"조사연도","가구고유번호(MD제공용)","자산","금융자산","저축액","적립 및 예치식 저축","현거주지 전월세보증금","실물자산","부동산","거주주택","거주주택 이외 부동산","계약금 및 중도금 납입액","기타 실물자산","자동차","자동차이외 기타 실물자산","권리금","부채","금융부채","담보대출","신용대출","소비지출","주거비","의료비","교통비","통신비","세금(보완)"
2020,010000112,112000,49000,10000,10000,39000,63000,60000,0,60000,0,3000,3000,0,0,54500,16000,10000,6000,2340,180,30,400,110,491
2020,010000132,42500,25500,22500,17500,3000,17000,17000,0,17000,0,0,0,0,0,17500,11500,9500,2000,6580,1800,100,240,480,1413
2020,010000162,5712,5712,712,712,5000,0,0,0,0,0,0,0,0,0,0,0,0,0,570,60,120,10,20,3
2020,010000182,14870,14800,4800,4800,10000,70,0,0,0,0,70,70,0,0,0,0,0,0,2200,360,240,60,60,57
2020,010000192,814,814,314,314,500,0,0,0,0,0,0,0,0,0,0,0,0,0,1730,600,20,120,120,62
2020,010000212,17524,11524,11524,11524,0,6000,6000,6000,0,0,0,0,0,0,300,0,0,0,1363,138,44,36,55,46
2020,010000222,7930,2930,2930,2930,0,5000,5000,5000,0,0,0,0,0,0,8000,8000,3000,0,894,60,25,96,72,48
2020,010000232,27506,2056,2056,2056,0,25450,25000,25000,0,0,450,450,0,0,18000,18000,18000,0,2865,247,56,252,210,70
2020,010000252,2160,1630,130,130,1500,530,0,0,0,0,530,530,0,0,800,800,0,0,2089,504,700,120,180,81
2020,010000262,57615,1570,1570,1570,0,56045,56000,38000,18000,0,45,0,45,0,0,0,0,0,1444,370,80,140,96,62
2020,010000272,32425,5875,5875,5875,0,26550,24000,24000,0,0,2550,2550,0,0,0,0,0,0,4360,360,100,600,380,1450
2020,010000282,104860,360,360,360,0,104500,102000,22000,80000,0,2500,500,2000,0,74700,74700,72000,900,2041,216,10,150,300,302
2020,010000312,82680,12680,12680,12680,0,70000,69000,49000,20000,0,1000,1000,0,0,10,0,0,0,4340,360,600,600,360,84
2020,010000322,5366,366,366,366,0,5000,5000,5000,0,0,0,0,0,0,1500,1500,0,400,2740,240,780,240,240,48
2020,010000332,21035,20135,3635,3635,16500,900,0,0,0,0,900,900,0,0,13000,13000,0,13000,2280,300,50,300,180,372
2020,010000342,20050,20050,16050,16050,4000,0,0,0,0,0,0,0,0,0,200,200,200,0,1800,200,50,50,180,285
2020,010000352,25700,3700,3700,3700,0,22000,22000,22000,0,0,0,0,0,0,0,0,0,0,1260,180,20,60,60,28
2020,010000362,4900,3400,3400,1900,0,1500,0,0,0,0,1500,0,1500,0,0,0,0,0,1680,0,700,120,120,620
2020,010000372,14760,1810,810,810,1000,12950,12000,0,0,12000,950,950,0,0,12000,12000,0,12000,4190,900,500,600,350,165
2020,010001102,5252,5252,252,252,5000,0,0,0,0,0,0,0,0,0,0,0,0,0,588,50,2,16,60,9
2020,010600141,21848,1748,1748,1748,0,20100,20000,20000,0,0,100,100,0,0,5200,5200,2700,2500,2080,100,100,130,200,55
2020,010600211,90,50,50,50,0,40,0,0,0,0,40,0,40,0,0,0,0,0,1418,120,250,120,108,1
2020,010600221,11360,1690,1690,1690,0,9670,7500,7500,0,0,2170,2170,0,0,1300,1300,0,0,2160,180,60,360,240,64
2020,010600241,1220,1200,200,200,1000,20,0,0,0,0,20,0,20,0,0,0,0,0,1679,175,1000,24,60,1
2020,010600271,68823,40987,40987,40987,0,27836,27300,27000,300,0,536,400,136,0,0,0,0,0,3158,252,320,630,264,435
2020,010600281,41322,8322,8322,8322,0,33000,32000,32000,0,0,1000,1000,0,0,6200,200,0,0,1821,148,300,348,84,78
2020,010600291,91856,10256,10256,10256,0,81600,80000,47000,13000,20000,1600,1600,0,0,500,0,0,0,4262,600,50,500,125,496
2020,010600331,103231,41367,41367,41367,0,61864,60000,60000,0,0,1864,1364,500,0,0,0,0,0,3810,350,160,450,170,1499
2020,010600351,32150,6150,6150,6150,0,26000,26000,26000,0,0,0,0,0,0,0,0,0,0,1143,250,270,60,48,25
2020,010600371,150958,6834,6834,6834,0,144124,143500,0,143500,0,624,400,224,0,61281,38681,38681,0,3400,410,580,410,240,630
2020,010600381,37384,10434,10434,10134,0,26950,25000,25000,0,0,1950,1950,0,0,13,13,0,0,3344,216,50,450,360,672
2020,010601101,80000,20000,20000,20000,0,60000,60000,60000,0,0,0,0,0,0,400,0,0,0,1822,720,240,24,84,43
2020,010601111,720,20,20,20,0,700,0,0,0,0,700,700,0,0,1350,1350,0,1000,1482,840,12,60,400,3
2020,010601121,510,510,10,10,500,0,0,0,0,0,0,0,0,0,0,0,0,0,1163,603,10,24,96,7
2020,010700111,117080,82880,10380,10380,72500,34200,26600,0,26600,0,7600,7600,0,0,21540,21540,17540,4000,4710,100,200,180,180,5183
2020,010700121,80190,190,190,190,0,80000,80000,80000,0,0,0,0,0,0,2000,2000,0,0,3500,400,300,400,300,80
2020,010700141,4448,4448,3948,3948,500,0,0,0,0,0,0,0,0,0,2577,2577,1500,0,1624,84,380,300,240,35
2020,010700151,20794,2794,2794,2794,0,18000,18000,18000,0,0,0,0,0,0,8100,8100,5100,0,963,120,140,72,96,41
2020,010700181,34154,15454,4454,4454,11000,18700,18700,0,0,18700,0,0,0,0,20700,20700,0,20700,1636,360,30,150,60,251
2020,010700191,61230,530,530,530,0,60700,60700,28000,32700,0,0,0,0,0,1000,0,0,0,542,216,40,60,36,136
2020,010700211,6890,2754,2754,1354,0,4136,4000,4000,0,0,136,0,36,100,0,0,0,0,674,120,20,30,90,4
2020,010700221,119,80,80,80,0,39,0,0,0,0,39,0,39,0,0,0,0,0,623,174,60,24,15,1
2020,010700231,23820,3670,3670,3670,0,20150,20000,20000,0,0,150,150,0,0,1100,1100,1000,0,6239,180,40,240,180,151
2020,010700241,29270,1770,1770,1770,0,27500,26500,24000,2500,0,1000,1000,0,0,8,8,0,0,1913,180,300,132,60,174
2020,010700321,29416,8416,8416,8416,0,21000,21000,21000,0,0,0,0,0,0,0,0,0,0,2436,230,400,180,68,25
2020,010700331,15100,3900,3900,3900,0,11200,11000,11000,0,0,200,0,200,0,0,0,0,0,1310,200,400,60,100,11
2020,010700341,118610,67260,24260,24260,43000,51350,50000,0,50000,0,1350,1350,0,0,0,0,0,0,8400,450,100,300,200,3703
2020,010700391,33135,4485,4485,4485,0,28650,27000,27000,0,0,1650,1650,0,0,15410,15410,14000,1200,4060,264,30,960,216,63
2020,010701101,18602,18602,8602,8602,10000,0,0,0,0,0,0,0,0,0,150,150,0,0,2404,126,220,84,264,8
2020,010800111,128844,23844,23844,21844,0,105000,105000,105000,0,0,0,0,0,0,9120,9120,0,9000,6168,360,300,720,288,1925
2020,010800161,18672,18672,3672,3672,15000,0,0,0,0,0,0,0,0,0,0,0,0,0,1420,180,160,120,180,22
2020,010800181,162490,16240,16240,16240,0,146250,146000,146000,0,0,250,250,0,0,0,0,0,0,4530,420,470,290,100,1237
2020,010800221,31676,3046,3046,3046,0,28630,26000,26000,0,0,2630,2500,130,0,13000,13000,12000,0,1286,192,20,120,144,36
2020,010800231,5146,4546,2546,2546,2000,600,0,0,0,0,600,300,300,0,2050,2050,0,0,3889,294,25,504,300,269
2020,010800241,16360,16360,1360,1360,15000,0,0,0,0,0,0,0,0,0,0,0,0,0,928,152,96,38,42,11
2020,010800261,23045,6545,6545,6545,0,16500,16000,16000,0,0,500,500,0,0,2000,0,0,0,1418,182,450,131,135,48
2020,010800271,305000,128000,128000,120000,0,177000,172000,82000,90000,0,5000,0,5000,0,20000,0,0,0,7148,480,500,120,48,566
2020,010800281,32400,32400,27900,27900,4500,0,0,0,0,0,0,0,0,0,0,0,0,0,1605,60,120,120,60,129
2020,010800321,896,896,620,620,276,0,0,0,0,0,0,0,0,0,356,356,0,356,396,213,12,10,36,1
2020,010800341,27084,25284,9784,9784,15500,1800,0,0,0,0,1800,1800,0,0,0,0,0,0,3808,650,100,720,228,288
2020,010800381,8020,8020,20,20,8000,0,0,0,0,0,0,0,0,0,0,0,0,0,605,115,180,0,50,3
2020,010801101,24874,74,74,74,0,24800,24000,24000,0,0,800,800,0,0,11300,11300,11000,0,1700,320,30,200,180,279
2020,010900111,293524,129024,56024,36024,73000,164500,160000,0,160000,0,4500,4500,0,0,106000,33000,29000,4000,10260,1000,100,1000,360,5500
2020,010900121,26010,1310,1310,310,0,24700,23000,23000,0,0,1700,1700,0,0,4000,4000,1500,400,2630,300,150,50,120,54
2020,010900131,14004,14004,6004,6004,8000,0,0,0,0,0,0,0,0,0,0,0,0,0,1565,120,200,72,42,8
2020,010900141,72260,35160,22160,21660,13000,37100,35000,0,35000,0,2100,300,1800,0,24000,0,0,0,4530,180,300,750,300,74
2020,010900161,95800,5000,5000,5000,0,90800,90000,90000,0,0,800,800,0,0,0,0,0,0,830,240,120,100,50,425
2020,010900171,9646,9646,3646,3646,6000,0,0,0,0,0,0,0,0,0,4,4,0,0,662,60,10,120,96,11
2020,010900191,124791,4791,4791,4791,0,120000,120000,120000,0,0,0,0,0,0,3112,1612,0,1612,2872,360,200,240,180,141
2020,010900211,3125,3125,2125,2125,1000,0,0,0,0,0,0,0,0,0,2000,2000,0,2000,3170,480,50,360,360,19
2020,010900221,16066,990,990,990,0,15076,15000,15000,0,0,76,0,76,0,0,0,0,0,1414,500,20,24,60,41
2020,010900251,8075,8050,1050,1050,7000,25,0,0,0,0,25,0,25,0,0,0,0,0,1040,120,8,30,42,167
2020,010900271,4030,30,30,30,0,4000,4000,4000,0,0,0,0,0,0,0,0,0,0,573,96,120,15,24,8
2020,010900291,8725,225,225,225,0,8500,8500,8500,0,0,0,0,0,0,0,0,0,0,894,96,140,60,72,11
2020,010900311,79739,9839,9839,9839,0,69900,64000,58000,6000,0,5900,5900,0,0,3000,3000,0,0,2770,300,130,240,280,214
2020,010900331,16500,4000,4000,4000,0,12500,12000,12000,0,0,500,500,0,0,300,0,0,0,1338,180,156,372,120,33
2020,010900341,1364,1364,864,864,500,0,0,0,0,0,0,0,0,0,0,0,0,0,1065,250,100,85,180,50
2020,010900351,13550,13550,550,550,13000,0,0,0,0,0,0,0,0,0,9000,9000,9000,0,2030,350,300,320,240,1
2020,010900371,361,361,61,61,300,0,0,0,0,0,0,0,0,0,2182,2182,0,2182,1684,554,22,210,264,1
2020,010901101,5240,5240,1240,1240,4000,0,0,0,0,0,0,0,0,0,0,0,0,0,1529,216,115,180,75,81
2020,011000162,68105,1105,1105,1105,0,67000,65000,35000,30000,0,2000,2000,0,0,0,0,0,0,2164,216,120,240,96,113
2020,011000172,4045,4045,1045,1045,3000,0,0,0,0,0,0,0,0,0,1560,1560,0,1450,3085,360,5,132,348,43
2020,011000192,356510,4610,4610,4610,0,351900,350000,100000,250000,0,1900,900,1000,0,12000,0,0,0,5960,504,120,420,216,493
2020,011000202,10798,10765,2265,2265,8500,33,0,0,0,0,33,0,33,0,8050,8050,7500,0,995,105,40,84,156,5
2020,011000232,43625,3625,3625,3625,0,40000,40000,40000,0,0,0,0,0,0,8600,8600,7000,1600,3950,240,40,330,150,21
2020,011000252,9472,8422,422,422,8000,1050,0,0,0,0,1050,350,700,0,5200,5200,5000,0,2035,180,60,240,280,26
2020,011000262,10000,200,200,200,0,9800,9500,9500,0,0,300,300,0,0,0,0,0,0,2310,120,80,150,110,55
2020,011000272,8860,160,160,160,0,8700,8300,8300,0,0,400,400,0,0,0,0,0,0,1680,180,50,120,120,29
2020,011000282,6360,6360,1860,1860,4500,0,0,0,0,0,0,0,0,0,0,0,0,0,1261,96,15,60,336,2
2020,011000292,78774,14684,14684,6684,0,64090,60000,60000,0,0,4090,0,90,4000,5750,5750,5400,0,6560,420,60,2070,240,89
2020,011000302,99636,45366,10366,8766,35000,54270,54000,0,54000,0,270,270,0,0,55500,23000,16000,7000,5030,300,60,360,360,1024
2020,011000312,23015,3815,3815,3815,0,19200,17000,17000,0,0,2200,1700,0,500,4500,4500,4500,0,5832,198,50,684,180,172
2020,011000322,2010,2010,10,10,2000,0,0,0,0,0,0,0,0,0,0,0,0,0,2068,900,48,140,120,7
2020,011000332,21878,11378,3378,3378,8000,10500,10500,0,10500,0,0,0,0,0,8300,300,0,300,1582,560,120,120,96,13
2020,011000342,87240,37440,37440,36440,0,49800,49000,40000,9000,0,800,0,800,0,0,0,0,0,1719,372,120,264,60,110
2020,011000352,172500,900,900,900,0,171600,170000,130000,40000,0,1600,1600,0,0,10500,0,0,0,4670,1200,120,360,600,1224
2020,011000362,1620,1620,80,80,1540,0,0,0,0,0,0,0,0,0,25,25,0,0,662,240,96,10,36,1
2020,011000372,14200,14000,4000,4000,10000,200,0,0,0,0,200,200,0,0,8000,8000,8000,0,2640,156,10,204,240,52
2020,011000382,5960,5260,2260,2260,3000,700,0,0,0,0,700,700,0,0,0,0,0,0,1945,640,5,180,120,12
2020,011000392,41878,36620,5620,5620,31000,5258,3600,0,0,3600,1658,1500,158,0,19200,19200,19200,0,1586,204,120,240,180,193
2020,011600111,27016,27016,2016,2016,25000,0,0,0,0,0,0,0,0,0,0,0,0,0,1572,60,36,60,96,68
2020,011600121,58860,12680,12680,12680,0,46180,45000,0,45000,0,1180,900,280,0,18000,5000,0,5000,5425,850,50,150,150,580
2020,011600131,203777,3777,3777,3777,0,200000,200000,200000,0,0,0,0,0,0,70000,0,0,0,2566,360,10,60,30,162
2020,011600151,4640,4640,640,640,4000,0,0,0,0,0,0,0,0,0,262,262,250,0,675,180,30,180,48,0
2020,011600181,36000,1900,1900,700,0,34100,32000,32000,0,0,2100,900,200,1000,720,720,0,600,2140,240,240,120,120,134
2020,011600201,3600,100,100,100,0,3500,3500,3500,0,0,0,0,0,0,0,0,0,0,720,65,125,15,30,4
2020,011600211,7436,3536,3536,3536,0,3900,3500,3500,0,0,400,400,0,0,1800,1800,1200,0,1595,110,125,180,190,12
2020,011600221,84240,16940,16940,14940,0,67300,42000,42000,0,0,25300,13300,5000,7000,2650,2650,2550,0,3886,300,240,240,276,267
2020,011600231,23090,290,290,290,0,22800,18000,18000,0,0,4800,4800,0,0,10694,10694,5694,5000,4590,180,30,1080,360,711
2020,011600261,28086,2860,2860,2860,0,25226,25000,25000,0,0,226,0,226,0,2380,2380,2380,0,1748,240,50,120,108,19
2020,011600281,14929,2713,2713,2713,0,12216,11000,11000,0,0,1216,900,316,0,6000,6000,6000,0,3440,300,24,300,264,100
2020,011600291,21256,4106,4106,2106,0,17150,15000,15000,0,0,2150,1150,1000,0,1738,1738,500,0,2192,192,150,480,240,57
2020,011600311,56090,8000,8000,7000,0,48090,48000,30000,18000,0,90,0,90,0,8000,0,0,0,1240,120,200,100,70,52
2020,011600381,146300,16000,16000,16000,0,130300,130000,130000,0,0,300,100,200,0,0,0,0,0,2329,480,70,240,43,519
2020,011700121,2880,2880,1880,1880,1000,0,0,0,0,0,0,0,0,0,2698,2698,0,1185,2619,720,130,200,156,30
2020,011700151,280420,55420,15420,7420,40000,225000,215000,0,215000,0,10000,1000,9000,0,72816,17816,17816,0,9236,556,500,220,350,1700
2020,011700161,198660,52360,52360,52360,0,146300,140000,85000,55000,0,6300,1800,4500,0,20000,0,0,0,3160,396,80,400,144,409
2020,011700171,56490,4990,4990,4990,0,51500,50000,50000,0,0,1500,1500,0,0,0,0,0,0,3350,250,20,480,250,385
2020,011700181,56326,8900,8900,8900,0,47426,45000,45000,0,0,2426,2200,226,0,2400,2400,2400,0,3502,240,100,250,192,85
2020,011700191,49254,3486,3486,3486,0,45768,45000,45000,0,0,768,700,68,0,1500,1500,1500,0,5260,360,120,360,360,926
2020,011700211,27008,5650,5650,5650,0,21358,21000,21000,0,0,358,158,200,0,3500,0,0,0,3010,165,250,250,125,25
2020,011700221,2404,2404,2104,2104,300,0,0,0,0,0,0,0,0,0,0,0,0,0,495,64,40,25,48,0
2020,011700241,130,130,80,80,50,0,0,0,0,0,0,0,0,0,1000,1000,0,0,988,310,42,250,48,1
2020,011700271,3145,3145,2145,2145,1000,0,0,0,0,0,0,0,0,0,1425,1425,600,0,1570,200,700,60,60,13
2020,011700281,171400,1200,1200,1200,0,170200,170000,90000,80000,0,200,200,0,0,2050,50,0,0,2390,360,100,360,120,354
2020,011700311,1430,1060,60,60,1000,370,0,0,0,0,370,370,0,0,160,160,0,160,2028,696,10,240,162,1
2020,011700371,6300,4800,2100,2100,2700,1500,1500,0,1500,0,0,0,0,0,0,0,0,0,720,100,25,10,30,4
2020,011800131,60120,120,120,120,0,60000,60000,60000,0,0,0,0,0,0,1200,0,0,0,1252,180,300,20,72,41
2020,011800151,11265,11265,265,265,11000,0,0,0,0,0,0,0,0,0,14,14,0,0,1328,180,24,84,120,2
2020,011800201,18981,3936,3936,3936,0,15045,12000,12000,0,0,3045,3000,45,0,9580,9580,5000,2180,3510,300,20,280,300,53
2020,011800231,60455,5755,5755,5755,0,54700,48000,48000,0,0,6700,6000,700,0,27550,27550,27500,0,4054,264,380,360,180,169
2020,011800241,178700,700,700,700,0,178000,178000,78000,100000,0,0,0,0,0,78355,69355,39355,0,3895,350,1290,270,180,1536
2020,011800251,165255,14300,14300,14300,0,150955,150000,150000,0,0,955,700,255,0,5000,0,0,0,3940,144,2400,120,120,290
2020,011800261,138370,6850,6850,6850,0,131520,130000,100000,30000,0,1520,1400,120,0,2000,0,0,0,3397,108,36,243,120,743
2020,011800271,17920,17920,9920,9920,8000,0,0,0,0,0,0,0,0,0,5000,5000,0,5000,1400,140,20,360,50,2
2020,011800281,56500,3500,3500,3500,0,53000,53000,53000,0,0,0,0,0,0,750,0,0,0,920,140,100,20,30,67
2020,011800301,1220,1220,220,220,1000,0,0,0,0,0,0,0,0,0,930,930,0,700,2102,600,30,216,156,23
2020,011800341,56368,20188,20188,17688,0,36180,35000,35000,0,0,1180,1000,180,0,4000,4000,4000,0,2400,120,300,200,300,95
2020,011800351,82360,8860,8860,8860,0,73500,70000,65000,5000,0,3500,3500,0,0,21500,21500,21500,0,2434,800,100,264,250,705
2020,011800371,97280,1380,1380,1380,0,95900,95000,95000,0,0,900,900,0,0,0,0,0,0,3084,600,360,360,84,155
2020,011800381,16096,14596,4596,4596,10000,1500,0,0,0,0,1500,1500,0,0,0,0,0,0,1400,190,70,210,110,53
2020,011900151,3800,3000,2500,2500,500,800,800,0,800,0,0,0,0,0,0,0,0,0,1000,306,72,40,32,3
2020,011900161,36200,21200,6200,6200,15000,15000,15000,0,15000,0,0,0,0,0,50,50,0,0,1636,186,200,100,140,35
2020,011900171,62992,992,992,992,0,62000,60000,60000,0,0,2000,2000,0,0,14158,1658,0,1400,3050,500,400,300,72,460
2020,011900211,36600,13440,11140,11140,2300,23160,23000,0,23000,0,160,0,160,0,2800,0,0,0,921,80,190,36,15,27
2020,011900221,548,548,548,548,0,0,0,0,0,0,0,0,0,0,0,0,0,0,674,60,40,20,24,0
2020,011900231,13120,820,820,820,0,12300,10000,10000,0,0,2300,1800,500,0,2700,2700,0,1200,2184,120,24,240,360,33
2020,011900241,35040,4740,4740,4740,0,30300,30000,30000,0,0,300,300,0,0,5040,5040,5000,0,2040,100,50,640,180,45
2020,011900251,952,952,652,652,300,0,0,0,0,0,0,0,0,0,10800,10800,0,0,1132,132,240,180,20,7
2020,011900261,7620,2120,2120,2120,0,5500,5500,5500,0,0,0,0,0,0,0,0,0,0,578,100,10,30,15,7
2020,011900271,18685,5235,5235,5235,0,13450,13000,13000,0,0,450,450,0,0,0,0,0,0,2015,380,25,40,120,48
2020,011900281,56880,25430,25430,25430,0,31450,30900,28500,2400,0,550,550,0,0,0,0,0,0,4800,240,100,800,180,165
2020,011900291,137430,37380,5380,5380,32000,100050,100000,0,100000,0,50,50,0,0,73400,68400,65500,2900,2236,336,120,120,120,146
2020,011900341,34758,34500,9500,9500,25000,258,0,0,0,0,258,30,228,0,0,0,0,0,1715,300,50,120,75,451
2020,011900371,178820,12320,12320,12320,0,166500,164500,90000,74500,0,2000,2000,0,0,0,0,0,0,2430,480,10,300,240,392
2020,011900381,2940,2940,940,940,2000,0,0,0,0,0,0,0,0,0,0,0,0,0,561,72,24,150,122,2
2020,011900391,36000,2000,2000,2000,0,34000,34000,34000,0,0,0,0,0,0,3000,0,0,0,1700,210,580,20,90,286
2020,012000102,540,540,40,40,500,0,0,0,0,0,0,0,0,0,0,0,0,0,1772,520,2,120,70,3
2020,012000112,4225,4095,3895,3895,200,130,0,0,0,0,130,130,0,0,7635,7635,4000,3600,2033,318,900,240,132,40
2020,012000122,91923,4073,4073,4073,0,87850,87000,85000,2000,0,850,850,0,0,0,0,0,0,3740,300,50,180,240,506
2020,012000132,7690,7090,590,590,6500,600,0,0,0,0,600,600,0,0,2100,2100,0,1800,1490,150,30,140,120,48
2020,012000152,27900,5900,5900,5900,0,22000,21000,21000,0,0,1000,1000,0,0,5060,5060,5000,0,1944,156,72,276,156,171
2020,012000182,935,935,35,35,900,0,0,0,0,0,0,0,0,0,4900,4900,900,4000,3230,1380,50,200,200,2
2020,012000192,85201,14975,14975,14975,0,70226,70000,70000,0,0,226,0,226,0,0,0,0,0,3390,256,450,50,192,594
2020,012000202,19745,2845,2845,845,0,16900,16000,16000,0,0,900,500,400,0,2600,2600,2600,0,1138,444,100,24,72,55
2020,012000212,26818,6318,6318,6318,0,20500,18000,18000,0,0,2500,2500,0,0,0,0,0,0,3472,240,63,180,264,45
2020,012000222,5440,5440,1040,1040,4400,0,0,0,0,0,0,0,0,0,0,0,0,0,940,120,20,36,24,1
2020,012000242,1400,1400,900,900,500,0,0,0,0,0,0,0,0,0,100,100,0,0,3010,750,280,55,260,34
2020,012000252,24600,600,600,600,0,24000,24000,24000,0,0,0,0,0,0,0,0,0,0,3018,216,360,210,132,51
2020,012000262,48845,8590,590,590,8000,40255,40000,0,40000,0,255,0,255,0,0,0,0,0,1357,132,15,84,120,41
2020,012000272,15030,10,10,10,0,15020,15000,15000,0,0,20,20,0,0,0,0,0,0,1353,200,10,92,78,200
2020,012000292,300,300,200,200,100,0,0,0,0,0,0,0,0,0,0,0,0,0,896,135,240,48,18,0
2020,012000312,91622,31622,31622,31622,0,60000,60000,60000,0,0,0,0,0,0,2500,0,0,0,1370,240,200,120,60,209
2020,012000322,64958,20428,4428,4428,16000,44530,44500,0,18500,26000,30,0,30,0,0,0,0,0,1474,272,50,24,8,61
2020,012000332,31368,4368,4368,4368,0,27000,27000,27000,0,0,0,0,0,0,0,0,0,0,776,132,20,36,48,20
2020,012000352,210600,35200,35200,35200,0,175400,172000,80000,92000,0,3400,2200,1200,0,23000,0,0,0,1460,480,200,350,70,728
2020,012000372,13235,65,65,65,0,13170,13000,13000,0,0,170,170,0,0,1774,1774,1774,0,1530,180,50,100,60,12
2020,012000392,12010,160,160,160,0,11850,10350,10000,0,350,1500,1500,0,0,10540,10540,5400,0,2936,120,36,240,240,6030
2020,012600111,49320,50,50,50,0,49270,49000,49000,0,0,270,270,0,0,11080,580,0,500,2443,330,700,25,68,106
2020,012600121,70740,16060,1060,1060,15000,54680,54500,0,54500,0,180,180,0,0,32000,0,0,0,4519,410,300,230,168,111
2020,012600131,52580,1680,1680,840,0,50900,50000,50000,0,0,900,600,300,0,16050,16050,14700,800,2840,250,10,500,250,81
2020,012600151,16350,350,350,350,0,16000,16000,16000,0,0,0,0,0,0,0,0,0,0,843,139,119,20,30,27
2020,012600181,390,390,90,90,300,0,0,0,0,0,0,0,0,0,2000,2000,0,0,1560,276,500,180,84,1
2020,012600191,55440,4640,4640,4640,0,50800,50000,50000,0,0,800,800,0,0,17500,17500,16700,800,3150,300,300,450,300,261
2020,012600201,39140,3340,3340,3340,0,35800,32000,15000,17000,0,3800,1200,0,2600,20572,8572,8572,0,2524,120,50,120,204,28
2020,012600211,30165,9415,9415,9415,0,20750,20000,20000,0,0,750,300,450,0,1700,1700,0,1000,2644,240,350,350,192,81
2020,012600221,49620,26320,26320,22320,0,23300,23000,23000,0,0,300,300,0,0,4000,4000,4000,0,2304,300,80,300,180,45
2020,012600241,62476,4276,4276,4276,0,58200,56300,44000,12300,0,1900,1800,100,0,1600,0,0,0,8960,180,800,720,660,1432
2020,012600261,2530,2530,30,30,2500,0,0,0,0,0,0,0,0,0,0,0,0,0,568,60,60,10,18,1
2020,012600291,64590,7190,7190,7190,0,57400,57000,45000,0,12000,400,400,0,0,4800,4800,4800,0,5046,360,50,276,180,1058
2020,012600311,1500,1500,1000,1000,500,0,0,0,0,0,0,0,0,0,6280,6280,0,6280,1736,780,20,60,36,415
2020,012600321,1610,1610,1610,1610,0,0,0,0,0,0,0,0,0,0,0,0,0,0,862,125,10,100,45,242
2020,012600331,453,453,3,3,450,0,0,0,0,0,0,0,0,0,2500,2500,0,0,955,344,100,48,78,0
2020,012600351,50220,4320,4320,4320,0,45900,44000,44000,0,0,1900,1100,0,800,13460,13460,13460,0,2906,270,60,380,252,140
2020,012600371,530,530,30,30,500,0,0,0,0,0,0,0,0,0,0,0,0,0,656,205,245,12,15,1
2020,012600381,29427,19547,9547,6547,10000,9880,9500,0,9500,0,380,380,0,0,8500,0,0,0,2530,310,100,320,250,52
2020,012600391,1988,1988,988,988,1000,0,0,0,0,0,0,0,0,0,1000,1000,1000,0,2808,456,100,360,300,2
2020,012700101,85490,29940,29940,29940,0,55550,55000,55000,0,0,550,550,0,0,10000,10000,10000,0,1946,360,120,240,156,212
2020,012700151,29060,60,60,60,0,29000,29000,29000,0,0,0,0,0,0,0,0,0,0,894,204,300,10,120,36
2020,012700181,429380,142680,142680,141880,0,286700,250000,80000,170000,0,36700,1700,35000,0,10000,0,0,0,5830,1800,200,600,350,10289
2020,012700221,102929,44929,28929,23429,16000,58000,58000,0,58000,0,0,0,0,0,8500,0,0,0,6340,185,370,300,320,1659
2020,012700231,15366,6640,6640,6640,0,8726,8500,8500,0,0,226,0,226,0,0,0,0,0,1609,230,360,84,35,86
2020,012700241,7279,1079,1079,1079,0,6200,6200,6200,0,0,0,0,0,0,0,0,0,0,1248,244,240,84,60,9
2020,012700251,5948,2848,848,848,2000,3100,1000,0,0,1000,2100,1400,700,0,4592,4592,0,3892,1090,60,10,240,50,241
2020,012700281,16690,340,340,340,0,16350,15000,15000,0,0,1350,1000,350,0,7914,7914,6414,1500,2810,140,60,180,150,72
2020,012700291,32436,12586,12586,12586,0,19850,13000,13000,0,0,6850,2850,0,4000,0,0,0,0,3880,280,30,700,240,104
2020,012700331,24810,3810,2810,2810,1000,21000,0,0,0,0,21000,11000,0,10000,1300,1300,0,0,1640,650,40,160,100,331
2020,012700341,17500,17500,2500,2500,15000,0,0,0,0,0,0,0,0,0,11030,11030,11000,0,1507,210,15,70,190,13
2020,012700361,31020,12020,5020,2920,7000,19000,19000,0,19000,0,0,0,0,0,10076,10076,10076,0,1790,130,200,120,140,32
2020,012700371,61164,7664,7664,7664,0,53500,52000,45000,7000,0,1500,1500,0,0,8580,7580,7580,0,3670,300,10,300,220,341
2020,012800111,74350,34850,5850,5850,29000,39500,39000,0,39000,0,500,500,0,0,0,0,0,0,3700,300,200,300,150,108
2020,012800121,41874,6374,6374,6374,0,35500,35000,35000,0,0,500,500,0,0,0,0,0,0,3850,350,100,300,200,2471
2020,012800131,5330,5330,330,330,5000,0,0,0,0,0,0,0,0,0,0,0,0,0,2870,360,20,140,250,108
2020,012800181,27620,2620,2620,2620,0,25000,25000,25000,0,0,0,0,0,0,7850,7850,4850,0,1030,120,200,40,60,31
2020,012800191,36370,3570,3570,3570,0,32800,32000,32000,0,0,800,800,0,0,2000,2000,1100,900,3260,180,60,360,300,29
2020,012800201,31090,3140,3140,3140,0,27950,25000,25000,0,0,2950,2950,0,0,7400,7400,7300,0,5244,288,100,660,238,412
2020,012800211,10800,1400,400,400,1000,9400,0,0,0,0,9400,7400,0,2000,6740,6740,0,300,3685,720,12,336,240,104
2020,012800241,22860,560,560,560,0,22300,19800,19800,0,0,2500,2500,0,0,9805,9805,9805,0,5144,192,100,400,312,243
2020,012800251,59678,13410,13410,12210,0,46268,43200,15200,28000,0,3068,1600,468,1000,21000,0,0,0,2672,432,70,552,156,379
2020,012800261,23219,4900,4900,4900,0,18319,18000,10000,8000,0,319,200,119,0,5000,0,0,0,3612,156,800,86,120,68
2020,012800271,660,660,210,210,450,0,0,0,0,0,0,0,0,0,0,0,0,0,982,312,110,48,42,1
2020,012800281,37190,6890,6890,6890,0,30300,30000,30000,0,0,300,0,300,0,0,0,0,0,2660,300,60,84,96,29
2020,012800291,50400,9800,9800,7800,0,40600,30000,30000,0,0,10600,1600,9000,0,0,0,0,0,5556,342,80,120,144,273
2020,012800311,14570,10470,970,970,9500,4100,4100,0,0,4100,0,0,0,0,9500,9500,7500,0,2756,180,40,320,216,34
2020,012800321,46650,1650,1650,1650,0,45000,45000,45000,0,0,0,0,0,0,22600,22600,20000,2600,4670,240,500,30,180,101
2020,012800351,69300,4300,4300,4300,0,65000,65000,65000,0,0,0,0,0,0,0,0,0,0,906,300,90,20,36,108
2020,012800361,45000,22000,500,500,21500,23000,23000,0,23000,0,0,0,0,0,2000,0,0,0,1112,240,120,72,60,23
2020,012800381,6042,5342,842,842,4500,700,0,0,0,0,700,0,700,0,1090,1090,0,1000,1310,180,10,180,120,2
2020,012900101,66110,860,860,860,0,65250,65000,65000,0,0,250,250,0,0,16000,16000,13000,3000,4426,300,96,350,120,971
2020,012900121,6200,6200,200,200,6000,0,0,0,0,0,0,0,0,0,0,0,0,0,2080,351,100,200,180,39
2020,012900131,69610,110,110,110,0,69500,68000,68000,0,0,1500,1500,0,0,0,0,0,0,2576,280,100,200,156,144
2020,012900151,25460,25460,460,460,25000,0,0,0,0,0,0,0,0,0,14100,14100,13000,600,4640,240,300,360,240,98
2020,012900161,73722,7722,7722,7722,0,66000,65000,65000,0,0,1000,700,300,0,0,0,0,0,2076,360,120,180,120,86
2020,012900171,19910,18310,5810,5810,12500,1600,0,0,0,0,1600,1600,0,0,37660,37660,0,35400,5080,840,300,200,340,836
2020,012900181,33030,8030,30,30,8000,25000,25000,0,25000,0,0,0,0,0,15000,0,0,0,855,170,50,20,15,15
2020,012900211,221531,10100,10100,10100,0,211431,210000,202000,8000,0,1431,1200,231,0,4100,0,0,0,3440,250,600,1000,40,230
2020,012900221,42400,200,200,200,0,42200,42200,28000,14200,0,0,0,0,0,13850,1850,1800,0,1010,150,180,10,40,70
2020,012900241,5696,5646,5346,5346,300,50,0,0,0,0,50,50,0,0,0,0,0,0,1692,306,10,250,60,27
2020,012900251,27050,24350,5850,5850,18500,2700,0,0,0,0,2700,2700,0,0,0,0,0,0,1960,130,10,600,180,194
2020,012900271,11890,2790,2790,2790,0,9100,0,0,0,0,9100,1800,300,7000,0,0,0,0,1361,108,660,50,48,7
2020,012900321,9612,7412,3412,1612,4000,2200,0,0,0,0,2200,2200,0,0,3380,3380,0,2000,1964,250,220,400,120,92
2020,012900331,48508,1108,1108,1108,0,47400,44000,44000,0,0,3400,1900,0,1500,14800,14800,14500,300,2543,248,100,260,336,77
2020,012900341,72485,13710,13710,13710,0,58775,57890,42000,5820,10070,885,885,0,0,34280,33880,19980,13900,2506,336,50,200,80,1031
2020,012900351,38718,518,518,518,0,38200,38000,38000,0,0,200,200,0,0,0,0,0,0,1600,196,100,380,156,113
2020,012900391,157923,69803,30803,30803,39000,88120,88000,0,65000,23000,120,120,0,0,68900,57900,34900,22000,5180,400,200,400,180,463
2020,013000102,97456,16556,16556,16556,0,80900,76500,76500,0,0,4400,4200,200,0,13588,13588,1738,11800,6250,200,2000,300,250,682
2020,013000112,36680,1180,1180,1180,0,35500,34000,34000,0,0,1500,1500,0,0,0,0,0,0,2510,300,70,180,240,77
2020,013000122,44190,3190,3190,3190,0,41000,40000,40000,0,0,1000,1000,0,0,0,0,0,0,3630,180,600,240,100,333
2020,013000132,30600,300,300,300,0,30300,30300,30300,0,0,0,0,0,0,0,0,0,0,1633,180,50,98,170,19
2020,013000142,33768,2768,2768,2768,0,31000,31000,31000,0,0,0,0,0,0,7000,7000,7000,0,3990,300,100,150,300,76
2020,013000152,36660,10560,10560,9060,0,26100,23000,23000,0,0,3100,2100,0,1000,16650,16650,12000,3950,5430,320,20,340,360,158
2020,013000162,20420,3420,3420,3420,0,17000,17000,17000,0,0,0,0,0,0,4880,4880,4800,0,948,109,30,72,65,21
2020,013000182,41325,12550,12550,12550,0,28775,28375,23000,5375,0,400,400,0,0,0,0,0,0,6076,384,300,480,300,1493
2020,013000192,75755,14655,14655,14655,0,61100,60000,60000,0,0,1100,1100,0,0,0,0,0,0,1361,328,200,156,96,94
2020,013000222,49430,5310,5310,5310,0,44120,27000,27000,0,0,17120,15520,1600,0,14670,14670,7800,0,2619,276,50,300,264,94
2020,013000232,9270,8570,2570,2570,6000,700,0,0,0,0,700,700,0,0,0,0,0,0,4038,750,1040,480,144,143
2020,013000252,5190,5040,4040,1040,1000,150,0,0,0,0,150,150,0,0,300,300,0,0,2490,350,60,360,120,15
2020,013000262,53730,230,230,230,0,53500,49000,21000,28000,0,4500,4500,0,0,37200,20700,20600,0,4178,300,180,360,228,565
2020,013000272,3656,3656,1256,1256,2400,0,0,0,0,0,0,0,0,0,2400,2400,2400,0,1420,360,60,240,100,27
2020,013000302,12316,4090,4090,4090,0,8226,8000,8000,0,0,226,0,226,0,0,0,0,0,1065,75,96,72,52,24
2020,013000332,20350,350,350,350,0,20000,20000,20000,0,0,0,0,0,0,6720,6720,6720,0,1392,156,96,120,156,19
2020,013000342,38018,700,700,700,0,37318,37000,15000,22000,0,318,318,0,0,0,0,0,0,1165,420,50,70,55,24
2020,013000352,12412,1412,1412,1412,0,11000,10000,10000,0,0,1000,1000,0,0,0,0,0,0,3310,180,0,450,120,27
2020,013000382,10050,10050,1050,1050,9000,0,0,0,0,0,0,0,0,0,916,916,0,916,1584,336,108,120,240,1
2020,013600101,60570,270,270,270,0,60300,60000,0,60000,0,300,300,0,0,54000,0,0,0,880,200,150,50,15,101
2020,013600131,37818,26118,10118,10118,16000,11700,9900,0,0,9900,1800,800,1000,0,16600,16600,10000,6600,2800,300,100,100,300,370
2020,013600141,16200,1800,1800,1800,0,14400,14000,14000,0,0,400,400,0,0,4400,4400,4400,0,1910,100,200,60,120,63
2020,013600151,16100,4100,4100,4100,0,12000,12000,12000,0,0,0,0,0,0,0,0,0,0,1000,120,10,120,20,22
2020,013600181,65720,19720,19720,19720,0,46000,45000,25000,20000,0,1000,1000,0,0,2000,0,0,0,1830,240,120,300,168,88
2020,013600191,40550,400,400,400,0,40150,40150,40000,150,0,0,0,0,0,27000,0,0,0,1625,260,100,15,80,61
2020,013600201,56733,21620,21620,21620,0,35113,35000,28000,7000,0,113,0,113,0,1500,0,0,0,1185,58,170,20,24,175
2020,013600211,59720,9420,9420,9420,0,50300,50000,50000,0,0,300,0,300,0,0,0,0,0,2220,440,100,130,50,24
2020,013600221,786540,87040,87040,87040,0,699500,695000,75000,620000,0,4500,4500,0,0,60000,0,0,0,7630,500,30,600,320,16648
2020,013600241,1868,1768,768,768,1000,100,0,0,0,0,100,0,100,0,0,0,0,0,2650,400,20,360,20,16
2020,013600261,56949,28349,13349,7349,15000,28600,24500,0,24500,0,4100,3800,300,0,7100,7100,0,7000,7285,240,95,450,220,3035
2020,013600301,30010,10,10,10,0,30000,30000,30000,0,0,0,0,0,0,0,0,0,0,1176,180,600,36,60,6
2020,013600321,69520,67520,13020,13020,54500,2000,0,0,0,0,2000,1500,500,0,28050,28050,18000,10000,4340,400,200,300,190,1531
2020,013600331,7398,7398,1398,1398,6000,0,0,0,0,0,0,0,0,0,0,0,0,0,960,120,300,20,20,1
2020,013600351,16595,15095,1095,1095,14000,1500,0,0,0,0,1500,1000,500,0,12700,12700,10000,2700,3690,300,100,320,220,49
2020,013600361,39578,1178,1178,878,0,38400,32000,32000,0,0,6400,3600,2300,500,10700,10700,9100,0,4300,100,1000,700,200,161
2020,013700141,2476,2476,2076,2076,400,0,0,0,0,0,0,0,0,0,120,120,120,0,1448,140,7,190,100,2
2020,013700151,13800,950,950,950,0,12850,12000,12000,0,0,850,850,0,0,1950,1950,1950,0,768,156,30,290,1,61
2020,013700161,21115,3615,3615,3615,0,17500,17500,17500,0,0,0,0,0,0,7600,7600,6000,1400,3620,100,800,200,120,325
2020,013700171,5,5,5,5,0,0,0,0,0,0,0,0,0,0,0,0,0,0,518,120,80,2,36,1
2020,013700191,60330,330,330,330,0,60000,60000,60000,0,0,0,0,0,0,0,0,0,0,844,200,180,6,48,126
2020,013700201,2968,2718,1218,1218,1500,250,0,0,0,0,250,200,50,0,0,0,0,0,2067,360,100,204,120,43
2020,013700221,33092,5684,5684,5684,0,27408,27000,27000,0,0,408,250,158,0,0,0,0,0,940,162,30,100,60,64
2020,013700231,91200,33200,6200,6200,27000,58000,58000,0,14000,44000,0,0,0,0,690,190,0,0,2448,192,200,156,60,633
2020,013700241,23800,2283,2283,2283,0,21517,21000,21000,0,0,517,500,17,0,9950,9950,9900,0,2332,276,24,216,144,117
2020,013700251,46200,20100,6100,6100,14000,26100,25000,0,17000,8000,1100,900,200,0,1000,0,0,0,2948,132,216,720,240,306
2020,013700261,320,320,120,120,200,0,0,0,0,0,0,0,0,0,680,680,0,680,1440,280,100,60,130,1
2020,013700271,2327,1127,427,427,700,1200,0,0,0,0,1200,1200,0,0,1080,1080,0,0,4555,434,420,320,230,49
2020,013700311,28100,28100,11100,11100,17000,0,0,0,0,0,0,0,0,0,9000,9000,9000,0,4018,320,60,120,120,7
2020,013700341,510,10,10,10,0,500,0,0,0,0,500,500,0,0,950,950,0,0,1505,205,20,460,90,400
2020,013700351,187570,24270,24270,24270,0,163300,152500,25000,120000,7500,10800,10800,0,0,123290,114290,100870,8000,5565,240,200,60,385,418
2020,013700361,27499,5899,5899,5899,0,21600,21000,21000,0,0,600,600,0,0,9940,9940,9940,0,1980,240,50,240,40,602
2020,013700381,103,103,3,3,100,0,0,0,0,0,0,0,0,0,600,600,0,600,516,288,24,12,12,1
2020,013700391,18942,742,742,742,0,18200,17200,12500,0,4700,1000,1000,0,0,8140,8140,6200,1900,2901,48,10,324,240,37
2020,013800101,42500,500,500,500,0,42000,42000,42000,0,0,0,0,0,0,13850,13850,13000,850,1476,252,200,120,98,41
2020,013800111,5701,4301,3301,3301,1000,1400,0,0,0,0,1400,1400,0,0,2200,2200,0,2200,1970,640,20,172,168,105
2020,013800121,17760,560,560,560,0,17200,13000,13000,0,0,4200,4200,0,0,3850,3850,0,0,3200,350,900,360,100,66
2020,013800131,3750,3750,450,450,3300,0,0,0,0,0,0,0,0,0,0,0,0,0,880,120,20,60,50,2
2020,013800141,50292,292,292,292,0,50000,50000,50000,0,0,0,0,0,0,60,60,0,0,1310,240,120,150,80,202
2020,013800151,22300,20800,800,800,20000,1500,0,0,0,0,1500,1500,0,0,4000,4000,4000,0,4556,276,20,660,300,27
2020,013800161,45614,7114,7114,7114,0,38500,38000,38000,0,0,500,500,0,0,24830,24830,17700,4130,3508,240,660,144,144,64
2020,013800171,70000,11000,11000,11000,0,59000,55000,55000,0,0,4000,4000,0,0,0,0,0,0,5910,400,140,500,170,2069
2020,013800181,2240,2240,240,240,2000,0,0,0,0,0,0,0,0,0,600,600,0,600,2420,720,50,50,90,35
2020,013800201,19700,4200,4200,4200,0,15500,14000,14000,0,0,1500,1500,0,0,5920,5920,5920,0,3410,180,300,400,180,268
2020,013800221,44138,17488,7488,6488,10000,26650,23500,0,23500,0,3150,1450,700,1000,9400,8400,7000,1400,2646,186,50,620,180,76
2020,013800231,87380,15060,15060,15060,0,72320,68000,32000,36000,0,4320,1500,220,2600,29000,3000,0,0,2337,420,60,360,264,261
2020,013800241,1155,1105,105,105,1000,50,0,0,0,0,50,0,50,0,2376,2376,0,2000,1338,800,20,10,18,20
2020,013800251,53520,37320,37320,37320,0,16200,16000,16000,0,0,200,200,0,0,0,0,0,0,3306,240,300,140,96,195
2020,013800261,24310,810,810,810,0,23500,23500,19000,4500,0,0,0,0,0,2000,0,0,0,1382,122,120,24,96,14
2020,013800301,97360,860,860,860,0,96500,95000,95000,0,0,1500,1500,0,0,41760,15260,14200,1000,3020,180,80,120,240,285
2020,013800311,74589,60789,32289,26789,28500,13800,0,0,0,0,13800,5800,8000,0,23800,23800,20000,800,3210,100,130,360,240,1313
2020,013800331,20,20,20,20,0,0,0,0,0,0,0,0,0,0,0,0,0,0,605,120,110,10,30,1
2020,013800341,20880,1730,1730,1730,0,19150,16500,16500,0,0,2650,2400,250,0,0,0,0,0,3622,228,50,840,130,120
2020,013800351,17160,160,160,160,0,17000,17000,17000,0,0,0,0,0,0,8662,8662,8000,0,1210,192,30,120,120,43
2020,013800361,36620,4120,4120,4120,0,32500,30000,30000,0,0,2500,2500,0,0,14400,14400,14400,0,1366,366,60,24,96,39
2020,013800381,67150,2150,2150,2150,0,65000,65000,35000,30000,0,0,0,0,0,2000,0,0,0,1370,360,200,0,60,141
2020,013900101,67200,2100,2100,2100,0,65100,65000,65000,0,0,100,0,100,0,4500,0,0,0,1530,280,350,40,60,54
2020,013900131,35420,420,420,420,0,35000,35000,35000,0,0,0,0,0,0,0,0,0,0,786,150,30,30,36,28
2020,013900151,16851,15751,1351,1351,14400,1100,0,0,0,0,1100,1100,0,0,10200,10200,10000,0,2476,200,50,300,280,198
2020,013900181,31020,29020,9020,9020,20000,2000,0,0,0,0,2000,2000,0,0,0,0,0,0,1797,135,100,120,158,218
2020,013900201,3540,2640,40,40,2600,900,0,0,0,0,900,900,0,0,0,0,0,0,695,200,30,50,80,24
2020,013900211,6272,5072,3512,3512,1560,1200,0,0,0,0,1200,1200,0,0,1850,1850,0,0,2860,400,100,400,240,215
2020,013900241,93030,19030,19030,19030,0,74000,72000,42000,30000,0,2000,2000,0,0,20000,0,0,0,3411,300,330,430,132,493
2020,013900251,21638,1000,1000,1000,0,20638,13000,13000,0,0,7638,600,38,7000,0,0,0,0,1290,200,120,150,60,19
2020,013900301,3265,3265,1265,1265,2000,0,0,0,0,0,0,0,0,0,0,0,0,0,1106,91,35,25,56,3
2020,013900311,987,537,537,537,0,450,0,0,0,0,450,450,0,0,0,0,0,0,2417,200,40,360,144,60
2020,013900321,7372,7372,2372,1072,5000,0,0,0,0,0,0,0,0,0,510,510,0,0,729,120,120,24,15,1
2020,013900341,15015,14515,2515,2515,12000,500,0,0,0,0,500,500,0,0,2100,2100,0,1100,2280,480,100,240,216,71
2020,013900351,180,130,30,30,100,50,0,0,0,0,50,50,0,0,0,0,0,0,1164,444,36,144,108,18
2020,013900381,1123,563,63,63,500,560,0,0,0,0,560,560,0,0,20200,20200,0,200,2848,840,20,180,300,103
2020,013900391,50762,7030,7030,7030,0,43732,42000,42000,0,0,1732,1732,0,0,20000,20000,20000,0,6180,360,460,840,240,161
2020,014000102,13510,1510,1510,1510,0,12000,12000,12000,0,0,0,0,0,0,0,0,0,0,2067,87,300,156,162,26
2020,014000112,56760,5760,5760,5760,0,51000,43000,30000,13000,0,8000,8000,0,0,3000,0,0,0,3138,166,40,360,180,1647
2020,014000122,168126,13526,13526,13526,0,154600,150000,120000,30000,0,4600,3600,1000,0,22300,21300,20600,0,5280,360,400,420,120,1484
2020,014000142,11282,11282,1282,1282,10000,0,0,0,0,0,0,0,0,0,15300,15300,8000,7300,1860,750,20,120,60,1118
2020,014000152,177572,6072,6072,6072,0,171500,171000,145000,26000,0,500,500,0,0,62000,42000,42000,0,10464,720,400,600,620,776
2020,014000172,779,779,279,279,500,0,0,0,0,0,0,0,0,0,600,600,0,600,2238,756,300,120,72,14
2020,014000182,2530,1530,530,530,1000,1000,0,0,0,0,1000,1000,0,0,6059,6059,0,223,2210,624,100,240,156,116
2020,014000192,59339,839,839,839,0,58500,58000,58000,0,0,500,500,0,0,28000,28000,28000,0,4810,360,120,340,200,463
2020,014000302,510020,71520,71520,61520,0,438500,30000,0,0,30000,408500,4500,402000,2000,0,0,0,0,7626,600,30,480,480,6953
2020,014000322,35902,33902,9902,9902,24000,2000,0,0,0,0,2000,2000,0,0,6600,6600,6000,0,3728,300,120,240,216,232
2020,014000332,35680,30480,2480,2480,28000,5200,3500,0,0,3500,1700,1700,0,0,0,0,0,0,4410,410,340,495,310,804
2020,014000342,2005,2005,1005,1005,1000,0,0,0,0,0,0,0,0,0,4431,4431,0,1431,1565,1200,100,30,60,1
2020,014000352,56872,8920,8920,8920,0,47952,45000,25000,20000,0,2952,2500,452,0,12860,12860,8760,4100,3316,320,120,290,240,328
2020,014000362,42792,1372,1372,1372,0,41420,40000,20000,20000,0,1420,1420,0,0,13862,13862,13832,0,2134,241,150,422,132,138
2020,014000372,135050,50,50,50,0,135000,135000,0,135000,0,0,0,0,0,23000,20000,20000,0,776,162,115,72,12,301
2020,014000382,1004,1004,4,4,1000,0,0,0,0,0,0,0,0,0,0,0,0,0,2172,696,20,62,72,9
2020,014600111,3150,3150,10,10,3140,0,0,0,0,0,0,0,0,0,300,300,0,0,476,120,0,10,36,1
2020,014600141,1760,1760,60,60,1700,0,0,0,0,0,0,0,0,0,0,0,0,0,620,210,140,30,50,1
2020,014600151,50800,800,800,800,0,50000,50000,50000,0,0,0,0,0,0,32500,32500,28500,0,1770,180,80,80,80,2
2020,014600171,66826,1126,1126,1126,0,65700,65000,65000,0,0,700,700,0,0,13128,13128,13120,0,4410,300,100,90,120,621
2020,014600181,2400,2400,400,400,2000,0,0,0,0,0,0,0,0,0,0,0,0,0,1616,840,30,66,80,4
2020,014600301,7323,6723,5723,5723,1000,600,0,0,0,0,600,600,0,0,30,30,0,0,6318,888,230,720,280,121
2020,014600331,39786,15606,15606,15606,0,24180,22000,22000,0,0,2180,2180,0,0,0,0,0,0,3196,300,400,600,360,323
2020,014600361,13200,6400,6400,6400,0,6800,5000,0,5000,0,1800,1300,500,0,200,200,0,200,3880,300,100,300,180,298
2020,014600381,75826,19126,19126,19126,0,56700,56000,40000,16000,0,700,700,0,0,10000,0,0,0,2322,276,24,180,233,68
2020,014600391,77160,5260,5260,5260,0,71900,70800,5000,65800,0,1100,1100,0,0,42550,10550,10550,0,3036,818,150,336,132,186
2020,014700101,223500,56000,56000,56000,0,167500,165000,165000,0,0,2500,2500,0,0,0,0,0,0,8340,500,300,300,240,10040
2020,014700131,175860,32060,32060,32060,0,143800,140000,140000,0,0,3800,3800,0,0,10000,10000,10000,0,4662,660,60,150,36,2242
2020,014700151,19545,4545,4545,4545,0,15000,15000,15000,0,0,0,0,0,0,620,620,620,0,1604,76,50,108,144,272
2020,014700161,15426,15126,3126,3126,12000,300,0,0,0,0,300,300,0,0,0,0,0,0,2800,260,42,340,168,416
2020,014700181,925,925,50,50,875,0,0,0,0,0,0,0,0,0,0,0,0,0,782,210,12,72,32,1
2020,014700301,20680,4180,4180,4180,0,16500,15000,15000,0,0,1500,1500,0,0,30,30,0,0,2455,180,200,360,120,151
2020,014700331,224270,120,120,120,0,224150,176800,43800,133000,0,47350,4050,43300,0,173940,159940,153000,2000,3038,360,120,480,180,459
2020,014700351,75245,11131,11131,11131,0,64114,63000,63000,0,0,1114,210,904,0,0,0,0,0,4093,425,400,60,168,2845
2020,014700361,41490,500,500,500,0,40990,39000,39000,0,0,1990,1990,0,0,0,0,0,0,3100,500,700,250,220,157
2020,014700381,3019,2719,1919,1919,800,300,0,0,0,0,300,300,0,0,3760,3760,0,0,1580,150,100,80,120,97
2020,014700391,43359,12959,12959,12959,0,30400,27000,27000,0,0,3400,3400,0,0,107100,107100,16600,0,4140,600,300,400,240,141
2020,014800131,980,980,80,80,900,0,0,0,0,0,0,0,0,0,0,0,0,0,1157,244,250,20,36,1
2020,014800141,502,502,2,2,500,0,0,0,0,0,0,0,0,0,0,0,0,0,1016,216,50,30,120,1
2020,014800171,23611,22359,22359,22359,0,1252,0,0,0,0,1252,800,452,0,0,0,0,0,3562,180,150,260,72,100
2020,014800301,69770,5770,5770,5770,0,64000,63000,33000,30000,0,1000,1000,0,0,14500,7500,7500,0,3649,240,270,100,120,188
2020,014800311,126718,9208,9208,9208,0,117510,115000,65000,50000,0,2510,2510,0,0,51000,24000,24000,0,5401,275,170,375,268,156
2020,014800321,72320,4220,2220,220,2000,68100,65000,0,65000,0,3100,1800,1300,0,16830,9830,9530,0,4960,1220,2160,180,120,108
2020,014800381,40908,36608,6608,6608,30000,4300,4000,0,4000,0,300,300,0,0,8500,8500,8000,0,2520,120,30,240,120,186
2020,014800391,192630,130,130,130,0,192500,190000,40000,150000,0,2500,2500,0,0,92160,92160,90000,0,1558,290,10,320,168,610
2020,014900101,78700,3500,3500,3500,0,75200,75000,75000,0,0,200,200,0,0,0,0,0,0,6984,80,400,300,204,754
2020,014900121,86220,13640,6640,6640,7000,72580,72500,0,68000,4500,80,80,0,0,36100,4100,0,4100,4765,210,15,360,240,113
2020,014900131,85940,640,640,640,0,85300,85000,85000,0,0,300,300,0,0,6825,6825,6825,0,1890,300,50,100,110,128
2020,014900151,750,750,250,250,500,0,0,0,0,0,0,0,0,0,0,0,0,0,969,432,120,12,20,1
2020,014900171,24100,1100,1100,1100,0,23000,23000,23000,0,0,0,0,0,0,0,0,0,0,876,96,30,6,74,35
2020,014900301,43090,2540,2540,2540,0,40550,40000,40000,0,0,550,550,0,0,8740,8740,7800,340,6112,360,120,400,312,480
2020,014900311,181355,75205,75205,75205,0,106150,99000,65000,14000,20000,7150,3650,3500,0,7500,7000,0,0,6865,920,540,850,325,2850
2020,014900321,29238,7108,7108,7108,0,22130,21000,21000,0,0,1130,130,1000,0,0,0,0,0,2839,365,120,304,120,167
2020,014900361,31271,291,291,291,0,30980,30000,30000,0,0,980,980,0,0,7070,7070,0,0,2550,300,350,720,180,45
2020,014900381,43088,13588,13588,13588,0,29500,28500,28500,0,0,1000,1000,0,0,0,0,0,0,2185,264,36,468,115,189
2020,014900391,39363,26440,7440,7440,19000,12923,11000,0,11000,0,1923,1123,800,0,8850,6600,6600,0,2734,240,10,240,204,68
2020,015000102,50,50,50,50,0,0,0,0,0,0,0,0,0,0,0,0,0,0,285,50,60,10,30,1
2020,015000162,1060,1060,60,60,1000,0,0,0,0,0,0,0,0,0,884,884,0,0,1255,240,700,10,15,0
2020,015000182,29206,29206,5006,5006,24200,0,0,0,0,0,0,0,0,0,19000,19000,19000,0,1501,120,25,72,84,49
2020,015000302,32569,359,359,359,0,32210,32000,32000,0,0,210,210,0,0,0,0,0,0,2514,284,185,291,204,88
2020,015000312,17773,15773,273,273,15500,2000,0,0,0,0,2000,2000,0,0,12000,12000,12000,0,2160,240,20,240,300,73
2020,015000322,7496,7496,3196,3196,4300,0,0,0,0,0,0,0,0,0,0,0,0,0,1040,204,20,300,96,2
2020,015000342,177120,120,120,120,0,177000,176000,26000,150000,0,1000,1000,0,0,95000,0,0,0,1685,240,180,120,75,249
2020,015000372,34756,11656,11656,11656,0,23100,20600,18000,2600,0,2500,2500,0,0,70,70,0,0,2408,268,150,100,240,184
2020,015000382,1733,1403,1103,1103,300,330,0,0,0,0,330,330,0,0,0,0,0,0,3420,180,10,600,120,213
2020,015000392,5250,5250,450,450,4800,0,0,0,0,0,0,0,0,0,4200,4200,4200,0,1564,144,50,70,120,45
2020,015600111,800,800,300,300,500,0,0,0,0,0,0,0,0,0,0,0,0,0,1595,600,15,60,240,25
2020,015600131,65800,5500,5500,5500,0,60300,60000,60000,0,0,300,300,0,0,7000,7000,5000,2000,6045,360,200,500,300,92
2020,015600141,42300,4190,4190,4190,0,38110,33000,15000,18000,0,5110,2850,2260,0,16250,2250,2000,0,4672,600,400,660,373,141
2020,015600301,77195,42943,42943,42943,0,34252,32000,32000,0,0,2252,1800,452,0,0,0,0,0,6390,300,100,1000,400,2644
2020,015600311,66655,29135,29135,29135,0,37520,34000,34000,0,0,3520,3300,220,0,0,0,0,0,5923,264,142,230,696,10143
2020,015600321,2724,1953,1953,1953,0,771,0,0,0,0,771,771,0,0,1836,1836,1400,0,4910,638,600,745,460,265
2020,015600371,11288,2288,2288,2288,0,9000,9000,9000,0,0,0,0,0,0,110,110,0,0,3640,240,120,384,312,12
2020,015600381,82950,27350,27350,26350,0,55600,52000,52000,0,0,3600,1800,800,1000,14100,14100,14000,0,5187,1116,310,360,345,537
2020,015600391,8856,8400,8400,8400,0,456,0,0,0,0,456,230,226,0,350,350,0,100,4003,312,125,360,216,37
2020,015700141,90182,37730,37730,37730,0,52452,52000,52000,0,0,452,0,452,0,0,0,0,0,4104,420,240,480,300,630
2020,015700191,426766,110366,38366,22366,72000,316400,300000,0,300000,0,16400,13400,3000,0,105000,40000,40000,0,9860,720,100,400,320,3789
2020,015700301,10800,800,800,800,0,10000,10000,10000,0,0,0,0,0,0,0,0,0,0,2000,240,40,180,84,8
2020,015700311,86365,17365,17365,17365,0,69000,69000,14000,55000,0,0,0,0,0,12000,12000,12000,0,1633,241,194,205,72,73
2020,015700351,61371,27460,27460,27460,0,33911,30000,30000,0,0,3911,3711,200,0,0,0,0,0,3057,300,43,520,264,271
2020,015700371,27788,13908,13908,13908,0,13880,12000,12000,0,0,1880,1880,0,0,0,0,0,0,712,126,10,40,36,132
2020,015700381,14460,10860,10860,9860,0,3600,0,0,0,0,3600,2600,1000,0,3552,3552,0,1550,3292,423,280,420,300,86
2020,015700391,12920,12891,6891,6891,6000,29,0,0,0,0,29,29,0,0,800,800,0,800,2664,560,100,216,276,77
2020,015800111,58284,9184,9184,9184,0,49100,48000,48000,0,0,1100,1100,0,0,4800,4800,4800,0,4852,252,120,100,180,262
2020,015800131,24996,24996,4996,4996,20000,0,0,0,0,0,0,0,0,0,0,0,0,0,1654,134,100,180,240,14
2020,015800141,9200,9200,1700,1700,7500,0,0,0,0,0,0,0,0,0,0,0,0,0,984,144,40,72,96,56
2020,015800151,6645,6645,645,645,6000,0,0,0,0,0,0,0,0,0,9600,9600,0,9600,2318,530,240,68,300,81
2020,015800191,150200,200,200,200,0,150000,150000,150000,0,0,0,0,0,0,0,0,0,0,1510,360,120,120,120,211
2020,015800321,69884,934,934,934,0,68950,68000,68000,0,0,950,500,450,0,30000,30000,30000,0,3070,390,180,520,210,121
2020,015800331,26560,1330,1330,1330,0,25230,24000,24000,0,0,1230,1230,0,0,16307,16307,16000,0,3500,288,20,420,240,187
2020,015800351,3270,2270,1770,1270,500,1000,0,0,0,0,1000,1000,0,0,4700,4700,0,3000,1398,648,10,300,48,22
2020,015800371,1220,1220,10,10,1210,0,0,0,0,0,0,0,0,0,8000,8000,5000,3000,540,90,10,20,100,1
2020,015900111,228954,62454,29454,29454,33000,166500,165000,0,165000,0,1500,1500,0,0,98500,88000,87000,1000,10202,600,12,600,240,492
2020,015900131,1200,1200,800,800,400,0,0,0,0,0,0,0,0,0,0,0,0,0,582,147,0,20,26,1
2020,015900151,41460,6960,6960,5960,0,34500,34000,26000,0,8000,500,500,0,0,0,0,0,0,3350,96,50,120,384,731
2020,015900161,4820,4820,1020,1020,3800,0,0,0,0,0,0,0,0,0,3760,3760,3100,300,1632,540,0,60,180,1
2020,015900191,80817,4850,4850,4850,0,75967,75717,60000,15717,0,250,250,0,0,3000,0,0,0,1026,132,340,160,84,107
2020,015900301,1343,551,51,51,500,792,0,0,0,0,792,792,0,0,0,0,0,0,3570,550,150,120,360,36
2020,015900311,9003,3,3,3,0,9000,9000,4000,5000,0,0,0,0,0,2800,800,0,800,550,96,150,60,24,11
2020,015900331,28566,1716,1716,1716,0,26850,26500,17000,9500,0,350,350,0,0,14400,14100,14100,0,1534,180,10,250,204,111
2020,015900341,64798,2498,2498,2498,0,62300,60000,60000,0,0,2300,2300,0,0,25000,25000,25000,0,2790,500,50,250,300,123
2020,015900351,1180,550,50,50,500,630,0,0,0,0,630,630,0,0,0,0,0,0,2370,540,0,360,120,12
2020,015900371,24164,4897,4897,3897,0,19267,18000,18000,0,0,1267,0,267,1000,3963,3963,3963,0,3538,1730,50,216,108,30
2020,015900381,43220,2270,2270,2270,0,40950,38000,38000,0,0,2950,1950,1000,0,6600,6600,6600,0,2070,295,95,60,180,72
2020,015900391,22550,2000,2000,2000,0,20550,20000,20000,0,0,550,550,0,0,0,0,0,0,2240,940,60,120,60,48
2020,016000112,2680,2680,180,180,2500,0,0,0,0,0,0,0,0,0,0,0,0,0,606,106,110,10,10,1
2020,016000122,920,420,420,420,0,500,0,0,0,0,500,500,0,0,0,0,0,0,4334,120,50,480,300,74
2020,016000132,21130,3130,3130,3130,0,18000,18000,18000,0,0,0,0,0,0,4670,4670,4670,0,1516,240,110,360,216,188
2020,016000152,77470,37020,28020,28020,9000,40450,40000,0,40000,0,450,450,0,0,31000,0,0,0,1496,624,60,60,36,288
2020,016000162,142540,12540,12540,12540,0,130000,120000,100000,0,20000,10000,10000,0,0,10450,10450,10000,0,3925,600,120,90,600,367
2020,016000182,89150,35810,7810,7810,28000,53340,52000,0,52000,0,1340,1100,240,0,28000,0,0,0,5130,360,20,350,336,351
2020,016000302,2540,2040,40,40,2000,500,0,0,0,0,500,500,0,0,900,900,0,900,1586,240,20,144,288,16
2020,016000322,27500,27100,20600,20600,6500,400,0,0,0,0,400,400,0,0,3500,3500,0,3500,3502,132,300,480,120,134
2020,016000342,23930,23420,420,420,23000,510,0,0,0,0,510,310,200,0,0,0,0,0,3240,0,400,540,240,563
2020,016000352,56700,700,700,700,0,56000,56000,56000,0,0,0,0,0,0,0,0,0,0,1136,300,10,180,66,69
2020,016000362,308000,17700,17700,17700,0,290300,290000,50000,240000,0,300,300,0,0,28500,8500,8500,0,3180,360,1000,120,120,935
2020,016000382,134800,16600,16600,6300,0,118200,115000,65000,50000,0,3200,3200,0,0,1500,0,0,0,3819,500,500,275,252,725
2020,016000392,31432,7412,7412,7412,0,24020,22700,11700,11000,0,1320,1320,0,0,6000,0,0,0,5149,256,105,623,288,130
2020,016600121,27397,7539,7539,7539,0,19858,18000,18000,0,0,1858,1700,158,0,740,740,740,0,1981,182,90,432,112,48
2020,016600131,328,328,53,53,275,0,0,0,0,0,0,0,0,0,0,0,0,0,693,122,501,3,22,1
2020,016600141,14620,620,620,620,0,14000,14000,14000,0,0,0,0,0,0,0,0,0,0,1793,112,60,148,84,56
2020,016600151,32746,32746,5746,5746,27000,0,0,0,0,0,0,0,0,0,17110,17110,17000,0,2021,252,36,324,144,23
2020,016600171,100306,9926,9926,9926,0,90380,90000,90000,0,0,380,300,80,0,200,200,0,200,4134,300,30,354,240,850
2020,016600311,57300,7300,7300,7300,0,50000,50000,50000,0,0,0,0,0,0,0,0,0,0,1104,600,10,72,12,74
2020,016600321,78680,5680,5680,5680,0,73000,73000,18000,55000,0,0,0,0,0,5000,5000,5000,0,2562,360,400,180,132,115
2020,016600341,22776,6776,6776,6776,0,16000,15000,15000,0,0,1000,1000,0,0,2670,2670,670,2000,2017,276,30,230,240,69
2020,016600351,46070,12870,12870,12870,0,33200,16000,16000,0,0,17200,1000,200,16000,50,50,0,0,4360,280,100,520,150,39
2020,016700111,3017,3017,17,17,3000,0,0,0,0,0,0,0,0,0,70,70,0,0,1835,240,5,36,134,0
2020,016700121,17354,17354,2354,2354,15000,0,0,0,0,0,0,0,0,0,15000,15000,15000,0,1390,240,30,120,120,48
2020,016700141,121330,330,330,330,0,121000,121000,101000,20000,0,0,0,0,0,500,0,0,0,1068,172,400,10,36,149
2020,016700161,91034,4534,4534,4534,0,86500,86500,85000,1500,0,0,0,0,0,500,0,0,0,1224,180,84,50,180,66
2020,016700311,44706,6506,6506,6506,0,38200,38000,38000,0,0,200,200,0,0,14200,14200,12700,1500,7009,688,315,316,240,956
2020,016700351,44782,782,782,782,0,44000,43000,43000,0,0,1000,1000,0,0,24930,24930,24180,600,2100,240,200,180,140,112
2020,016700361,94990,7490,7490,1490,0,87500,85000,65000,20000,0,2500,2500,0,0,22900,22900,21800,0,6800,400,600,400,200,194
2020,016700371,42950,1250,1250,1250,0,41700,36700,36700,0,0,5000,5000,0,0,37600,37600,22000,12600,3850,440,210,240,360,1539
2020,016800101,2510,2510,10,10,2500,0,0,0,0,0,0,0,0,0,0,0,0,0,881,180,0,0,36,1
2020,016800111,18020,18020,20,20,18000,0,0,0,0,0,0,0,0,0,6000,6000,5800,0,3776,360,30,120,216,276
2020,016800121,19730,19300,2300,2300,17000,430,0,0,0,0,430,300,130,0,7700,7700,5500,2200,2440,250,220,400,300,331
2020,016800131,98329,3729,3729,729,0,94600,90000,90000,0,0,4600,4600,0,0,15000,15000,13000,2000,2590,300,300,150,360,187
2020,016800141,113665,22065,22065,21565,0,91600,90000,90000,0,0,1600,1600,0,0,1860,1860,1700,160,4160,240,360,380,200,458
2020,016800151,189610,12510,12510,1010,0,177100,170000,150000,20000,0,7100,2500,4600,0,115000,35000,35000,0,3086,282,500,684,180,2463
2020,016800161,13000,13000,3000,2500,10000,0,0,0,0,0,0,0,0,0,8000,8000,8000,0,802,60,20,60,60,15
2020,016800171,64163,2050,2050,2050,0,62113,62000,62000,0,0,113,0,113,0,3000,0,0,0,1549,204,340,0,120,71
2020,016800181,6200,6200,100,100,6100,0,0,0,0,0,0,0,0,0,1700,1700,0,1700,1140,120,0,120,120,1
2020,016800301,41110,5460,5460,5460,0,35650,35500,17500,18000,0,150,150,0,0,13000,0,0,0,1650,230,50,150,110,36
2020,016800311,26576,7046,7046,7046,0,19530,17500,17500,0,0,2030,2030,0,0,1736,1736,1736,0,4210,230,50,320,210,340
2020,016800321,2256,2256,1456,1456,800,0,0,0,0,0,0,0,0,0,0,0,0,0,660,252,60,12,60,1
2020,016800351,7725,5425,1425,1425,4000,2300,1300,0,0,1300,1000,1000,0,0,12,12,0,0,3959,520,108,300,255,76
2020,016800381,2036,2036,296,296,1740,0,0,0,0,0,0,0,0,0,0,0,0,0,703,180,0,24,18,0
2020,016800391,31816,8316,8316,8316,0,23500,23500,20500,3000,0,0,0,0,0,0,0,0,0,1460,150,120,60,60,43
2020,016900101,2872,2772,772,772,2000,100,0,0,0,0,100,100,0,0,0,0,0,0,2920,1140,20,360,180,23
2020,016900121,303,303,26,26,277,0,0,0,0,0,0,0,0,0,0,0,0,0,708,132,5,30,78,1
2020,016900151,92120,11230,11230,11230,0,80890,80000,80000,0,0,890,190,700,0,100,100,0,0,1981,267,240,180,246,493
2020,016900161,86300,5600,600,600,5000,80700,80000,0,80000,0,700,700,0,0,74365,31365,27000,4300,2440,880,100,300,240,97
2020,016900191,191900,51800,51800,51800,0,140100,140000,70000,70000,0,100,100,0,0,10000,0,0,0,1640,560,100,120,40,982
2020,016900311,6020,6020,1420,1420,4600,0,0,0,0,0,0,0,0,0,1650,1650,1650,0,1662,216,160,240,156,2
2020,016900371,62214,5114,5114,5114,0,57100,57000,57000,0,0,100,100,0,0,3385,3385,2165,1220,4044,240,120,300,144,1167
2020,017000122,734,734,234,234,500,0,0,0,0,0,0,0,0,0,0,0,0,0,683,340,1,12,42,1
2020,017000132,4310,1310,310,310,1000,3000,0,0,0,0,3000,3000,0,0,2000,2000,0,2000,2170,300,10,150,100,128
2020,017000142,235200,200,200,200,0,235000,230000,130000,100000,0,5000,5000,0,0,23000,15000,15000,0,3820,600,300,500,120,1652
2020,017000152,40260,39960,5960,5960,34000,300,0,0,0,0,300,300,0,0,0,0,0,0,3600,250,300,200,200,135
2020,017000162,39840,36840,5840,5840,31000,3000,0,0,0,0,3000,3000,0,0,0,0,0,0,3103,121,400,300,132,1350
2020,017000182,15440,15440,440,440,15000,0,0,0,0,0,0,0,0,0,870,870,870,0,2500,100,30,140,170,159
2020,017000192,170200,20200,20200,20200,0,150000,150000,150000,0,0,0,0,0,0,15000,0,0,0,1936,240,72,60,90,288
2020,017000302,3793,1000,1000,1000,0,2793,2743,2743,0,0,50,50,0,0,0,0,0,0,1713,235,10,48,120,12
2020,017000312,12770,12320,320,310,12000,450,0,0,0,0,450,450,0,0,1312,1312,0,800,4800,720,50,360,300,71
2020,017000322,56125,13425,13425,13425,0,42700,37000,37000,0,0,5700,5400,300,0,0,0,0,0,4284,220,20,180,144,262
2020,017000332,40521,4021,4021,4021,0,36500,30000,30000,0,0,6500,4000,2500,0,12000,12000,12000,0,3560,280,50,500,180,162
2020,017000342,33726,926,926,926,0,32800,30000,30000,0,0,2800,2800,0,0,6000,6000,6000,0,1290,240,280,15,20,26
2020,017000352,36058,4158,4158,4158,0,31900,30900,30900,0,0,1000,1000,0,0,0,0,0,0,3791,240,36,240,240,186
2020,017000362,36775,4875,4875,4875,0,31900,31000,31000,0,0,900,900,0,0,7530,7530,7500,0,4940,420,100,600,240,391
2020,017000372,48588,9888,9888,9888,0,38700,35000,35000,0,0,3700,3700,0,0,2400,2400,0,2400,3694,384,0,540,240,662
2020,017000382,53160,5160,5160,3160,0,48000,43000,43000,0,0,5000,5000,0,0,9664,9664,8000,0,7164,384,60,648,192,406
2020,017000392,29512,26812,8812,8812,18000,2700,0,0,0,0,2700,2700,0,0,0,0,0,0,3847,277,400,200,350,552
2020,017600101,109160,38560,38560,38560,0,70600,70000,70000,0,0,600,600,0,0,0,0,0,0,4920,300,600,240,360,297
2020,017600131,106851,15976,3976,3976,12000,90875,90875,0,90875,0,0,0,0,0,46000,26000,26000,0,2628,204,200,296,144,281
2020,017600141,72921,2721,2721,2721,0,70200,70000,50000,20000,0,200,200,0,0,29800,5800,2000,3800,6453,240,150,384,343,207
2020,017600151,11534,11534,8034,8034,3500,0,0,0,0,0,0,0,0,0,0,0,0,0,2059,168,500,204,120,21
2020,017600161,241180,680,680,680,0,240500,240000,140000,100000,0,500,500,0,0,37600,37600,33600,0,3561,461,120,240,300,405
2020,017600191,10760,10760,760,760,10000,0,0,0,0,0,0,0,0,0,300,300,0,0,1412,240,30,108,104,216
2020,017600301,35208,6740,6740,6740,0,28468,28000,28000,0,0,468,400,68,0,6100,6100,6100,0,6164,492,120,250,360,426
2020,017600311,72591,35151,8151,8151,27000,37440,37300,0,33500,3800,140,140,0,0,31500,28200,22000,3000,4861,300,20,480,240,149
2020,017600331,86560,19360,19360,19360,0,67200,65000,65000,0,0,2200,2200,0,0,36100,36100,36100,0,5500,500,200,300,400,8540
2020,017600341,15650,15650,650,650,15000,0,0,0,0,0,0,0,0,0,3000,3000,3000,0,2868,480,120,180,60,95
2020,017600351,89898,5568,5568,5568,0,84330,82250,23000,59250,0,2080,1580,500,0,25000,0,0,0,2130,300,50,500,120,315
2020,017600361,40,40,40,40,0,0,0,0,0,0,0,0,0,0,0,0,0,0,631,124,280,24,48,1
2020,017600371,38,28,28,28,0,10,0,0,0,0,10,0,10,0,0,0,0,0,594,168,68,20,42,6
2020,017700101,70240,68240,28240,28240,40000,2000,0,0,0,0,2000,1500,500,0,0,0,0,0,6312,360,48,508,156,315
2020,017700111,40198,28898,6898,2498,22000,11300,0,0,0,0,11300,300,11000,0,27200,27200,17600,2500,3300,200,50,300,360,18
2020,017700121,3042,3042,2042,2042,1000,0,0,0,0,0,0,0,0,0,160,160,0,0,1878,720,10,72,216,1
2020,017700141,3280,3050,3050,3050,0,230,0,0,0,0,230,230,0,0,800,800,800,0,976,100,10,80,72,41
2020,017700151,9210,9210,210,210,9000,0,0,0,0,0,0,0,0,0,3000,3000,1000,2000,587,52,30,36,48,1
2020,017700171,64006,3025,3025,3025,0,60981,60000,60000,0,0,981,981,0,0,40800,40800,33000,7800,4740,480,800,420,240,240
2020,017700321,31970,5200,5200,5200,0,26770,24500,14500,10000,0,2270,2270,0,0,0,0,0,0,2513,360,120,165,120,2614
2020,017700331,83490,2690,2690,2690,0,80800,80000,80000,0,0,800,800,0,0,20400,20400,20000,400,4300,600,120,360,360,563
2020,017700341,14796,8896,8896,8896,0,5900,5550,5550,0,0,350,50,300,0,450,450,0,450,3025,300,500,400,75,8
2020,017700351,2847,2617,2617,2617,0,230,0,0,0,0,230,0,230,0,0,0,0,0,1032,96,200,60,48,51
2020,017700361,25302,23302,3302,3302,20000,2000,0,0,0,0,2000,2000,0,0,9900,9900,9900,0,1550,360,20,150,120,205
2020,017800111,46250,45850,5850,5850,40000,400,0,0,0,0,400,400,0,0,0,0,0,0,4020,480,120,360,360,1040
2020,017800121,34414,33014,9014,9014,24000,1400,0,0,0,0,1400,1400,0,0,12200,12200,10000,0,2670,250,20,70,120,43
2020,017800131,471040,42240,42240,42240,0,428800,425000,250000,175000,0,3800,3800,0,0,0,0,0,0,7660,420,120,500,420,6822
2020,017800151,134170,4070,4070,4070,0,130100,130000,130000,0,0,100,0,100,0,0,0,0,0,2374,414,360,120,60,227
2020,017800161,146900,73600,22600,22600,51000,73300,70000,0,70000,0,3300,3300,0,0,42000,0,0,0,3280,360,180,70,90,1754
2020,017800171,13564,13564,3564,3564,10000,0,0,0,0,0,0,0,0,0,0,0,0,0,1542,108,90,84,60,4
2020,017800181,238500,33000,33000,32000,0,205500,205000,200000,5000,0,500,500,0,0,2200,0,0,0,3110,400,300,380,290,675
2020,017800191,180285,285,285,285,0,180000,180000,180000,0,0,0,0,0,0,9000,0,0,0,1100,396,40,60,84,325
2020,017800301,30596,6496,6496,6496,0,24100,20900,20900,0,0,3200,3200,0,0,11400,11400,4000,7400,8770,400,150,370,320,1141
2020,017800311,460,460,10,10,450,0,0,0,0,0,0,0,0,0,0,0,0,0,1114,528,20,15,96,0
2020,017800321,191236,41210,41210,38210,0,150026,134000,30000,104000,0,16026,5800,10226,0,19000,0,0,0,8000,580,1200,920,480,904
2020,017800341,20018,4018,4018,4018,0,16000,16000,16000,0,0,0,0,0,0,2900,2900,2600,0,2199,504,15,360,180,113
2020,017800361,4556,4416,1416,1416,3000,140,0,0,0,0,140,140,0,0,300,300,0,300,3142,300,60,76,300,14
2020,017800371,12530,530,530,530,0,12000,12000,12000,0,0,0,0,0,0,0,0,0,0,1162,183,240,96,72,21
2020,017800381,69648,4148,4148,4148,0,65500,65000,30000,35000,0,500,500,0,0,14400,14400,9400,5000,1956,250,500,200,96,60
2020,017900101,55182,9632,9632,9632,0,45550,42000,42000,0,0,3550,550,3000,0,0,0,0,0,2752,320,40,480,380,479
2020,017900111,89754,11754,11754,11754,0,78000,75000,0,75000,0,3000,3000,0,0,145,145,0,0,1142,150,100,156,156,244
2020,017900121,62820,2820,2820,2820,0,60000,60000,0,60000,0,0,0,0,0,20000,0,0,0,1295,136,70,8,66,53
2020,017900141,15770,15770,14770,14770,1000,0,0,0,0,0,0,0,0,0,0,0,0,0,2560,420,100,180,360,259
2020,017900151,193092,3892,3892,3892,0,189200,180000,180000,0,0,9200,1200,0,8000,78000,1000,1000,0,2470,240,120,240,180,334
2020,017900161,335,335,35,35,300,0,0,0,0,0,0,0,0,0,0,0,0,0,407,169,10,6,30,1
2020,017900171,105350,9450,9450,9450,0,95900,95000,95000,0,0,900,900,0,0,10030,10030,10000,0,5840,500,100,600,300,899
2020,017900301,9177,8807,307,307,8500,370,0,0,0,0,370,370,0,0,6250,6250,6000,0,1674,360,20,144,240,9
2020,017900311,1095,1095,95,95,1000,0,0,0,0,0,0,0,0,0,800,800,0,800,2155,750,50,320,60,7
2020,017900331,16667,4623,2223,2223,2400,12044,0,0,0,0,12044,11950,68,26,6560,6560,0,0,3584,384,120,264,420,59
2020,017900341,62610,6210,6210,6210,0,56400,55000,35000,20000,0,1400,1400,0,0,22055,16055,14096,1959,7220,420,50,850,600,259
2020,017900361,102096,18596,18596,18596,0,83500,74000,52000,22000,0,9500,9500,0,0,32000,17000,16000,0,8080,1360,150,750,240,2098
2020,017900371,70020,20,20,20,0,70000,56000,22000,34000,0,14000,8600,400,5000,38600,38600,29800,0,3700,420,200,600,350,197
2020,017900381,33320,16420,16420,16420,0,16900,16000,16000,0,0,900,800,100,0,8900,8900,8900,0,4000,260,150,480,306,137
2020,018000102,76401,401,401,401,0,76000,76000,16000,60000,0,0,0,0,0,30000,27000,27000,0,1320,180,0,120,120,101
2020,018000142,163720,8320,8320,8320,0,155400,155000,80000,75000,0,400,400,0,0,15800,0,0,0,2752,320,120,360,120,218
2020,018000172,5230,3030,2030,30,1000,2200,0,0,0,0,2200,2200,0,0,1000,1000,0,0,1990,1200,20,300,260,13
2020,018000312,430,130,130,130,0,300,0,0,0,0,300,300,0,0,0,0,0,0,1800,360,20,490,110,17
2020,018000322,1202,1202,2,2,1200,0,0,0,0,0,0,0,0,0,0,0,0,0,652,96,0,36,120,0
2020,018000342,10600,600,600,600,0,10000,10000,8000,2000,0,0,0,0,0,2000,2000,2000,0,1070,150,180,30,30,27
2020,018600101,187260,21760,21760,21760,0,165500,165000,120000,45000,0,500,500,0,0,10000,0,0,0,1900,360,120,240,120,276
2020,018600121,315830,5130,5130,5130,0,310700,310000,310000,0,0,700,0,700,0,0,0,0,0,2126,750,300,50,72,972
2020,018600311,2492,2492,492,492,2000,0,0,0,0,0,0,0,0,0,0,0,0,0,798,120,62,20,36,1
2020,018600331,4230,2630,1630,1630,1000,1600,0,0,0,0,1600,1600,0,0,1500,1500,0,0,1865,180,25,320,320,151
2020,018700101,180880,29450,29450,24450,0,151430,150000,150000,0,0,1430,300,1130,0,22350,350,0,0,2885,180,300,288,204,419
2020,018700111,1465,1465,465,465,1000,0,0,0,0,0,0,0,0,0,0,0,0,0,1107,360,300,24,16,0
2020,018700121,935100,603000,603000,603000,0,332100,330000,200000,130000,0,2100,2000,100,0,4000,0,0,0,5860,540,1020,240,60,6354
2020,018700131,252476,50420,50420,50420,0,202056,200000,200000,0,0,2056,1830,226,0,0,0,0,0,8230,600,150,120,180,52098
2020,018700171,1120,1120,120,120,1000,0,0,0,0,0,0,0,0,0,1000,1000,0,1000,1574,672,100,72,120,1
2020,018700321,35852,11352,11352,11352,0,24500,23000,19000,0,4000,1500,1500,0,0,0,0,0,0,5650,390,240,240,210,849
2020,018700341,135080,2980,2980,2980,0,132100,128000,50000,78000,0,4100,4100,0,0,30400,30400,27000,3000,6450,600,250,530,320,210
2020,018800111,178200,15200,15200,9200,0,163000,163000,150000,13000,0,0,0,0,0,0,0,0,0,2550,300,200,200,150,601
2020,018800141,24100,7100,100,100,7000,17000,17000,0,17000,0,0,0,0,0,0,0,0,0,887,150,240,5,72,7
2020,018800161,427540,32540,32540,32540,0,395000,390000,120000,270000,0,5000,0,5000,0,43500,0,0,0,8764,600,520,24,240,12591
2020,018800181,36710,3610,3610,3610,0,33100,33100,29100,4000,0,0,0,0,0,1000,1000,0,1000,928,120,100,24,72,11
2020,018800191,5800,5800,800,800,5000,0,0,0,0,0,0,0,0,0,0,0,0,0,1523,660,35,96,60,26
2020,018800301,104777,37277,17277,17277,20000,67500,65000,0,65000,0,2500,2500,0,0,52034,31834,27834,4000,4770,480,100,300,240,225
2020,018900101,114538,3738,3738,1238,0,110800,110000,110000,0,0,800,800,0,0,34100,34100,34000,0,2500,300,30,150,200,127
2020,018900121,18336,18336,9836,9836,8500,0,0,0,0,0,0,0,0,0,580,580,580,0,3693,719,50,60,204,14
2020,018900131,5025,5025,1225,1225,3800,0,0,0,0,0,0,0,0,0,0,0,0,0,676,108,18,0,30,1
2020,018900141,841,841,41,41,800,0,0,0,0,0,0,0,0,0,0,0,0,0,553,120,10,10,18,1
2020,018900181,4350,4350,100,100,4250,0,0,0,0,0,0,0,0,0,0,0,0,0,1344,399,10,60,72,1
2020,018900301,248590,30540,30540,30540,0,218050,190000,30000,139000,21000,28050,3050,25000,0,0,0,0,0,4786,720,180,240,96,557
2020,018900311,3230,3000,3000,3000,0,230,0,0,0,0,230,230,0,0,0,0,0,0,1025,120,24,240,30,31
2020,018900321,25706,4106,4106,4106,0,21600,21500,17000,4500,0,100,100,0,0,0,0,0,0,1530,200,50,150,70,15
2020,019000102,103300,18200,18200,18200,0,85100,85000,70000,15000,0,100,100,0,0,3500,0,0,0,3900,500,400,400,200,1949
2020,019000112,88250,3000,3000,3000,0,85250,85000,85000,0,0,250,250,0,0,0,0,0,0,3240,300,500,240,240,280
2020,019000122,26280,24780,10780,780,14000,1500,0,0,0,0,1500,1500,0,0,0,0,0,0,4399,120,5,600,84,61
2020,019000132,230820,15820,15820,15820,0,215000,215000,215000,0,0,0,0,0,0,36000,36000,36000,0,5284,500,1700,96,360,2082
2020,019000142,222750,22000,22000,22000,0,200750,200000,200000,0,0,750,750,0,0,0,0,0,0,3300,240,100,30,60,670
2020,019000162,85774,5264,5264,5264,0,80510,78000,75000,3000,0,2510,2290,220,0,2900,2900,2500,0,4546,276,36,180,264,167
2020,019000172,163340,77560,77560,77560,0,85780,75500,71000,4500,0,10280,3500,6780,0,0,0,0,0,3990,288,100,50,420,875
2020,019000182,12089,5289,3289,3289,2000,6800,6600,0,0,6600,200,200,0,0,0,0,0,0,2467,987,120,360,216,49
2020,019000192,53197,2197,2197,2197,0,51000,51000,32000,19000,0,0,0,0,0,30300,20300,17800,0,2450,60,600,300,300,69
2020,019600111,272024,11624,11624,11624,0,260400,260000,260000,0,0,400,400,0,0,0,0,0,0,3335,480,100,100,240,569
2020,019700101,4780,4530,1380,1380,3150,250,0,0,0,0,250,200,50,0,1200,1200,1200,0,2330,240,50,360,120,16
2020,019700131,64720,2320,2320,2320,0,62400,60000,60000,0,0,2400,1200,1200,0,25900,25900,23800,2000,3798,284,10,300,204,171
2020,019700141,20690,20690,3690,3690,17000,0,0,0,0,0,0,0,0,0,14900,14900,11900,3000,920,240,20,20,40,87
2020,019700161,188800,57600,27600,27600,30000,131200,127200,0,127200,0,4000,4000,0,0,108700,79000,69000,6000,8000,3600,200,1000,300,924
2020,019700171,283452,21000,21000,21000,0,262452,244000,140000,104000,0,18452,18000,452,0,25800,7800,7800,0,4460,360,10,600,100,398
2020,019700191,6200,6200,200,200,6000,0,0,0,0,0,0,0,0,0,4600,4600,4600,0,830,70,120,60,40,1
2020,019800101,417656,930,930,930,0,416726,415000,130000,285000,0,1726,1500,226,0,91000,16000,16000,0,5920,600,650,520,100,439
2020,019800121,81220,5820,5820,5820,0,75400,75000,75000,0,0,400,400,0,0,0,0,0,0,1662,240,150,180,96,290
2020,019800131,80680,5180,5180,5180,0,75500,75000,75000,0,0,500,500,0,0,2700,0,0,0,2572,240,60,648,228,508
2020,019800151,47318,8778,8778,8778,0,38540,38500,35000,3500,0,40,40,0,0,0,0,0,0,1557,96,240,150,109,79
2020,019800161,26866,24566,5566,5566,19000,2300,0,0,0,0,2300,2300,0,0,9000,9000,9000,0,3350,100,1000,240,300,961
2020,019800171,11553,11553,3053,3053,8500,0,0,0,0,0,0,0,0,0,5000,5000,5000,0,2486,300,100,72,180,1
2020,019800181,15600,15600,1600,1600,14000,0,0,0,0,0,0,0,0,0,0,0,0,0,1306,130,350,100,100,23
2020,019900101,24262,9662,4162,4162,5500,14600,10000,0,10000,0,4600,4600,0,0,5000,5000,0,1000,6480,960,400,1200,600,762
2020,019900131,81309,57959,12959,12959,45000,23350,23000,0,23000,0,350,350,0,0,12110,12110,12010,0,5500,500,600,300,200,464
2020,019900151,53928,7928,7928,7928,0,46000,38000,38000,0,0,8000,8000,0,0,14000,14000,14000,0,2990,240,100,360,340,289
2020,019900171,9110,9110,110,110,9000,0,0,0,0,0,0,0,0,0,1000,1000,0,1000,1460,200,150,200,150,7
2020,020000222,4050,50,50,50,0,4000,4000,4000,0,0,0,0,0,0,0,0,0,0,518,76,0,36,16,3
2020,020000242,8399,7073,7073,7073,0,1326,0,0,0,0,1326,1100,226,0,0,0,0,0,2841,240,260,290,192,582
2020,020000262,101530,1530,1530,1530,0,100000,100000,30000,70000,0,0,0,0,0,1150,0,0,0,1834,180,138,20,24,119
2020,020000272,1060,1060,60,60,1000,0,0,0,0,0,0,0,0,0,0,0,0,0,285,60,10,60,10,1
2020,020000282,16725,13425,12425,12425,1000,3300,0,0,0,0,3300,3300,0,0,4000,4000,0,4000,2878,1000,100,500,240,99
2020,020000312,11155,10155,7855,7855,2300,1000,0,0,0,0,1000,1000,0,0,1700,1700,1700,0,2082,396,60,120,180,21
2020,020000322,39778,5678,5678,4678,0,34100,32000,18000,14000,0,2100,2100,0,0,1000,0,0,0,2458,396,120,600,180,481
2020,020000332,46148,5048,5048,5048,0,41100,38000,25000,13000,0,3100,3100,0,0,29530,17030,17000,0,4246,1024,60,672,240,59
2020,020000342,6650,2250,250,250,2000,4400,4000,0,4000,0,400,400,0,0,3500,3500,0,3500,2636,936,30,250,100,52
2020,020000352,29300,8300,8300,5300,0,21000,18000,18000,0,0,3000,3000,0,0,8600,8600,8000,0,2364,144,120,600,200,285
2020,020000362,48050,3000,3000,3000,0,45050,45000,20000,25000,0,50,0,50,0,0,0,0,0,1110,300,150,50,30,65
2020,020000372,22060,18060,5060,5060,13000,4000,0,0,0,0,4000,4000,0,0,5000,5000,5000,0,3340,250,300,100,250,501
2020,020000382,25085,3885,1885,1885,2000,21200,19000,0,19000,0,2200,2200,0,0,15700,15700,11000,2000,2922,696,35,160,172,140
2020,020600211,10,10,10,10,0,0,0,0,0,0,0,0,0,0,0,0,0,0,351,132,6,10,16,1
2020,020600221,26249,7099,7099,5099,0,19150,15000,15000,0,0,4150,1300,850,2000,7570,7570,6500,1000,2750,300,200,300,300,422
2020,020600231,16897,16897,1397,1397,15500,0,0,0,0,0,0,0,0,0,2037,2037,2000,0,1204,120,50,20,30,1
2020,020600241,16010,3840,3840,3840,0,12170,12000,12000,0,0,170,0,170,0,30,30,0,0,800,120,20,60,40,16
2020,020600261,26330,330,330,330,0,26000,26000,26000,0,0,0,0,0,0,0,0,0,0,604,170,13,13,20,23
2020,020600271,39524,7424,7424,7424,0,32100,32000,32000,0,0,100,0,100,0,210,210,0,150,1400,240,60,180,120,39
2020,020600281,64311,8311,8311,8311,0,56000,56000,41000,15000,0,0,0,0,0,1200,0,0,0,860,90,70,30,50,99
2020,020600291,32180,2100,2100,2100,0,30080,30000,0,18000,12000,80,80,0,0,6632,6632,6632,0,1255,250,50,120,70,71
2020,020600311,24240,1100,1100,1100,0,23140,23000,18000,5000,0,140,140,0,0,40,40,0,0,1975,240,115,240,240,166
2020,020600321,70460,15260,15260,15260,0,55200,54000,24000,30000,0,1200,1200,0,0,12000,3000,3000,0,1866,216,240,60,72,1703
2020,020600371,1981,1981,981,981,1000,0,0,0,0,0,0,0,0,0,1500,1500,1500,0,836,586,48,10,42,1
2020,020600381,30995,1675,1675,1675,0,29320,18300,8300,10000,0,11020,1000,10020,0,6200,6200,0,6200,990,200,48,120,80,23
2020,020600391,40500,20300,20300,20300,0,20200,16500,16500,0,0,3700,1700,0,2000,0,0,0,0,3100,508,700,170,132,201
2020,020700221,2040,2040,540,540,1500,0,0,0,0,0,0,0,0,0,0,0,0,0,1107,240,500,10,22,1
2020,020700241,10100,100,100,100,0,10000,10000,10000,0,0,0,0,0,0,0,0,0,0,379,60,125,10,18,5
2020,020700261,38577,9057,9057,8057,0,29520,25000,25000,0,0,4520,2200,320,2000,21710,21710,17500,1600,2970,200,50,200,310,61
2020,020700271,35785,5675,5675,5675,0,30110,29000,20000,0,9000,1110,1050,60,0,0,0,0,0,2030,400,240,240,200,120
2020,020700291,42250,6170,6170,6170,0,36080,36000,26000,10000,0,80,80,0,0,0,0,0,0,3227,460,780,190,97,65
2020,020700311,57223,3400,3400,3400,0,53823,53500,4500,49000,0,323,0,323,0,0,0,0,0,1191,250,220,36,72,29
2020,020700331,80940,37120,6120,6120,31000,43820,39000,0,39000,0,4820,3200,1620,0,9900,7700,0,7700,2382,300,100,480,240,528
2020,020700341,33714,6664,6664,6664,0,27050,27000,27000,0,0,50,50,0,0,1600,1600,1600,0,1650,240,200,240,180,155
2020,020700351,41900,11900,11900,11900,0,30000,30000,30000,0,0,0,0,0,0,900,0,0,0,2577,261,480,120,60,83
2020,020700371,4100,4100,100,100,4000,0,0,0,0,0,0,0,0,0,3400,3400,0,3400,2160,252,100,240,276,32
2020,020700381,26730,8130,8130,8130,0,18600,17000,17000,0,0,1600,1600,0,0,300,300,0,300,3750,360,150,300,240,407
2020,020700391,11718,9418,9418,9418,0,2300,0,0,0,0,2300,2300,0,0,0,0,0,0,2025,220,50,250,120,28
2020,020800211,16317,6242,6242,6242,0,10075,10000,10000,0,0,75,75,0,0,2300,2300,1300,1000,2900,300,500,300,200,73
2020,020800221,350,350,150,150,200,0,0,0,0,0,0,0,0,0,0,0,0,0,1833,480,5,120,180,68
2020,020800231,30900,11400,3400,3400,8000,19500,18000,0,0,18000,1500,1500,0,0,11050,11050,0,11000,2290,700,30,100,100,381
2020,020800251,19590,9440,9440,5440,0,10150,10000,10000,0,0,150,0,150,0,3000,3000,3000,0,1075,190,10,66,74,23
2020,020800291,32505,200,200,200,0,32305,32000,18000,14000,0,305,230,75,0,0,0,0,0,1265,215,200,140,65,56
2020,020800311,36255,17155,17155,17155,0,19100,17000,8000,9000,0,2100,1100,1000,0,0,0,0,0,2689,1080,120,240,168,71
2020,020800321,11806,1506,1506,1506,0,10300,8700,8700,0,0,1600,1600,0,0,3898,3898,3000,0,4085,300,180,240,300,56
2020,020800331,42033,24633,24633,23633,0,17400,14000,14000,0,0,3400,3400,0,0,1400,1400,0,0,3816,836,350,80,320,282
2020,020800341,11676,3676,3676,3076,0,8000,8000,8000,0,0,0,0,0,0,2300,2300,1500,800,1644,156,20,48,180,86
2020,020800361,112868,1368,1368,1368,0,111500,110000,110000,0,0,1500,1500,0,0,15000,9000,9000,0,2440,200,600,120,100,628
2020,020900211,4350,4350,4050,4050,300,0,0,0,0,0,0,0,0,0,0,0,0,0,1482,600,20,120,120,1
2020,020900231,305,305,5,5,300,0,0,0,0,0,0,0,0,0,0,0,0,0,795,175,10,35,20,0
2020,020900241,26550,4700,4700,4700,0,21850,20000,20000,0,0,1850,1200,650,0,12000,12000,12000,0,4990,230,400,600,240,232
2020,020900251,74806,9130,9130,9130,0,65676,57500,25000,32500,0,8176,3950,4226,0,11874,9374,9350,0,6048,350,38,960,360,433
2020,020900281,19410,4210,4210,4210,0,15200,10000,10000,0,0,5200,200,0,5000,0,0,0,0,1385,168,100,276,61,28
2020,020900291,18220,2970,2970,2970,0,15250,15000,15000,0,0,250,150,100,0,8600,8600,8400,0,1896,400,50,450,180,71
2020,020900321,10590,90,90,90,0,10500,10500,10500,0,0,0,0,0,0,4600,4600,4600,0,781,180,20,12,84,66
2020,020900331,53025,17412,17412,17412,0,35613,27500,27500,0,0,8113,8000,113,0,4700,4700,4700,0,3985,240,100,240,240,244
2020,020900341,41200,200,200,200,0,41000,30000,30000,0,0,11000,11000,0,0,14000,14000,8000,3000,2650,500,600,600,120,100
2020,020900361,23500,9300,9300,9300,0,14200,11700,9000,2700,0,2500,2500,0,0,0,0,0,0,2060,300,400,360,120,161
2020,020900371,7290,990,990,990,0,6300,6000,6000,0,0,300,300,0,0,1033,1033,0,1000,1263,197,32,334,180,15
2020,020900381,8824,2574,2574,2574,0,6250,6000,6000,0,0,250,250,0,0,0,0,0,0,2086,280,48,678,132,40
2020,021000202,58800,38500,36500,36500,2000,20300,20000,0,0,20000,300,300,0,0,19000,19000,19000,0,5000,1000,150,300,120,810
2020,021000222,35388,4188,4188,4188,0,31200,26000,15000,11000,0,5200,5000,200,0,0,0,0,0,2240,180,200,360,180,269
2020,021000232,36660,5360,5360,5360,0,31300,29000,20000,9000,0,2300,2300,0,0,0,0,0,0,2340,300,60,600,240,134
2020,021000262,73230,30230,30230,30230,0,43000,43000,43000,0,0,0,0,0,0,0,0,0,0,1260,60,240,60,50,161
2020,021000272,30092,9692,9692,9692,0,20400,20000,20000,0,0,400,400,0,0,10100,10100,0,0,2770,168,260,100,290,54
2020,021000282,24630,630,630,630,0,24000,23000,23000,0,0,1000,1000,0,0,1000,1000,1000,0,3000,240,100,350,300,103
2020,021000292,23565,4865,4865,4865,0,18700,17000,17000,0,0,1700,1700,0,0,0,0,0,0,2660,210,110,240,300,154
2020,021000302,11308,10208,2208,2208,8000,1100,0,0,0,0,1100,1000,100,0,0,0,0,0,1800,300,100,100,100,165
2020,021000312,27600,10600,10600,10600,0,17000,17000,17000,0,0,0,0,0,0,1500,1500,1500,0,2532,350,1000,40,42,33
2020,021000322,10206,3556,3556,3556,0,6650,6000,0,6000,0,650,350,300,0,0,0,0,0,1664,186,36,240,72,41
2020,021000342,16260,3510,510,510,3000,12750,0,0,0,0,12750,750,0,12000,2000,2000,0,2000,1525,270,55,30,120,10
2020,021000352,77268,17018,16718,16718,300,60250,60000,0,60000,0,250,0,250,0,30000,0,0,0,4724,504,30,1200,180,105
2020,021000362,133180,3332,3332,3332,0,129848,125700,55000,70700,0,4148,3470,678,0,70000,47000,47000,0,2320,240,100,230,200,373
2020,021000372,13770,770,770,770,0,13000,13000,7000,6000,0,0,0,0,0,0,0,0,0,683,145,54,60,24,7
2020,021000382,11390,11390,10390,10390,1000,0,0,0,0,0,0,0,0,0,50,50,0,0,1572,720,36,24,72,37
2020,021000392,11452,4652,4652,4652,0,6800,5000,5000,0,0,1800,1300,500,0,1000,1000,0,0,1724,180,24,360,60,29
2020,021600201,47970,5420,5420,5420,0,42550,42000,36000,6000,0,550,350,200,0,0,0,0,0,2390,350,470,190,100,55
2020,021600211,452238,2238,1238,1238,1000,450000,400000,0,400000,0,50000,0,50000,0,292000,292000,287000,0,2306,1140,20,120,180,1214
2020,021600251,27322,7822,7822,5822,0,19500,15500,15500,0,0,4000,3000,1000,0,10750,10750,9750,0,4180,730,50,420,360,146
2020,021600261,50100,36100,36100,36100,0,14000,14000,14000,0,0,0,0,0,0,0,0,0,0,1123,300,150,10,98,135
2020,021600271,25628,4128,4128,2628,0,21500,20000,20000,0,0,1500,500,1000,0,13835,13835,13800,0,3200,364,15,320,224,63
2020,021600281,17830,3030,3030,3030,0,14800,14000,14000,0,0,800,800,0,0,3600,3600,3600,0,1957,400,120,180,120,13
2020,021600291,310000,5100,5100,5100,0,304900,291000,160000,131000,0,13900,2100,11800,0,22880,15880,15480,0,3290,500,380,600,140,233
2020,021600321,48030,43730,12730,12730,31000,4300,4000,0,4000,0,300,300,0,0,30000,30000,22000,8000,3984,720,240,240,240,654
2020,021600331,46754,6854,6854,6854,0,39900,36000,23000,13000,0,3900,3900,0,0,8500,8500,8500,0,3730,308,500,340,140,318
2020,021600351,13514,8864,8864,8864,0,4650,4500,4500,0,0,150,150,0,0,0,0,0,0,1914,141,460,180,120,214
2020,021600361,2148,2148,1848,1848,300,0,0,0,0,0,0,0,0,0,1060,1060,0,1060,1445,330,15,60,120,24
2020,021600381,24969,9246,9246,9246,0,15723,11000,11000,0,0,4723,4470,253,0,9610,9610,980,4000,4992,288,10,192,192,509
2020,021600391,17008,2808,2808,2808,0,14200,11000,11000,0,0,3200,2200,1000,0,280,280,280,0,3940,280,20,550,240,59
2020,021700201,10080,80,80,80,0,10000,10000,10000,0,0,0,0,0,0,0,0,0,0,595,150,30,10,42,13
2020,021700221,45320,11520,11520,11520,0,33800,30000,30000,0,0,3800,3800,0,0,11000,11000,6000,0,4060,200,10,50,250,100
2020,021700231,64780,4080,4080,4080,0,60700,60000,60000,0,0,700,700,0,0,24050,1050,1000,0,1289,65,200,110,64,81
2020,021700241,11200,11000,5000,5000,6000,200,0,0,0,0,200,200,0,0,0,0,0,0,4480,300,40,120,120,156
2020,021700311,11844,10844,2344,2344,8500,1000,0,0,0,0,1000,1000,0,0,4800,4800,4800,0,2692,312,10,360,360,51
2020,021700321,3092,2492,1192,1192,1300,600,0,0,0,0,600,600,0,0,0,0,0,0,1335,360,20,240,120,15
2020,021700331,34268,1258,1258,1258,0,33010,30800,3800,27000,0,2210,2150,60,0,0,0,0,0,966,106,100,180,120,63
2020,021700341,41353,4360,4360,4360,0,36993,36500,17000,19500,0,493,380,113,0,8000,0,0,0,1886,178,50,240,48,295
2020,021700361,7050,3000,3000,3000,0,4050,3500,3500,0,0,550,550,0,0,100,100,0,0,1023,100,20,150,23,25
2020,021700371,49400,7100,7100,7100,0,42300,38500,8500,30000,0,3800,800,3000,0,7000,7000,7000,0,1394,120,180,120,96,63
2020,021700391,30480,4180,4180,2180,0,26300,24500,20000,4500,0,1800,1800,0,0,300,300,0,300,2350,500,100,300,250,79
2020,021800201,20110,12410,2410,2410,10000,7700,0,0,0,0,7700,4700,0,3000,0,0,0,0,1402,216,30,300,96,29
2020,021800231,43062,11712,11712,11712,0,31350,31000,31000,0,0,350,350,0,0,0,0,0,0,2620,300,100,300,130,95
2020,021800241,103554,12154,12154,9154,0,91400,87000,25000,58000,4000,4400,4300,100,0,28500,13000,10000,3000,4600,400,300,600,200,546
2020,021800251,20300,300,300,300,0,20000,20000,20000,0,0,0,0,0,0,0,0,0,0,312,80,60,30,12,16
2020,021800261,21316,80,80,80,0,21236,20000,20000,0,0,1236,1100,136,0,0,0,0,0,1618,180,20,180,108,74
2020,021800281,35100,300,300,300,0,34800,34800,30000,4800,0,0,0,0,0,0,0,0,0,1586,250,250,30,50,43
2020,021800301,3189,189,189,189,0,3000,3000,3000,0,0,0,0,0,0,0,0,0,0,288,100,10,15,24,8
2020,021800311,12693,1354,1354,1354,0,11339,11000,11000,0,0,339,0,339,0,3000,3000,3000,0,2480,680,1200,20,30,14
2020,021800321,40379,11566,11566,11566,0,28813,28500,19000,9500,0,313,200,113,0,21300,14300,14300,0,3332,324,600,480,144,65
2020,021800331,34396,9996,9996,9996,0,24400,24000,24000,0,0,400,400,0,0,14000,14000,14000,0,1600,360,100,100,120,117
2020,021800341,24406,21806,5806,5806,16000,2600,0,0,0,0,2600,2600,0,0,7000,7000,0,7000,4434,390,150,760,240,461
2020,021800361,22680,15680,12180,10880,3500,7000,3000,0,3000,0,4000,1500,2500,0,650,650,0,0,1249,210,42,320,100,71
2020,021800371,24020,1700,1700,1700,0,22320,22000,10000,12000,0,320,200,120,0,0,0,0,0,1548,200,20,250,204,29
2020,021800381,250,250,50,50,200,0,0,0,0,0,0,0,0,0,750,750,0,0,1334,450,24,40,60,6
2020,021900201,47644,8544,8544,8544,0,39100,39000,39000,0,0,100,0,100,0,0,0,0,0,1822,240,10,10,44,43
2020,021900211,450,450,450,450,0,0,0,0,0,0,0,0,0,0,0,0,0,0,1036,150,130,60,36,1
2020,021900221,109029,11229,11229,11229,0,97800,95000,95000,0,0,2800,2800,0,0,41500,41500,37500,4000,7360,540,320,360,880,1580
2020,021900231,550,550,50,50,500,0,0,0,0,0,0,0,0,0,3000,3000,3000,0,1861,620,21,240,135,207
2020,021900251,41960,960,960,960,0,41000,40000,40000,0,0,1000,1000,0,0,3280,3280,0,3100,2790,500,50,400,240,367
2020,021900261,201150,5800,5800,5800,0,195350,195000,115000,80000,0,350,50,300,0,12000,5000,5000,0,2690,320,150,200,120,254
2020,021900271,2800,1000,1000,1000,0,1800,0,0,0,0,1800,1800,0,0,0,0,0,0,2104,144,30,720,84,55
2020,021900281,7490,6690,1690,1690,5000,800,0,0,0,0,800,300,500,0,0,0,0,0,4408,1128,50,350,350,82
2020,021900301,17314,4446,4446,2446,0,12868,10000,10000,0,0,2868,750,918,1200,0,0,0,0,3264,248,500,150,186,28
2020,021900331,800,770,470,470,300,30,0,0,0,0,30,30,0,0,388,388,0,0,2003,356,5,390,132,234
2020,021900341,3350,2350,2350,2350,0,1000,1000,1000,0,0,0,0,0,0,0,0,0,0,922,138,60,62,12,1
2020,021900371,408,108,108,108,0,300,300,300,0,0,0,0,0,0,0,0,0,0,520,85,20,33,29,3
2020,021900381,6118,2530,2530,2530,0,3588,3450,3450,0,0,138,70,68,0,0,0,0,0,2200,800,240,140,150,5
2020,021900391,9250,250,250,250,0,9000,9000,9000,0,0,0,0,0,0,0,0,0,0,742,100,360,24,18,7
2020,022000202,19217,19217,7217,7217,12000,0,0,0,0,0,0,0,0,0,3300,3300,3000,300,2100,360,120,180,180,606
2020,022000212,17253,1130,1130,630,0,16123,15000,15000,0,0,1123,400,223,500,30,30,0,0,1794,150,10,372,132,35
2020,022000222,13675,7630,7430,6430,200,6045,0,0,0,0,6045,2000,1045,3000,0,0,0,0,2110,480,180,240,180,46
2020,022000272,1570,270,20,20,250,1300,0,0,0,0,1300,1300,0,0,0,0,0,0,936,168,5,180,45,0
2020,022000282,20,20,20,20,0,0,0,0,0,0,0,0,0,0,0,0,0,0,429,120,20,10,24,1
2020,022000292,4050,2450,2450,2450,0,1600,0,0,0,0,1600,1600,0,0,0,0,0,0,1890,180,10,180,120,389
2020,022000302,22808,4008,4008,3708,0,18800,15000,15000,0,0,3800,3700,0,100,80,80,0,0,3386,324,120,300,432,46
2020,022000312,10,10,10,10,0,0,0,0,0,0,0,0,0,0,0,0,0,0,413,95,35,45,30,1
2020,022000322,9880,300,300,300,0,9580,8100,600,7500,0,1480,480,1000,0,0,0,0,0,814,72,5,240,42,7
2020,022000332,11734,1600,1600,1600,0,10134,10000,10000,0,0,134,134,0,0,0,0,0,0,1354,264,240,126,36,67
2020,022000362,8515,505,505,505,0,8010,7900,5000,2900,0,110,110,0,0,0,0,0,0,1601,240,72,130,36,6
2020,022600201,8080,8080,80,80,8000,0,0,0,0,0,0,0,0,0,0,0,0,0,505,56,60,10,15,1
2020,022600221,27050,50,50,50,0,27000,27000,27000,0,0,0,0,0,0,4390,4390,4000,0,810,100,50,250,50,16
2020,022600231,262,262,12,12,250,0,0,0,0,0,0,0,0,0,1200,1200,0,1200,606,110,20,26,20,0
2020,022600241,7040,7040,40,40,7000,0,0,0,0,0,0,0,0,0,0,0,0,0,1270,240,100,60,130,35
2020,022600261,77569,9559,9559,9559,0,68010,67000,40000,27000,0,1010,700,310,0,36720,5720,5720,0,2660,730,200,50,150,115
2020,022600281,54320,22820,22820,22820,0,31500,28000,23000,5000,0,3500,3500,0,0,3800,3800,1300,0,3900,360,50,400,240,826
2020,022600291,40,40,40,40,0,0,0,0,0,0,0,0,0,0,0,0,0,0,798,120,426,0,24,18
2020,022600301,15230,5730,5730,730,0,9500,7000,7000,0,0,2500,2500,0,0,9600,9600,0,8000,2983,230,100,288,300,38
2020,022600311,26040,13140,13140,11140,0,12900,10000,10000,0,0,2900,400,2500,0,0,0,0,0,1174,144,72,240,168,82
2020,022600341,2710,1600,1600,1600,0,1110,1000,1000,0,0,110,80,30,0,0,0,0,0,758,235,80,18,43,48
2020,022600361,21300,6300,6300,6300,0,15000,15000,3000,12000,0,0,0,0,0,4000,0,0,0,680,240,48,10,72,48
2020,022700201,18520,80,80,80,0,18440,18300,18300,0,0,140,0,140,0,9800,0,0,0,789,150,65,10,29,27
2020,022700211,68980,9060,9060,9060,0,59920,59500,49500,10000,0,420,220,200,0,0,0,0,0,2700,300,300,200,100,80
2020,022700221,86400,100,100,100,0,86300,85500,50000,35500,0,800,800,0,0,23770,23770,23770,0,4180,540,60,480,240,151
2020,022700251,104268,38398,38398,38398,0,65870,65200,45000,20200,0,670,170,500,0,0,0,0,0,3633,335,420,610,95,164
2020,022700291,38160,9460,9460,9460,0,28700,28000,28000,0,0,700,700,0,0,0,0,0,0,7373,540,15,280,300,738
2020,022700301,15802,6170,6170,6170,0,9632,9000,9000,0,0,632,180,452,0,1000,1000,1000,0,4520,250,70,350,200,140
2020,022700311,29228,10966,10966,10966,0,18262,16000,16000,0,0,2262,2210,52,0,1200,1200,0,1200,3968,360,50,300,296,1128
2020,022700321,538,425,425,425,0,113,0,0,0,0,113,0,113,0,0,0,0,0,1626,910,48,24,51,1
2020,022700331,5200,200,200,200,0,5000,5000,5000,0,0,0,0,0,0,0,0,0,0,552,156,36,15,30,5
2020,022700351,12374,3144,3144,2844,0,9230,6000,2000,4000,0,3230,1500,1730,0,1000,1000,0,1000,2232,600,360,360,25,62
2020,022700361,14939,4849,4849,4849,0,10090,10000,10000,0,0,90,0,90,0,0,0,0,0,872,150,100,100,32,1
2020,022800201,202832,20122,20122,16122,0,182710,171000,75000,90000,6000,11710,7100,1610,3000,74500,24500,23700,500,5550,300,100,600,250,504
2020,022800211,435000,70000,70000,70000,0,365000,355000,110000,245000,0,10000,0,10000,0,21500,0,0,0,7736,600,2000,60,36,1502
2020,022800271,390,220,20,20,200,170,0,0,0,0,170,170,0,0,0,0,0,0,773,116,15,130,14,0
2020,022800281,207,207,7,7,200,0,0,0,0,0,0,0,0,0,0,0,0,0,608,96,48,40,14,0
2020,022800301,7720,1520,1520,1520,0,6200,6000,0,6000,0,200,200,0,0,12500,12500,12500,0,1955,245,35,275,130,226
2020,022800311,145,145,145,145,0,0,0,0,0,0,0,0,0,0,0,0,0,0,635,70,90,80,65,67
2020,022800321,73000,500,500,500,0,72500,72000,20000,52000,0,500,500,0,0,9500,9500,9500,0,2226,180,30,96,360,44
2020,022900201,15380,80,80,80,0,15300,15000,0,15000,0,300,300,0,0,0,0,0,0,2560,120,900,500,40,52
2020,022900211,10214,10214,3214,3214,7000,0,0,0,0,0,0,0,0,0,0,0,0,0,620,78,30,70,42,3
2020,022900221,80300,15300,15300,15300,0,65000,65000,45000,20000,0,0,0,0,0,0,0,0,0,1802,130,300,200,60,268
2020,022900241,25000,1500,1500,1500,0,23500,23500,23000,500,0,0,0,0,0,0,0,0,0,1622,312,500,100,60,41
2020,022900251,88281,5171,5171,3171,0,83110,80200,15000,65200,0,2910,1400,1510,0,4000,0,0,0,3406,950,140,600,156,242
2020,022900261,33380,5350,5350,5350,0,28030,27900,27900,0,0,130,130,0,0,0,0,0,0,1432,157,173,215,37,109
2020,022900271,2050,1900,1900,1900,0,150,0,0,0,0,150,150,0,0,0,0,0,0,1930,300,200,280,100,24
2020,022900281,19646,4586,4586,4586,0,15060,15000,15000,0,0,60,0,60,0,22,22,0,0,3290,250,800,160,180,62
2020,022900291,10610,8180,8180,8180,0,2430,1500,0,1500,0,930,800,130,0,20,20,0,0,3130,180,500,400,150,55
2020,022900301,4010,10,10,10,0,4000,4000,4000,0,0,0,0,0,0,0,0,0,0,422,110,5,20,15,1
2020,022900341,22497,315,315,315,0,22182,22162,7000,15162,0,20,0,20,0,0,0,0,0,1343,274,560,67,59,11
2020,022900351,71506,20076,20076,20076,0,51430,48600,40000,8600,0,2830,830,2000,0,40811,40811,21010,15001,4150,500,300,600,250,542
2020,022900361,800,800,800,800,0,0,0,0,0,0,0,0,0,0,0,0,0,0,489,119,38,14,24,1
2020,023000202,16760,450,450,450,0,16310,13000,13000,0,0,3310,3310,0,0,9096,9096,7656,0,3740,200,200,400,360,88
2020,023000212,45433,11733,11733,11233,0,33700,32000,32000,0,0,1700,1700,0,0,3362,3362,3362,0,4286,360,60,300,180,50
2020,023000222,19000,2500,2500,2500,0,16500,16000,16000,0,0,500,500,0,0,0,0,0,0,2010,240,100,130,150,56
2020,023000232,66735,17535,17535,4535,0,49200,24000,21000,3000,0,25200,1200,24000,0,12048,12048,2048,3000,3300,360,100,80,300,76
2020,023000252,20330,16800,8800,8800,8000,3530,1200,0,1200,0,2330,2100,230,0,0,0,0,0,2410,220,320,240,140,68
2020,023600201,297,297,297,297,0,0,0,0,0,0,0,0,0,0,1000,1000,0,0,985,112,52,53,54,0
2020,023600211,53087,9237,9237,9237,0,43850,43000,40000,3000,0,850,700,150,0,0,0,0,0,3940,240,30,180,240,910
2020,023600231,98158,60978,60978,60978,0,37180,34000,34000,0,0,3180,2950,230,0,0,0,0,0,3600,300,200,400,150,145
2020,023700201,13475,175,175,175,0,13300,12500,12500,0,0,800,800,0,0,1800,1800,1800,0,1464,250,200,250,24,56
2020,023700231,20576,6576,6576,6576,0,14000,14000,14000,0,0,0,0,0,0,0,0,0,0,1060,100,100,100,70,76
2020,023700241,22890,9740,9740,9740,0,13150,12000,12000,0,0,1150,850,300,0,10000,10000,0,10000,3270,120,300,400,250,105
2020,023700251,18070,540,540,540,0,17530,17000,17000,0,0,530,80,450,0,160,160,0,0,4136,216,120,300,120,21
2020,023700261,31200,200,200,200,0,31000,31000,14000,17000,0,0,0,0,0,0,0,0,0,771,80,10,30,36,8
2020,023700271,30380,150,150,150,0,30230,30000,30000,0,0,230,0,230,0,18700,18700,18700,0,2568,720,60,120,192,49
2020,023800201,54463,29363,29363,29363,0,25100,25000,12000,13000,0,100,100,0,0,0,0,0,0,4141,190,370,290,331,156
2020,023800221,20000,3000,3000,3000,0,17000,17000,17000,0,0,0,0,0,0,0,0,0,0,828,380,48,12,28,15
2020,023800231,23995,6595,6595,6095,0,17400,17000,17000,0,0,400,0,400,0,6000,6000,6000,0,1370,250,100,100,120,121
2020,023800241,27925,5725,5725,5725,0,22200,21500,0,21500,0,700,700,0,0,10104,104,0,0,3273,250,130,420,96,94
2020,023800251,40250,5700,5700,5700,0,34550,33000,25000,8000,0,1550,1300,250,0,0,0,0,0,1880,200,500,200,70,104
2020,023900221,12180,11530,530,530,11000,650,0,0,0,0,650,650,0,0,7310,7310,6000,1050,1764,280,40,300,144,132
2020,023900231,230,230,30,30,200,0,0,0,0,0,0,0,0,0,0,0,0,0,1594,410,72,72,120,1
2020,023900241,23466,1790,1790,1790,0,21676,21000,21000,0,0,676,350,326,0,7080,7080,6430,0,3948,260,120,350,240,87
2020,030000232,38240,2240,2240,2240,0,36000,36000,24000,12000,0,0,0,0,0,2000,0,0,0,2002,256,200,48,180,344
2020,030000252,9140,9140,3140,140,6000,0,0,0,0,0,0,0,0,0,1850,1850,0,1700,1109,79,2,84,60,4
2020,030000262,1350,1350,1000,1000,350,0,0,0,0,0,0,0,0,0,0,0,0,0,1030,180,50,60,80,8
2020,030000272,6700,100,100,100,0,6600,6600,6600,0,0,0,0,0,0,2800,2800,2800,0,1760,240,600,80,40,11
2020,030000292,75490,9566,9566,9566,0,65924,65000,65000,0,0,924,924,0,0,13096,13096,11700,0,5270,660,100,250,180,864
2020,030000312,53000,20200,20200,20200,0,32800,31500,3500,28000,0,1300,1000,300,0,0,0,0,0,1974,160,360,180,24,27
2020,030000322,28566,530,530,530,0,28036,27810,9010,18800,0,226,0,226,0,0,0,0,0,1281,936,24,10,21,34
2020,030000342,9020,2320,2320,2320,0,6700,6700,6700,0,0,0,0,0,0,0,0,0,0,1384,498,216,15,30,9
2020,030000352,7808,7808,3808,3808,4000,0,0,0,0,0,0,0,0,0,2800,2800,0,2800,1900,210,60,60,240,1
2020,030000372,117460,12510,12510,12510,0,104950,100000,40000,60000,0,4950,4950,0,0,17286,14286,14286,0,7994,840,20,750,360,1454
2020,030000392,66600,19000,19000,19000,0,47600,27000,12000,0,15000,20600,600,20000,0,0,0,0,0,4460,240,60,600,240,1546
2020,030600241,921,921,721,721,200,0,0,0,0,0,0,0,0,0,0,0,0,0,566,216,12,12,38,1
2020,030600281,30200,200,200,200,0,30000,30000,30000,0,0,0,0,0,0,1000,0,0,0,2532,346,500,84,130,27
2020,030600311,29682,11483,11483,10483,0,18199,15700,15700,0,0,2499,2240,259,0,3200,3200,3200,0,2100,257,20,220,156,158
2020,030600321,13690,2370,2370,2370,0,11320,11000,11000,0,0,320,200,120,0,0,0,0,0,2028,180,120,360,108,47
2020,030600331,36178,2078,2078,2078,0,34100,30000,30000,0,0,4100,600,3500,0,9500,9500,9500,0,2787,287,100,420,228,197
2020,030600351,37474,17648,17648,17648,0,19826,18000,18000,0,0,1826,1600,226,0,17900,17900,17900,0,2279,312,370,360,180,208
2020,030600361,32770,2770,2770,2770,0,30000,30000,29000,1000,0,0,0,0,0,0,0,0,0,1680,180,276,72,52,17
2020,030600371,2640,840,340,340,500,1800,0,0,0,0,1800,1800,0,0,0,0,0,0,1230,135,10,200,95,51
2020,030600381,31868,11168,11168,10468,0,20700,18000,18000,0,0,2700,2700,0,0,630,630,0,0,3775,228,486,300,156,187
2020,030600391,151806,11856,11856,11856,0,139950,130000,90000,40000,0,9950,4050,5900,0,25000,25000,25000,0,8680,840,120,1200,240,758
2020,030700231,16400,16000,14000,14000,2000,400,0,0,0,0,400,400,0,0,0,0,0,0,1481,204,5,180,60,69
2020,030700261,12620,2340,2340,2340,0,10280,10000,10000,0,0,280,280,0,0,5800,5800,5800,0,2908,240,20,300,228,67
2020,030700271,20785,20053,12053,12053,8000,732,0,0,0,0,732,300,432,0,40,40,0,0,3430,120,480,240,144,1149
2020,030700281,8420,420,420,420,0,8000,8000,8000,0,0,0,0,0,0,3980,3980,3980,0,1081,58,40,25,48,11
2020,030700291,20896,17996,2496,2496,15500,2900,0,0,0,0,2900,2900,0,0,11200,11200,11200,0,3064,220,140,500,204,60
2020,030700311,700,700,700,700,0,0,0,0,0,0,0,0,0,0,0,0,0,0,1675,250,1200,25,30,1
2020,030700341,200,200,200,200,0,0,0,0,0,0,0,0,0,0,0,0,0,0,816,154,350,10,30,1
2020,030700351,59770,700,700,700,0,59070,59000,5000,54000,0,70,0,70,0,0,0,0,0,1080,150,300,50,80,31
2020,030700361,2975,2745,895,895,1850,230,0,0,0,0,230,230,0,0,0,0,0,0,1244,204,550,120,40,0
2020,030700371,19412,10562,10562,10562,0,8850,7500,7500,0,0,1350,1350,0,0,464,464,0,0,1719,360,120,240,79,34
2020,030700391,40035,14935,14935,14935,0,25100,22000,22000,0,0,3100,3100,0,0,1460,1260,0,0,2556,120,60,600,156,378
2020,030800221,34256,3432,3432,3432,0,30824,30000,30000,0,0,824,824,0,0,0,0,0,0,2034,980,200,240,24,78
2020,030800241,620,620,120,120,500,0,0,0,0,0,0,0,0,0,0,0,0,0,810,420,156,24,30,1
2020,030800261,87060,1486,1486,1486,0,85574,78000,48000,30000,0,7574,6074,0,1500,23374,20374,14574,0,2188,190,150,180,96,164
2020,030800271,42365,4125,4125,4125,0,38240,30000,30000,0,0,8240,1240,0,7000,0,0,0,0,2900,360,200,600,120,46
2020,030800281,19482,12332,4332,4332,8000,7150,7000,0,7000,0,150,150,0,0,1000,0,0,0,2140,180,185,120,175,134
2020,030800311,9000,2400,2400,2400,0,6600,5000,5000,0,0,1600,1600,0,0,0,0,0,0,1168,90,100,360,66,63
2020,030800331,45464,32701,32701,32701,0,12763,11963,8500,3463,0,800,800,0,0,2500,300,0,300,4290,820,50,480,240,366
2020,030800341,48300,25100,25100,25100,0,23200,22300,15000,7300,0,900,900,0,0,200,0,0,0,4090,300,1200,280,90,135
2020,030800351,34410,8210,8210,8210,0,26200,17000,10000,7000,0,9200,1200,8000,0,135,135,0,0,4355,115,50,650,300,359
2020,030800361,1006,1006,6,6,1000,0,0,0,0,0,0,0,0,0,2000,2000,0,0,1180,580,40,80,90,1
2020,030800371,21368,11638,11638,11638,0,9730,9000,9000,0,0,730,730,0,0,0,0,0,0,1780,252,300,180,48,27
2020,030800381,20851,10651,10651,7151,0,10200,9000,9000,0,0,1200,1200,0,0,3100,3100,2100,1000,3878,324,300,240,240,285
2020,030800391,70750,33450,33450,28450,0,37300,30000,30000,0,0,7300,1800,5500,0,530,530,0,0,6532,500,500,1300,360,406
2020,030900221,535,535,35,35,500,0,0,0,0,0,0,0,0,0,0,0,0,0,1864,540,330,72,96,36
2020,030900241,1976,1976,1816,1816,160,0,0,0,0,0,0,0,0,0,0,0,0,0,812,130,40,30,72,0
2020,030900281,61818,518,518,518,0,61300,59500,31500,0,28000,1800,1800,0,0,40700,40700,14000,25500,2230,270,130,288,288,121
2020,030900291,35704,2968,2968,2968,0,32736,32000,32000,0,0,736,600,136,0,7300,7300,7300,0,2225,55,200,204,230,63
2020,030900321,11707,2507,2507,2507,0,9200,5000,5000,0,0,4200,4200,0,0,2968,2968,0,0,1950,174,50,180,132,33
2020,030900371,26904,11554,5554,5554,6000,15350,14000,0,12000,2000,1350,1150,200,0,0,0,0,0,3194,144,100,600,300,78
2020,030900381,47597,8096,8096,8096,0,39501,35000,20000,15000,0,4501,1500,3001,0,5944,5944,5944,0,2100,240,120,120,120,48
2020,030900391,78,10,10,10,0,68,0,0,0,0,68,0,68,0,0,0,0,0,625,145,50,50,20,1
2020,031000202,3510,3510,510,510,3000,0,0,0,0,0,0,0,0,0,2000,2000,0,0,6660,2280,100,600,400,380
2020,031000212,245276,17550,17550,17550,0,227726,214000,75000,139000,0,13726,13500,226,0,45500,0,0,0,7780,540,300,1440,240,2841
2020,031000222,14980,7080,7080,7080,0,7900,7000,7000,0,0,900,900,0,0,112,112,100,0,1867,256,1,150,150,208
2020,031000242,8626,8490,3490,3490,5000,136,0,0,0,0,136,0,136,0,20,20,0,0,1895,180,600,36,132,1
2020,031000252,3445,3445,445,445,3000,0,0,0,0,0,0,0,0,0,50,50,0,50,2605,420,50,75,75,54
2020,031000282,53488,18486,18486,18486,0,35002,32000,32000,0,0,3002,2310,692,0,0,0,0,0,2155,300,566,540,180,96
2020,031000292,38644,5075,5075,5075,0,33569,24000,24000,0,0,9569,7500,69,2000,3650,3650,3500,0,3129,276,470,388,216,64
2020,031000312,20700,2000,2000,2000,0,18700,16000,16000,0,0,2700,2700,0,0,10000,10000,10000,0,2400,300,100,300,100,61
2020,031000322,2386,2386,1386,1386,1000,0,0,0,0,0,0,0,0,0,0,0,0,0,1647,576,5,180,120,15
2020,031000342,16167,1508,1508,1508,0,14659,14000,14000,0,0,659,659,0,0,17089,17089,9989,6800,4370,300,320,500,350,433
2020,031000362,2873,2873,2873,2873,0,0,0,0,0,0,0,0,0,0,0,0,0,0,846,178,48,5,24,1
2020,031000372,101780,6480,6480,6480,0,95300,93900,23900,70000,0,1400,1400,0,0,15000,15000,15000,0,4290,240,240,360,360,858
2020,031000392,4200,4200,2900,1900,1300,0,0,0,0,0,0,0,0,0,1000,1000,0,1000,1396,136,40,20,60,1
2020,031600201,20331,11865,11865,11865,0,8466,7000,7000,0,0,1466,896,570,0,0,0,0,0,1443,84,337,84,169,74
2020,031600261,800,500,0,0,500,300,0,0,0,0,300,300,0,0,5990,5990,2540,2450,2180,500,240,600,120,51
2020,031600271,4200,200,200,200,0,4000,4000,4000,0,0,0,0,0,0,250,250,0,0,1620,180,300,60,60,27
2020,031600301,24000,800,800,800,0,23200,23200,16000,7200,0,0,0,0,0,500,0,0,0,503,150,8,10,15,22
2020,031600311,19900,10900,10900,10900,0,9000,9000,9000,0,0,0,0,0,0,200,0,0,0,1547,284,296,120,70,62
2020,031600321,40,40,40,40,0,0,0,0,0,0,0,0,0,0,1000,1000,1000,0,584,170,120,20,38,1
2020,031600331,622,600,600,600,0,22,0,0,0,0,22,0,22,0,0,0,0,0,564,121,84,12,18,1
2020,031600361,4120,1620,560,560,1060,2500,0,0,0,0,2500,2500,0,0,1368,1368,0,0,665,240,5,120,80,0
2020,031600371,11090,5090,5090,5090,0,6000,6000,6000,0,0,0,0,0,0,0,0,0,0,748,168,30,120,40,7
2020,031600381,117415,20825,20825,20825,0,96590,75000,30000,45000,0,21590,4590,17000,0,54000,54000,54000,0,3810,300,1100,720,180,113
2020,031700211,34526,3200,3200,3200,0,31326,30000,30000,0,0,1326,1100,226,0,2748,2748,2748,0,3211,226,10,360,300,282
2020,031700231,10917,917,917,917,0,10000,10000,10000,0,0,0,0,0,0,0,0,0,0,1125,120,400,10,70,22
2020,031700301,64648,4918,4918,4918,0,59730,56500,33000,23500,0,3230,2950,280,0,7000,7000,7000,0,4370,380,400,500,240,835
2020,031700321,6100,5810,3310,3310,2500,290,0,0,0,0,290,290,0,0,3800,3800,0,3800,2138,240,10,360,360,41
2020,031700331,893,893,743,43,150,0,0,0,0,0,0,0,0,0,980,980,0,880,1567,345,100,360,204,1
2020,031700341,33846,28846,18846,15846,10000,5000,1000,0,0,1000,4000,4000,0,0,7420,7420,0,5000,3360,360,240,480,120,80
2020,031700361,103556,18256,18256,18256,0,85300,83800,35000,48800,0,1500,1500,0,0,10500,10000,10000,0,3778,420,24,240,144,218
2020,031700371,1485,1005,505,505,500,480,0,0,0,0,480,80,400,0,2000,2000,0,0,1076,360,30,120,156,5
2020,031700391,16682,3082,3082,3082,0,13600,11000,11000,0,0,2600,2600,0,0,713,713,0,0,2190,190,10,480,280,397
2020,031800201,140750,1950,1950,1950,0,138800,136000,65000,71000,0,2800,2800,0,0,44000,44000,42000,0,4310,400,600,300,80,257
2020,031800211,8640,8640,5640,5640,3000,0,0,0,0,0,0,0,0,0,500,500,0,500,3791,1296,225,480,120,1
2020,031800231,24622,122,122,122,0,24500,24500,19000,5500,0,0,0,0,0,5000,0,0,0,1524,180,60,85,144,34
2020,031800261,299,170,20,20,150,129,0,0,0,0,129,129,0,0,0,0,0,0,1888,488,200,200,180,59
2020,031800271,14995,7545,7045,5745,500,7450,0,0,0,0,7450,450,7000,0,2300,2300,0,1300,2009,588,70,340,122,122
2020,031800281,20696,3696,3696,3696,0,17000,17000,17000,0,0,0,0,0,0,0,0,0,0,1040,240,180,36,30,21
2020,031800291,42744,10244,10244,10244,0,32500,32500,17500,15000,0,0,0,0,0,10000,0,0,0,1380,240,72,84,120,88
2020,031800301,81434,10884,10884,10684,0,70550,60000,60000,0,0,10550,8550,0,2000,23900,9900,1200,0,5250,300,340,460,202,222
2020,031800311,13200,200,200,200,0,13000,13000,0,13000,0,0,0,0,0,8000,0,0,0,634,200,60,35,36,46
2020,031800321,37295,6995,6995,6995,0,30300,24000,24000,0,0,6300,6300,0,0,12317,12317,10400,1000,3140,370,150,390,200,121
2020,031800341,122840,34120,34120,26120,0,88720,77000,26000,51000,0,11720,3500,3220,5000,16500,16500,14800,1700,4247,580,40,660,300,565
2020,031800351,28970,2220,2220,2220,0,26750,26000,26000,0,0,750,600,150,0,8830,8830,4600,4230,4882,240,88,300,144,864
2020,031800361,52762,4162,4162,4162,0,48600,42000,32000,10000,0,6600,6400,200,0,9764,9764,5364,0,3380,300,40,400,280,360
2020,031800371,43220,9170,9170,9170,0,34050,32000,32000,0,0,2050,2050,0,0,0,0,0,0,1800,240,150,200,60,525
2020,031800391,14010,460,460,460,0,13550,13500,0,13500,0,50,0,50,0,0,0,0,0,510,162,25,20,18,13
2020,031900221,16140,5540,5540,5540,0,10600,8000,8000,0,0,2600,2500,100,0,215,215,0,0,2900,220,200,200,210,47
2020,031900271,520,520,20,20,500,0,0,0,0,0,0,0,0,0,0,0,0,0,520,320,10,36,12,1
2020,031900281,29654,27134,4134,4134,23000,2520,0,0,0,0,2520,2250,270,0,0,0,0,0,2915,220,200,267,200,899
2020,031900291,33812,6812,6812,6812,0,27000,23000,23000,0,0,4000,4000,0,0,21112,21112,13300,4000,6470,480,50,200,240,532
2020,031900301,2451,2451,2151,2151,300,0,0,0,0,0,0,0,0,0,0,0,0,0,2460,480,150,200,96,21
2020,031900331,57550,14900,14900,14900,0,42650,40000,30000,10000,0,2650,2650,0,0,10000,10000,10000,0,3262,162,360,600,120,315
2020,031900341,33516,7916,7916,7916,0,25600,25000,10000,0,15000,600,600,0,0,0,0,0,0,1698,300,20,128,120,192
2020,031900351,8618,8318,318,318,8000,300,0,0,0,0,300,300,0,0,0,0,0,0,1600,250,150,180,60,9
2020,031900361,2479,1103,1103,1103,0,1376,0,0,0,0,1376,376,1000,0,0,0,0,0,4896,300,240,720,216,15
2020,031900391,4175,165,165,165,0,4010,4000,4000,0,0,10,0,10,0,0,0,0,0,963,100,320,62,17,3
2020,032000202,24370,5070,5070,5070,0,19300,17000,17000,0,0,2300,2300,0,0,5866,5866,5800,0,1877,180,40,360,168,119
2020,032000212,49009,22577,5577,5577,17000,26432,25396,0,0,25396,1036,900,136,0,28696,28696,7000,21696,4434,240,410,168,396,713
2020,032000232,12007,3887,3887,3887,0,8120,8000,8000,0,0,120,120,0,0,5973,5973,2103,1870,944,144,50,36,90,44
2020,032000242,81155,2455,2455,2455,0,78700,76900,21900,55000,0,1800,1800,0,0,2800,0,0,0,4020,180,150,180,180,85
2020,032000252,48750,9350,9350,9350,0,39400,35000,35000,0,0,4400,4400,0,0,20600,20600,18900,1000,9490,360,50,700,480,1272
2020,032000272,2618,2440,440,440,2000,178,0,0,0,0,178,178,0,0,0,0,0,0,1985,84,500,650,156,44
2020,032000292,310,310,10,10,300,0,0,0,0,0,0,0,0,0,5600,5600,0,5600,1679,444,120,60,55,15
2020,032000302,1848,1848,500,500,1348,0,0,0,0,0,0,0,0,0,350,350,0,0,1020,400,50,60,50,1
2020,032000322,16320,1621,1621,1621,0,14699,12470,12470,0,0,2229,1729,500,0,8420,8420,7300,500,1720,219,228,550,156,469
2020,032600211,51110,9910,9910,9910,0,41200,40200,31000,0,9200,1000,500,500,0,4500,4500,0,4500,2090,360,120,360,120,86
2020,032600221,119440,36240,36240,36240,0,83200,80000,30000,50000,0,3200,3000,200,0,30000,0,0,0,3430,480,60,620,120,180
2020,032600271,19300,4900,4900,4900,0,14400,14000,14000,0,0,400,400,0,0,300,300,200,0,3701,215,1000,270,282,57
2020,032600281,7380,1130,1130,630,0,6250,6000,0,6000,0,250,250,0,0,30,30,0,0,3750,140,50,100,300,26
2020,032600291,108890,27300,27300,27300,0,81590,79500,55000,24500,0,2090,2090,0,0,18715,17715,17715,0,4850,480,50,120,300,3491
2020,032600311,35865,4185,4185,4185,0,31680,31500,1500,30000,0,180,0,180,0,0,0,0,0,1125,50,300,50,35,8
2020,032600321,58030,41750,41750,41750,0,16280,10000,2000,8000,0,6280,4180,2100,0,0,0,0,0,2155,180,100,280,130,173
2020,032600341,5118,1918,1918,1418,0,3200,0,0,0,0,3200,2200,0,1000,0,0,0,0,2600,240,60,360,180,55
2020,032700201,62340,4000,4000,4000,0,58340,55000,55000,0,0,3340,3340,0,0,17800,17800,16800,1000,7525,360,80,444,600,1067
2020,032700211,9575,9400,400,400,9000,175,0,0,0,0,175,175,0,0,0,0,0,0,811,84,5,240,36,7
2020,032700231,22570,2770,2770,2270,0,19800,19000,19000,0,0,800,800,0,0,0,0,0,0,3488,250,150,200,288,25
2020,032700241,20015,15,15,15,0,20000,20000,20000,0,0,0,0,0,0,21000,6000,6000,0,560,70,100,0,50,17
2020,032700251,13970,2270,2270,2270,0,11700,11000,11000,0,0,700,700,0,0,8200,8200,4600,1750,1379,162,60,240,240,12
2020,032700261,14910,14560,5560,5560,9000,350,0,0,0,0,350,250,100,0,1270,1270,1270,0,2376,508,80,460,156,16
2020,032700271,4399,4399,899,899,3500,0,0,0,0,0,0,0,0,0,66,66,0,0,754,276,5,120,6,1
2020,032700301,78114,12204,12204,9204,0,65910,64000,27000,37000,0,1910,830,1080,0,57150,39150,24530,14620,2740,420,200,160,216,145
2020,032700311,27350,6450,6450,3450,0,20900,20000,20000,0,0,900,900,0,0,1300,1300,1300,0,4100,300,600,700,250,84
2020,032700321,2370,870,870,870,0,1500,1500,1500,0,0,0,0,0,0,0,0,0,0,483,110,36,24,30,4
2020,032700331,45661,5761,5761,5761,0,39900,35000,35000,0,0,4900,3100,0,1800,12855,12855,10500,0,3809,301,150,120,528,92
2020,032700341,46630,620,620,620,0,46010,46000,30000,16000,0,10,0,10,0,0,0,0,0,972,210,240,5,72,184
2020,032700351,31956,456,456,456,0,31500,29000,29000,0,0,2500,2500,0,0,21000,21000,20000,1000,1883,490,25,450,78,91
2020,032800211,45224,4404,4404,2904,0,40820,38000,38000,0,0,2820,820,1000,1000,15400,15400,15400,0,3593,329,30,242,141,69
2020,032800231,16080,16080,2080,2080,14000,0,0,0,0,0,0,0,0,0,10000,10000,10000,0,1680,120,10,10,170,78
2020,032800241,71706,6326,6326,6326,0,65380,65000,45000,20000,0,380,380,0,0,27650,27650,27650,0,3600,300,120,180,180,70
2020,032800251,17200,200,200,200,0,17000,17000,17000,0,0,0,0,0,0,15084,15084,14000,900,2698,156,700,72,360,38
2020,032800261,1052,1002,2,2,1000,50,0,0,0,0,50,50,0,0,3182,3182,682,2500,3119,608,180,204,240,74
2020,032800271,1994,1994,1994,1994,0,0,0,0,0,0,0,0,0,0,4000,4000,0,2200,1910,780,10,10,240,395
2020,032800281,12072,572,572,512,0,11500,11500,11500,0,0,0,0,0,0,7500,7500,7500,0,748,180,20,0,48,11
2020,032800291,18750,700,700,700,0,18050,18000,18000,0,0,50,50,0,0,7859,7859,7859,0,870,300,30,10,100,27
2020,032800321,24480,7100,7100,7100,0,17380,15500,11000,4500,0,1880,1700,180,0,0,0,0,0,1967,174,310,150,148,165
2020,032800331,14300,5000,5000,5000,0,9300,9300,3000,6300,0,0,0,0,0,0,0,0,0,600,125,240,30,15,5
2020,032800341,38625,345,345,345,0,38280,38000,18000,20000,0,280,0,280,0,200,0,0,0,325,154,35,20,36,20
2020,032900201,63090,29568,29568,29568,0,33522,30000,27000,3000,0,3522,2422,1100,0,546,546,0,0,3920,300,100,240,240,172
2020,032900211,25050,50,50,50,0,25000,25000,25000,0,0,0,0,0,0,0,0,0,0,768,228,45,120,15,24
2020,032900221,9050,2450,650,650,1800,6600,0,0,0,0,6600,1600,0,5000,2700,2700,1000,1700,1662,456,18,360,96,54
2020,032900231,2920,2920,20,20,2900,0,0,0,0,0,0,0,0,0,5900,5900,2900,0,996,288,20,24,130,47
2020,032900241,11040,2040,2040,2040,0,9000,9000,9000,0,0,0,0,0,0,3600,3600,3600,0,731,120,10,84,92,44
2020,032900251,34626,4100,4100,4100,0,30526,30000,30000,0,0,526,300,226,0,0,0,0,0,2456,750,800,60,240,83
2020,032900261,100605,17800,17800,17800,0,82805,65000,40000,25000,0,17805,10800,5,7000,0,0,0,0,5432,2800,240,200,389,798
2020,032900281,410,410,10,10,400,0,0,0,0,0,0,0,0,0,1500,1500,0,1500,1664,124,20,240,120,35
2020,032900311,1700,800,800,800,0,900,0,0,0,0,900,900,0,0,0,0,0,0,888,250,48,140,60,5
2020,032900321,12820,1000,1000,1000,0,11820,11800,1800,10000,0,20,0,20,0,0,0,0,0,718,50,300,30,18,4
2020,032900341,32149,6519,6519,6519,0,25630,24700,5000,19700,0,930,600,330,0,210,210,210,0,903,95,50,140,88,29
2020,033000202,61500,9000,5000,5000,4000,52500,50000,0,50000,0,2500,1000,500,1000,15000,15000,15000,0,2002,900,40,60,60,113
2020,033000212,19540,18840,2340,1940,16500,700,0,0,0,0,700,700,0,0,15800,15800,14200,0,2784,156,10,110,144,135
2020,033600201,67520,6520,6520,5520,0,61000,59000,55000,4000,0,2000,2000,0,0,33106,33106,26500,6606,3954,420,100,400,144,343
2020,033600211,68734,1734,1734,1734,0,67000,65000,0,65000,0,2000,2000,0,0,32000,1000,0,0,3611,792,100,540,180,988
2020,033700221,102416,550,550,550,0,101866,96000,46000,50000,0,5866,2866,3000,0,56000,21000,21000,0,2150,300,10,480,150,221
2020,033900211,34850,200,200,200,0,34650,30000,30000,0,0,4650,1650,0,3000,6585,6585,5685,0,2360,180,20,150,120,65
2020,040000212,45197,264,264,264,0,44933,44900,14900,30000,0,33,0,33,0,0,0,0,0,1152,216,60,36,30,73
2020,040000222,187870,154070,119070,119070,35000,33800,33000,0,33000,0,800,0,800,0,5000,0,0,0,6007,544,514,405,502,5034
2020,040000232,56797,30851,30851,30851,0,25946,24000,22000,2000,0,1946,1200,746,0,0,0,0,0,4258,291,49,336,194,1541
2020,040000242,39580,14730,14730,6730,0,24850,20200,17200,3000,0,4650,650,3000,1000,200,200,0,0,4263,186,107,369,304,60
2020,040000252,639,239,29,29,210,400,0,0,0,0,400,400,0,0,0,0,0,0,1738,108,244,187,256,11
2020,040000262,3518,3355,3155,3155,200,163,0,0,0,0,163,0,163,0,0,0,0,0,905,122,241,121,15,0
2020,040000272,19299,2231,2231,2231,0,17068,17000,17000,0,0,68,0,68,0,200,0,0,0,987,96,84,56,36,14
2020,040000282,28923,6845,6845,6845,0,22078,21200,21200,0,0,878,830,48,0,177,177,0,0,4145,792,670,315,203,99
2020,040000312,18840,18500,3500,3500,15000,340,0,0,0,0,340,340,0,0,8000,8000,8000,0,2890,300,300,300,150,36
2020,040000322,43330,6180,6180,5180,0,37150,35500,20500,15000,0,1650,1650,0,0,400,400,0,400,2570,240,100,500,240,1365
2020,040000332,750,550,150,150,400,200,0,0,0,0,200,200,0,0,1100,1100,0,500,1548,348,10,200,120,25
2020,040000342,11136,10686,2686,2686,8000,450,0,0,0,0,450,450,0,0,8524,8524,7600,340,1864,144,30,240,150,22
2020,040600211,370952,136300,136300,136300,0,234652,231000,51000,180000,0,3652,3500,152,0,2000,0,0,0,6108,536,523,611,108,471
2020,040600231,55531,9505,9505,9505,0,46026,42000,42000,0,0,4026,3500,526,0,17200,17200,17200,0,4098,468,150,600,300,453
2020,040600241,40852,4814,4814,4814,0,36038,35000,35000,0,0,1038,880,158,0,11330,11330,8510,2800,3786,430,60,720,360,409
2020,040600261,28324,324,324,324,0,28000,28000,28000,0,0,0,0,0,0,0,0,0,0,1409,143,375,78,69,34
2020,040600271,61263,4613,4613,4613,0,56650,55000,55000,0,0,1650,1650,0,0,13000,13000,10000,3000,3420,250,70,360,280,1247
2020,040600281,22070,231,231,231,0,21839,21500,16000,5500,0,339,0,339,0,0,0,0,0,460,106,78,33,36,13
2020,040600291,46988,388,388,388,0,46600,43000,18000,25000,0,3600,3600,0,0,900,0,0,0,1197,192,72,258,66,333
2020,040600311,17530,850,850,850,0,16680,15740,8000,7740,0,940,800,140,0,0,0,0,0,1455,350,350,150,50,102
2020,040600321,8040,40,40,40,0,8000,8000,8000,0,0,0,0,0,0,0,0,0,0,930,180,400,20,60,10
2020,040600331,14860,11760,3760,3760,8000,3100,0,0,0,0,3100,2500,600,0,740,740,0,0,2345,352,40,200,277,79
2020,040600341,26600,400,400,400,0,26200,25000,25000,0,0,1200,1200,0,0,11760,11760,11760,0,2650,550,100,400,150,226
2020,040600361,43322,19822,19822,19822,0,23500,23000,10000,13000,0,500,500,0,0,3330,2830,2830,0,2990,200,70,300,230,201
2020,040600391,21094,3994,3994,3994,0,17100,15000,15000,0,0,2100,2000,100,0,10400,10400,9000,0,2572,216,20,720,276,417
2020,040700211,9747,1795,1795,1795,0,7952,7500,7500,0,0,452,0,452,0,3000,0,0,0,870,144,132,56,36,5
2020,040700261,22940,20632,20632,5632,0,2308,1175,0,1175,0,1133,1100,33,0,25,25,0,0,2510,185,600,420,126,62
2020,040700271,25317,23817,3817,3817,20000,1500,0,0,0,0,1500,1500,0,0,10000,10000,10000,0,1181,215,30,127,96,65
2020,040700281,107954,3354,3354,2854,0,104600,102900,22900,80000,0,1700,1200,500,0,23300,14300,13700,0,1923,296,250,90,110,323
2020,040700291,116383,37337,37337,37337,0,79046,69000,44000,25000,0,10046,3800,1246,5000,0,0,0,0,7037,723,126,367,309,3117
2020,040700341,37800,18450,18450,18450,0,19350,19000,19000,0,0,350,350,0,0,350,350,0,0,2540,400,60,150,360,652
2020,040700351,37320,320,320,320,0,37000,37000,13000,24000,0,0,0,0,0,25000,24000,24000,0,690,240,150,30,30,41
2020,040700361,33606,7756,7756,7756,0,25850,25000,25000,0,0,850,850,0,0,16000,16000,16000,0,2490,230,40,200,240,219
2020,040700371,67700,26200,5200,5200,21000,41500,40000,0,40000,0,1500,1500,0,0,21900,900,0,900,2880,360,300,200,120,1045
2020,040700381,112098,62098,32098,30098,30000,50000,30000,0,30000,0,20000,5000,15000,0,57900,52900,12800,40000,8126,340,95,480,300,688
2020,040700391,10110,210,210,210,0,9900,9900,6900,3000,0,0,0,0,0,0,0,0,0,533,122,60,0,23,2
2020,040800211,4090,3090,2090,90,1000,1000,0,0,0,0,1000,0,1000,0,4020,4020,0,4020,1679,781,46,182,132,1
2020,040800221,37531,25733,25733,25733,0,11798,11000,11000,0,0,798,490,308,0,1720,20,0,0,2506,180,136,330,187,233
2020,040800271,53459,911,911,911,0,52548,49000,49000,0,0,3548,3190,358,0,0,0,0,0,4035,216,24,420,144,156
2020,040800291,10116,1083,1083,1083,0,9033,9000,9000,0,0,33,0,33,0,100,0,0,0,1941,214,680,178,162,13
2020,040800311,123230,2330,2330,2330,0,120900,119200,38000,81200,0,1700,100,1600,0,4370,4170,4170,0,1722,218,35,140,120,131
2020,040800321,10970,10370,10370,10370,0,600,0,0,0,0,600,600,0,0,30,30,0,0,2780,180,100,150,120,80
2020,040800331,163000,11800,11800,11800,0,151200,151000,27000,124000,0,200,200,0,0,30500,0,0,0,3542,280,1200,200,42,696
2020,040800341,49595,3295,3295,3295,0,46300,40000,20000,20000,0,6300,3300,3000,0,100,0,0,0,3314,580,780,240,144,85
2020,040800351,30410,9510,9510,9510,0,20900,20000,20000,0,0,900,900,0,0,0,0,0,0,4000,250,150,200,300,103
2020,040800371,4800,2300,1800,1800,500,2500,0,0,0,0,2500,2500,0,0,1200,1200,0,0,2070,600,10,240,180,69
2020,040800391,27600,5600,5600,4100,0,22000,17000,15000,2000,0,5000,2000,3000,0,0,0,0,0,6400,300,100,300,200,89
2020,040900221,23428,4689,4689,4689,0,18739,15500,15500,0,0,3239,2750,489,0,2560,60,0,0,1797,172,12,51,228,51
2020,040900231,10300,10300,300,300,10000,0,0,0,0,0,0,0,0,0,0,0,0,0,576,120,96,12,24,1
2020,040900251,2702,1071,771,771,300,1631,0,0,0,0,1631,1550,81,0,600,600,0,0,2524,900,36,132,360,24
2020,040900261,60,27,27,27,0,33,0,0,0,0,33,0,33,0,0,0,0,0,572,70,26,15,15,1
2020,040900271,16615,547,547,547,0,16068,16000,16000,0,0,68,0,68,0,0,0,0,0,547,95,120,35,20,16
2020,040900281,25090,3909,3909,3909,0,21181,17500,17500,0,0,3681,3000,681,0,3000,3000,0,3000,2290,176,175,300,184,185
2020,040900291,24199,6082,6082,6082,0,18117,17000,17000,0,0,1117,970,147,0,20,20,0,0,4794,300,1300,780,350,97
2020,040900311,2750,1250,250,250,1000,1500,0,0,0,0,1500,1500,0,0,0,0,0,0,1800,600,100,300,120,30
2020,040900321,22100,4100,4100,4100,0,18000,18000,18000,0,0,0,0,0,0,0,0,0,0,2550,380,600,40,120,69
2020,040900331,62760,9660,9660,9660,0,53100,48000,22000,26000,0,5100,5100,0,0,0,0,0,0,5350,350,50,700,400,2487
2020,040900351,4210,210,210,210,0,4000,4000,4000,0,0,0,0,0,0,0,0,0,0,730,100,150,20,40,5
2020,040900361,117470,570,570,570,0,116900,115000,115000,0,0,1900,1900,0,0,46000,40000,40000,0,4680,80,100,200,200,306
2020,040900371,2010,510,10,10,500,1500,0,0,0,0,1500,1500,0,0,200,200,0,0,2970,660,760,120,110,101
2020,040900381,860,860,360,360,500,0,0,0,0,0,0,0,0,0,2000,2000,0,2000,2080,450,50,70,120,67
2020,040900391,21470,17270,1270,1270,16000,4200,0,0,0,0,4200,4200,0,0,20300,20300,12400,3300,2516,180,36,600,180,157
2020,041000202,4496,3646,146,146,3500,850,0,0,0,0,850,850,0,0,6500,6500,6500,0,1082,125,96,84,198,2
2020,041000212,3146,2946,2446,2446,500,200,0,0,0,0,200,200,0,0,0,0,0,0,1608,181,351,182,48,29
2020,041000222,14393,700,700,700,0,13693,13000,13000,0,0,693,583,110,0,2000,2000,2000,0,1510,144,313,300,128,126
2020,041000232,7095,7095,95,95,7000,0,0,0,0,0,0,0,0,0,4000,4000,4000,0,2181,81,3,117,156,1
2020,041000242,2518,2450,2450,2450,0,68,0,0,0,0,68,0,68,0,0,0,0,0,1355,88,76,72,90,24
2020,041000252,12082,82,82,82,0,12000,12000,7000,5000,0,0,0,0,0,0,0,0,0,843,125,135,65,65,60
2020,041000262,89198,23308,23308,23208,0,65890,63000,38000,25000,0,2890,1300,1590,0,1000,0,0,0,3712,360,120,420,240,253
2020,041000282,148648,34922,12922,12922,22000,113726,112000,0,112000,0,1726,1500,226,0,37000,37000,37000,0,4270,264,32,1368,276,1030
2020,041000302,82698,2248,2248,1248,0,80450,65400,9000,56400,0,15050,4800,5250,5000,13024,13024,8000,470,6300,500,200,800,200,91
2020,041000322,8822,822,822,760,0,8000,6000,6000,0,0,2000,2000,0,0,4204,4204,2895,960,2476,240,120,55,248,82
2020,041000342,550,550,550,550,0,0,0,0,0,0,0,0,0,0,0,0,0,0,546,130,70,10,16,1
2020,041000352,305,45,45,45,0,260,0,0,0,0,260,260,0,0,0,0,0,0,3040,300,200,300,260,8
2020,041000362,28118,505,505,505,0,27613,27500,3500,24000,0,113,0,113,0,0,0,0,0,208,84,0,0,48,11
2020,041000382,1721,521,521,521,0,1200,1000,1000,0,0,200,0,200,0,0,0,0,0,2194,800,600,10,84,6
2020,041000392,2965,465,465,465,0,2500,2500,2500,0,0,0,0,0,0,0,0,0,0,1530,380,60,310,80,4
2020,041600201,39359,6201,6201,4201,0,33158,33000,18000,15000,0,158,0,158,0,5050,2050,2000,0,1159,125,79,85,132,223
2020,041600211,26714,8488,8488,6488,0,18226,18000,18000,0,0,226,0,226,0,200,0,0,0,2585,852,100,80,90,24
2020,041600221,1993,1993,393,393,1600,0,0,0,0,0,0,0,0,0,0,0,0,0,1042,198,18,64,66,1
2020,041600231,36221,2951,2951,2951,0,33270,33000,33000,0,0,270,0,270,0,19162,19162,18680,0,7262,214,5000,250,280,20
2020,041600251,68123,7823,7823,7823,0,60300,42200,31000,11200,0,18100,3100,15000,0,0,0,0,0,4633,432,700,680,240,566
2020,041600261,1237,187,187,187,0,1050,1000,0,1000,0,50,0,50,0,0,0,0,0,946,243,122,24,36,4
2020,041600271,41533,11030,11030,11030,0,30503,30000,30000,0,0,503,390,113,0,0,0,0,0,3302,240,1330,140,62,73
2020,041600281,19971,10103,10103,10103,0,9868,9800,9800,0,0,68,0,68,0,0,0,0,0,1003,163,402,36,31,35
2020,041600291,5512,3812,312,312,3500,1700,0,0,0,0,1700,800,0,900,25000,25000,1000,1000,3773,852,66,398,368,11
2020,041600331,70225,9075,9075,9075,0,61150,60000,20000,40000,0,1150,1150,0,0,200,200,0,0,4300,400,500,600,100,1402
2020,041600351,64000,3050,3050,3050,0,60950,60000,22000,38000,0,950,880,70,0,0,0,0,0,2723,300,750,150,170,184
2020,041600371,6640,6040,6040,6040,0,600,600,600,0,0,0,0,0,0,0,0,0,0,566,80,40,16,25,3
2020,041600381,20030,1030,1030,1030,0,19000,18500,15000,3500,0,500,500,0,0,900,400,0,400,3500,350,200,350,300,194
2020,041700211,264,264,14,14,250,0,0,0,0,0,0,0,0,0,0,0,0,0,757,56,214,23,18,0
2020,041700221,251,251,8,8,243,0,0,0,0,0,0,0,0,0,0,0,0,0,1375,122,21,28,53,0
2020,041700231,32505,5,5,5,0,32500,32500,10500,22000,0,0,0,0,0,0,0,0,0,3904,108,3500,90,18,45
2020,041700241,10005,9905,1805,1805,8100,100,0,0,0,0,100,100,0,0,0,0,0,0,3933,672,240,480,216,34
2020,041700261,46496,6031,6031,6031,0,40465,39000,39000,0,0,1465,1230,235,0,18500,18500,18500,0,2459,112,208,600,240,186
2020,041700271,3445,3445,445,445,3000,0,0,0,0,0,0,0,0,0,0,0,0,0,1310,84,72,84,120,7
2020,041700281,6197,197,197,197,0,6000,6000,6000,0,0,0,0,0,0,0,0,0,0,1007,96,650,21,18,6
2020,041700321,51220,4220,4220,4220,0,47000,40000,40000,0,0,7000,7000,0,0,6000,6000,6000,0,4160,360,100,100,250,1158
2020,041700341,984,884,884,884,0,100,0,0,0,0,100,100,0,0,0,0,0,0,1696,800,360,120,96,35
2020,041700351,5350,300,200,200,100,5050,4800,0,4800,0,250,250,0,0,370,370,0,0,1174,372,10,20,60,28
2020,041700361,2210,2180,1880,1880,300,30,0,0,0,0,30,30,0,0,2500,2500,0,2500,1954,420,0,240,144,57
2020,041700371,20,20,20,20,0,0,0,0,0,0,0,0,0,0,0,0,0,0,815,150,300,50,15,1
2020,041700381,17856,2856,2856,2856,0,15000,15000,5000,10000,0,0,0,0,0,4000,4000,4000,0,761,340,60,80,11,41
2020,041700391,44440,1540,1540,1540,0,42900,40000,40000,0,0,2900,2900,0,0,19000,19000,19000,0,2060,180,76,480,264,138
2020,041800201,69649,22823,22823,22823,0,46826,45000,45000,0,0,1826,1600,226,0,17050,17050,17000,0,4090,396,62,526,117,436
2020,041800221,34728,615,615,615,0,34113,34000,20000,14000,0,113,0,113,0,800,0,0,0,1029,168,250,61,48,39
2020,041800231,96530,12680,12680,12680,0,83850,66000,66000,0,0,17850,15500,2350,0,0,0,0,0,8155,650,55,750,350,1286
2020,041800251,26562,5814,5814,5814,0,20748,20000,10000,10000,0,748,700,48,0,0,0,0,0,727,157,15,60,70,49
2020,041800261,15169,14697,10697,10697,4000,472,0,0,0,0,472,246,226,0,0,0,0,0,3100,204,40,240,168,1016
2020,041800281,4443,4443,2943,2943,1500,0,0,0,0,0,0,0,0,0,700,700,700,0,1902,202,1025,121,48,6
2020,041800311,16600,900,900,900,0,15700,14000,14000,0,0,1700,1700,0,0,8828,8828,8828,0,2759,230,50,500,144,155
2020,041800321,32850,782,782,782,0,32068,30000,0,30000,0,2068,1200,868,0,160,160,0,160,1192,55,194,220,180,20
2020,041800331,45500,21300,21300,21300,0,24200,22000,17000,5000,0,2200,1900,300,0,0,0,0,0,6822,216,20,420,216,586
2020,041800341,16600,300,300,300,0,16300,16000,16000,0,0,300,300,0,0,0,0,0,0,1236,240,50,200,36,47
2020,041800351,53500,2000,2000,2000,0,51500,10200,5000,5200,0,41300,1300,40000,0,0,0,0,0,3006,380,120,730,65,99
2020,041800361,71600,8100,8100,8100,0,63500,62500,29500,33000,0,1000,1000,0,0,1100,0,0,0,1446,122,78,234,76,86
2020,041800371,1330,1330,830,830,500,0,0,0,0,0,0,0,0,0,0,0,0,0,1152,430,70,30,130,207
2020,041900211,4830,4530,4030,4030,500,300,0,0,0,0,300,300,0,0,0,0,0,0,1914,540,100,248,126,88
2020,041900221,39477,11402,11402,11402,0,28075,27000,27000,0,0,1075,880,195,0,0,0,0,0,5774,144,120,360,360,741
2020,041900231,28779,279,279,279,0,28500,28500,28500,0,0,0,0,0,0,6729,6729,6729,0,1571,252,116,135,144,34
2020,041900251,26821,156,156,156,0,26665,26600,13600,13000,0,65,0,65,0,1000,0,0,0,997,156,242,72,96,31
2020,041900261,1374,1294,294,294,1000,80,0,0,0,0,80,0,80,0,0,0,0,0,2198,540,42,100,128,1
2020,041900271,21350,7900,7900,7900,0,13450,12000,12000,0,0,1450,1200,250,0,4500,4500,0,4500,3719,399,100,220,200,59
2020,041900281,36325,8075,8075,8075,0,28250,28000,28000,0,0,250,250,0,0,0,0,0,0,3283,245,36,432,144,247
2020,041900311,1600,1150,150,150,1000,450,0,0,0,0,450,450,0,0,100,100,0,100,1960,250,160,350,80,41
2020,041900321,10980,5410,5410,5410,0,5570,5500,5500,0,0,70,0,70,0,50,50,0,0,1216,120,260,120,36,7
2020,041900331,13954,5554,5554,5554,0,8400,7500,7500,0,0,900,900,0,0,0,0,0,0,1742,148,70,270,54,28
2020,041900341,137536,11536,11536,11536,0,126000,59000,0,59000,0,67000,1000,66000,0,53000,50000,50000,0,3578,78,20,398,264,202
2020,041900361,30700,25500,500,500,25000,5200,3500,0,0,3500,1700,1700,0,0,10000,10000,10000,0,6810,324,100,180,216,2771
2020,041900381,6490,40,40,40,0,6450,6300,6300,0,0,150,150,0,0,3940,3940,3940,0,1354,100,300,120,84,27
2020,041900391,15626,1200,1200,1200,0,14426,14200,2200,12000,0,226,0,226,0,0,0,0,0,811,230,100,60,21,11
2020,042000212,22933,6255,6255,6255,0,16678,15000,15000,0,0,1678,1550,128,0,0,0,0,0,2947,192,30,620,180,358
2020,042000222,17569,1520,1520,1520,0,16049,15000,15000,0,0,1049,1000,49,0,0,0,0,0,1267,99,12,185,240,40
2020,042000232,5658,4458,3458,3458,1000,1200,0,0,0,0,1200,1200,0,0,1000,1000,1000,0,1750,600,60,120,72,99
2020,042000242,822,822,722,722,100,0,0,0,0,0,0,0,0,0,0,0,0,0,1634,336,50,120,84,0
2020,042000252,3462,3462,3162,3162,300,0,0,0,0,0,0,0,0,0,0,0,0,0,1007,444,10,29,54,0
2020,042000302,30196,4170,4170,3570,0,26026,20000,20000,0,0,6026,3300,2726,0,8000,7500,7500,0,7430,3200,150,630,600,226
2020,042000322,20500,2300,2300,2300,0,18200,15000,3000,12000,0,3200,1070,2130,0,1000,1000,0,1000,2720,144,12,188,125,19
2020,042000332,51054,5400,5400,5400,0,45654,44354,8000,36354,0,1300,600,700,0,0,0,0,0,783,54,10,127,29,20
2020,042000342,14753,980,980,980,0,13773,13773,7320,6453,0,0,0,0,0,0,0,0,0,752,230,80,40,6,67
2020,042000362,3800,300,300,300,0,3500,3500,3500,0,0,0,0,0,0,0,0,0,0,576,118,150,10,18,2
2020,042000372,3010,10,10,10,0,3000,3000,3000,0,0,0,0,0,0,0,0,0,0,571,162,120,10,24,2
2020,042000382,1935,1735,35,35,1700,200,0,0,0,0,200,0,200,0,2360,2360,1300,1060,1572,372,80,120,240,94
2020,042000392,36840,14740,14740,14740,0,22100,21000,21000,0,0,1100,1100,0,0,0,0,0,0,3524,240,240,600,300,669
2020,042600201,22708,2246,2246,2246,0,20462,20000,20000,0,0,462,299,163,0,5394,5394,5394,0,1860,194,10,183,72,46
2020,042600211,24884,1184,1184,1184,0,23700,20000,20000,0,0,3700,3700,0,0,8316,8316,6705,400,2978,785,50,342,264,313
2020,042600221,43819,11933,11933,11933,0,31886,28000,28000,0,0,3886,3700,186,0,2396,2396,2396,0,3998,284,112,456,243,1366
2020,042600231,29061,5934,5934,5934,0,23127,21800,21800,0,0,1327,1200,127,0,10880,10880,10880,0,3829,295,70,450,170,83
2020,042600311,21453,3340,3340,3340,0,18113,18000,3000,15000,0,113,0,113,0,0,0,0,0,1719,815,380,35,24,24
2020,042600331,31573,8713,8713,8713,0,22860,21980,5500,16480,0,880,850,30,0,0,0,0,0,1765,274,65,230,141,83
2020,042600341,9420,2220,2220,2220,0,7200,7000,7000,0,0,200,200,0,0,0,0,0,0,2078,198,120,120,60,13
2020,042600351,7000,2000,2000,2000,0,5000,5000,5000,0,0,0,0,0,0,0,0,0,0,657,123,180,60,24,6
2020,042700201,22065,65,65,65,0,22000,18000,18000,0,0,4000,4000,0,0,8841,8841,6311,2500,1676,180,70,350,180,78
2020,042700211,31347,5487,5487,5487,0,25860,25000,25000,0,0,860,860,0,0,50,50,0,0,2826,432,120,480,216,103
2020,042700231,101299,3179,3179,3179,0,98120,96000,53000,43000,0,2120,1700,420,0,45400,15400,15400,0,3812,360,45,375,336,512
2020,042700301,18271,1681,1681,1681,0,16590,16570,5920,10650,0,20,0,20,0,0,0,0,0,1122,194,180,48,99,13
2020,042700311,50100,1890,1890,1890,0,48210,22000,7000,15000,0,26210,1710,24500,0,3200,3200,1100,2000,1770,83,118,220,104,79
2020,042700321,6660,2660,2660,2660,0,4000,4000,4000,0,0,0,0,0,0,0,0,0,0,1116,118,10,72,68,70
2020,042700341,10547,5147,5147,5147,0,5400,5400,5400,0,0,0,0,0,0,0,0,0,0,902,150,36,15,15,4
2020,042700351,22070,10470,10470,10470,0,11600,10000,6000,4000,0,1600,1600,0,0,0,0,0,0,1930,100,100,100,180,523
2020,042800201,27665,4265,4265,4265,0,23400,23000,23000,0,0,400,400,0,0,11540,11540,11540,0,2647,190,20,72,335,53
2020,042800221,77902,37537,37537,37537,0,40365,36000,36000,0,0,4365,2900,1465,0,0,0,0,0,4294,600,132,180,216,2683
2020,042800301,51,51,1,1,50,0,0,0,0,0,0,0,0,0,0,0,0,0,960,240,60,12,36,1
2020,042800311,55405,9180,9180,9180,0,46225,45000,25000,20000,0,1225,1200,25,0,1050,1050,0,0,1430,210,170,360,145,48
2020,042800321,48530,6450,6450,5150,0,42080,21200,5200,16000,0,20880,16800,80,4000,4580,4580,0,4580,7090,1050,1200,1390,450,249
2020,042800331,7050,50,50,50,0,7000,7000,7000,0,0,0,0,0,0,0,0,0,0,480,115,90,30,15,5
2020,042800341,11995,245,245,245,0,11750,10500,0,10500,0,1250,50,1200,0,5104,5104,4000,1000,2025,156,60,396,215,13
2020,042800351,15006,1216,1216,1216,0,13790,13700,2700,11000,0,90,0,90,0,5500,0,0,0,1227,360,120,180,19,8
2020,042800361,60,60,60,60,0,0,0,0,0,0,0,0,0,0,490,490,0,490,803,247,60,48,18,1
2020,042800371,61932,1532,1532,1532,0,60400,47000,4000,34000,9000,13400,400,13000,0,26500,26500,23000,0,1604,420,150,150,120,46
2020,042800381,6890,390,390,390,0,6500,6500,6500,0,0,0,0,0,0,4900,4900,2200,0,1596,400,120,100,96,11
2020,042800391,43133,15033,15033,15033,0,28100,24000,24000,0,0,4100,3600,500,0,8098,8098,7605,83,4300,360,100,450,240,83
2020,042900201,210,210,10,10,200,0,0,0,0,0,0,0,0,0,0,0,0,0,695,108,12,24,4,0
2020,042900231,20338,17508,5938,5938,11570,2830,0,0,0,0,2830,2500,330,0,13700,13700,8500,4700,3765,251,498,501,149,163
2020,042900241,3056,2256,2256,2256,0,800,0,0,0,0,800,800,0,0,0,0,0,0,2155,156,50,360,144,48
2020,042900311,105299,5669,5669,5669,0,99630,98000,50000,48000,0,1630,1100,530,0,20040,20040,0,20000,2970,300,10,240,120,176
2020,042900321,15250,250,250,250,0,15000,12000,12000,0,0,3000,3000,0,0,0,0,0,0,1072,180,180,60,32,86
2020,042900331,14328,28,28,28,0,14300,14000,2000,12000,0,300,300,0,0,6160,6160,5500,0,1386,100,10,460,96,10
2020,042900351,11486,10260,2260,2260,8000,1226,0,0,0,0,1226,1000,226,0,25000,25000,25000,0,5570,180,100,360,324,312
2020,042900361,26800,800,800,800,0,26000,26000,0,26000,0,0,0,0,0,0,0,0,0,565,252,172,0,24,21
2020,042900371,22889,5959,5959,5959,0,16930,12900,8900,4000,0,4030,4000,30,0,400,400,0,0,3354,240,540,480,84,155
2020,042900391,14100,3300,3300,3300,0,10800,8800,4000,4800,0,2000,1500,500,0,4853,4853,800,4000,2084,245,60,128,250,37
2020,043000322,3005,5,5,5,0,3000,3000,3000,0,0,0,0,0,0,0,0,0,0,294,40,24,0,0,3
2020,050000212,9150,2000,2000,2000,0,7150,6000,0,6000,0,1150,1150,0,0,2444,2344,2120,0,1601,178,10,240,123,65
2020,050000232,11420,2620,2620,2620,0,8800,8500,8500,0,0,300,300,0,0,0,0,0,0,1904,156,120,240,168,40
2020,050000242,3205,2705,705,705,2000,500,0,0,0,0,500,500,0,0,300,300,0,0,2672,492,100,240,240,121
2020,050000252,1065,575,275,275,300,490,0,0,0,0,490,490,0,0,0,0,0,0,2350,440,110,450,90,119
2020,050000262,15000,0,0,0,0,15000,15000,0,15000,0,0,0,0,0,13000,5000,5000,0,1054,122,150,40,28,94
2020,050000282,10180,4180,4180,4180,0,6000,6000,6000,0,0,0,0,0,0,0,0,0,0,1172,180,216,240,36,44
2020,050000312,43300,11300,11300,11300,0,32000,31500,11500,20000,0,500,500,0,0,0,0,0,0,1540,460,120,240,60,93
2020,050000332,37160,3990,3990,3990,0,33170,33000,33000,0,0,170,170,0,0,5500,0,0,0,1191,150,15,130,60,74
2020,050000342,39084,5814,5814,5814,0,33270,33000,30000,3000,0,270,270,0,0,6000,1000,0,1000,3444,2168,360,360,96,55
2020,050000382,20608,3408,3408,3408,0,17200,16000,16000,0,0,1200,1200,0,0,13000,13000,13000,0,4154,408,15,360,216,288
2020,050000392,125944,21744,21744,21744,0,104200,79000,42000,37000,0,25200,5000,20200,0,11455,4455,2900,1555,7063,427,317,550,360,815
2020,050600221,410,410,10,10,400,0,0,0,0,0,0,0,0,0,0,0,0,0,542,60,200,0,12,1
2020,050600231,320,320,100,100,220,0,0,0,0,0,0,0,0,0,0,0,0,0,620,108,50,10,15,0
2020,050600311,10280,80,80,80,0,10200,10000,10000,0,0,200,200,0,0,8600,8600,3000,1000,3268,178,80,600,480,50
2020,050600321,33766,15866,15866,15866,0,17900,16000,16000,0,0,1900,1300,600,0,3300,3300,3000,300,2980,400,300,360,200,56
2020,050600331,12443,3243,3243,3243,0,9200,8000,8000,0,0,1200,1200,0,0,0,0,0,0,2690,300,150,300,180,81
2020,050600341,84550,13550,13550,13550,0,71000,60000,60000,0,0,11000,0,1000,10000,7000,0,0,0,3900,500,200,150,200,1760
2020,050600361,6197,6197,5197,5197,1000,0,0,0,0,0,0,0,0,0,0,0,0,0,1310,480,20,30,70,2
2020,050600381,35820,8170,8170,8170,0,27650,25000,25000,0,0,2650,2450,200,0,0,0,0,0,5896,148,24,360,180,739
2020,050600391,37228,3358,3358,3358,0,33870,29770,29770,0,0,4100,4100,0,0,15300,15300,10000,3000,4082,240,60,600,240,465
2020,050700211,7120,120,120,120,0,7000,7000,7000,0,0,0,0,0,0,15,15,0,0,319,156,12,6,18,9
2020,050700221,6450,6450,1450,1450,5000,0,0,0,0,0,0,0,0,0,500,500,0,0,856,400,80,50,36,5
2020,050700241,21980,10680,5680,5680,5000,11300,0,0,0,0,11300,1300,0,10000,0,0,0,0,1476,300,150,180,86,8
2020,050700281,18768,13018,13018,13018,0,5750,4500,4500,0,0,1250,1130,120,0,4,4,0,0,4641,719,100,696,230,572
2020,050700291,14012,10512,10512,10512,0,3500,0,0,0,0,3500,3500,0,0,0,0,0,0,6050,280,200,1200,480,231
2020,050700351,12258,1678,1678,1678,0,10580,10000,10000,0,0,580,580,0,0,1500,1500,0,1500,1845,235,150,265,150,63
2020,050700361,19032,7282,7282,7282,0,11750,10000,10000,0,0,1750,1670,80,0,2795,2795,1295,1500,2411,295,120,200,216,135
2020,050700371,25105,11485,11485,11485,0,13620,12000,12000,0,0,1620,1620,0,0,10700,10700,5700,4900,4060,350,50,180,250,417
2020,050700381,69568,2068,2068,2068,0,67500,67000,12000,55000,0,500,500,0,0,39000,39000,29000,10000,3506,276,180,760,480,916
2020,050800221,15862,2662,2662,2662,0,13200,13000,13000,0,0,200,200,0,0,11550,11550,6000,5500,4860,200,60,250,500,26
2020,050800241,26289,5939,5939,5939,0,20350,20000,20000,0,0,350,100,250,0,5590,590,0,590,3323,150,15,273,420,65
2020,050800251,15975,1225,1225,325,0,14750,14500,14500,0,0,250,100,150,0,0,0,0,0,846,100,60,40,26,16
2020,050800271,76170,7110,7110,7110,0,69060,69000,48000,21000,0,60,60,0,0,0,0,0,0,2068,330,96,560,82,223
2020,050800281,1,1,1,1,0,0,0,0,0,0,0,0,0,0,0,0,0,0,386,48,60,0,24,1
2020,050800311,43800,20650,20650,19650,0,23150,9000,9000,0,0,14150,1150,0,13000,250,250,0,0,3076,185,150,300,291,214
2020,050800321,63712,24162,24162,24162,0,39550,18000,18000,0,0,21550,6550,5000,10000,9490,9490,8300,0,5060,450,100,960,450,704
2020,050800341,32835,7135,7135,7135,0,25700,23000,16000,7000,0,2700,2700,0,0,6400,6400,4100,2000,5042,350,196,380,200,345
2020,050800371,5870,5020,20,20,5000,850,0,0,0,0,850,850,0,0,4300,4300,3500,0,1440,180,30,210,100,47
2020,050800381,29235,9935,9935,9215,0,19300,18000,13000,5000,0,1300,1100,200,0,0,0,0,0,3846,720,50,760,230,399
2020,050900231,58910,14010,3510,3010,10500,44900,43000,0,43000,0,1900,400,1000,500,19000,16000,16000,0,3390,420,30,200,240,433
2020,050900241,28660,10860,10860,10860,0,17800,16000,16000,0,0,1800,1800,0,0,0,0,0,0,5010,300,100,300,350,145
2020,050900251,16638,4638,4638,4638,0,12000,12000,12000,0,0,0,0,0,0,4949,4949,4949,0,1772,240,12,120,240,80
2020,050900261,110980,9498,9498,7498,0,101482,94000,30000,64000,0,7482,5030,2452,0,54500,54500,51500,3000,5270,210,130,720,240,757
2020,050900271,49516,6016,6016,5016,0,43500,35000,35000,0,0,8500,5000,500,3000,13000,13000,12500,500,3886,186,50,480,360,104
2020,050900281,161746,39546,39546,20046,0,122200,120600,35000,85600,0,1600,1600,0,0,97650,87000,87000,0,4190,360,300,420,120,1358
2020,050900291,11830,330,330,330,0,11500,9000,9000,0,0,2500,2500,0,0,114,114,0,0,2378,240,60,300,108,46
2020,050900311,22356,1356,1356,1356,0,21000,20500,15500,5000,0,500,500,0,0,12000,8000,8000,0,4127,170,60,360,180,152
2020,050900321,2530,2230,2230,2230,0,300,0,0,0,0,300,300,0,0,0,0,0,0,1631,306,120,192,180,24
2020,050900341,55526,7526,7526,7526,0,48000,48000,28000,20000,0,0,0,0,0,0,0,0,0,1215,154,25,65,46,82
2020,050900351,1300,600,100,100,500,700,0,0,0,0,700,700,0,0,0,0,0,0,1465,450,5,200,100,36
2020,050900371,8786,8636,2636,2636,6000,150,0,0,0,0,150,150,0,0,6000,6000,6000,0,1888,288,50,380,290,32
2020,050900381,38680,8830,8830,8830,0,29850,25000,17000,8000,0,4850,4850,0,0,0,0,0,0,5361,300,150,1000,396,889
2020,051000202,11270,10270,270,270,10000,1000,0,0,0,0,1000,1000,0,0,0,0,0,0,2660,300,10,120,228,631
2020,051000212,760,760,60,60,700,0,0,0,0,0,0,0,0,0,0,0,0,0,1816,220,10,100,156,1
2020,051000242,121510,32710,32710,32710,0,88800,88000,8000,80000,0,800,800,0,0,30000,0,0,0,3240,500,150,360,240,222
2020,051000252,51761,4311,4311,4181,0,47450,37990,37000,990,0,9460,1400,60,8000,8800,8800,8800,0,2242,336,10,720,120,86
2020,051000262,16531,31,31,31,0,16500,13000,13000,0,0,3500,3500,0,0,4670,4670,4100,570,2744,300,24,420,180,58
2020,051000272,18785,4335,4335,4335,0,14450,13500,13500,0,0,950,950,0,0,3000,3000,3000,0,3000,195,30,300,240,121
2020,051000282,46712,5212,5212,5212,0,41500,30000,30000,0,0,11500,2100,400,9000,1000,1000,0,1000,2278,180,360,720,48,59
2020,051000292,40110,1960,1960,1960,0,38150,36250,16000,20250,0,1900,1900,0,0,12634,12634,12634,0,3980,300,10,600,180,91
2020,051000302,1750,1750,1550,1550,200,0,0,0,0,0,0,0,0,0,0,0,0,0,1386,396,50,120,120,1
2020,051000322,36798,18040,18040,18040,0,18758,18500,12000,6500,0,258,100,158,0,6000,0,0,0,4282,200,120,360,132,1074
2020,051000332,10770,9970,1070,1070,8900,800,0,0,0,0,800,800,0,0,4600,4600,4600,0,3390,160,620,320,180,61
2020,051000342,34512,5512,2012,2012,3500,29000,0,0,0,0,29000,7000,22000,0,21000,21000,21000,0,3194,120,50,960,144,172
2020,051000352,6727,427,427,427,0,6300,5800,2500,3300,0,500,500,0,0,0,0,0,0,844,170,84,30,100,102
2020,051000362,7300,1000,1000,1000,0,6300,6000,6000,0,0,300,300,0,0,0,0,0,0,508,56,180,36,36,4
2020,051000372,40409,7949,7949,5949,0,32460,29500,4500,25000,0,2960,950,2010,0,2000,2000,2000,0,1365,110,120,260,95,43
2020,051000382,15940,4540,4540,4540,0,11400,10000,10000,0,0,1400,1400,0,0,1000,1000,0,1000,4684,384,1000,250,240,93
2020,051000392,15040,40,40,40,0,15000,13000,13000,0,0,2000,2000,0,0,6100,6100,6000,0,1418,272,36,120,120,47
2020,051600201,24880,6600,6600,6600,0,18280,18030,18000,30,0,250,250,0,0,0,0,0,0,2472,120,120,180,108,28
2020,051600211,2328,1928,1428,1428,500,400,0,0,0,0,400,400,0,0,0,0,0,0,3140,720,100,350,160,210
2020,051600221,800,650,150,150,500,150,0,0,0,0,150,150,0,0,50,50,0,0,3156,720,60,480,240,25
2020,051600241,51264,5664,5664,5664,0,45600,45000,25000,20000,0,600,600,0,0,6400,1400,700,700,3311,300,12,180,264,122
2020,051600281,70842,43042,43042,43042,0,27800,27000,27000,0,0,800,800,0,0,0,0,0,0,5290,480,130,600,240,563
2020,051600311,9050,2750,2750,2750,0,6300,5300,5300,0,0,1000,1000,0,0,160,160,0,0,915,100,20,150,65,35
2020,051600321,57258,18908,18908,18908,0,38350,36000,21000,15000,0,2350,2350,0,0,400,400,0,400,4440,250,220,600,240,1429
2020,051600331,64076,37374,37374,32374,0,26702,25000,21000,4000,0,1702,1250,452,0,0,0,0,0,4726,276,30,420,480,44
2020,051600341,19750,2700,2700,2700,0,17050,17000,0,17000,0,50,50,0,0,7962,7962,7962,0,1560,150,20,200,240,90
2020,051600351,78750,11600,11600,11600,0,67150,67000,12000,55000,0,150,150,0,0,0,0,0,0,2692,250,1000,312,120,137
2020,051600361,471,471,471,471,0,0,0,0,0,0,0,0,0,0,0,0,0,0,1495,268,180,120,96,8
2020,051600371,27460,60,60,60,0,27400,26000,19000,7000,0,1400,1400,0,0,11680,11680,6680,0,1216,240,30,120,96,46
2020,051600381,580,580,480,480,100,0,0,0,0,0,0,0,0,0,2130,2130,130,0,594,250,36,32,16,1
2020,051700201,47580,9780,9780,9780,0,37800,36500,13000,23500,0,1300,800,500,0,13800,13800,11800,2000,4550,600,30,360,480,283
2020,051700211,5688,1188,688,688,500,4500,0,0,0,0,4500,4500,0,0,4120,4120,0,0,1858,560,60,264,132,46
2020,051700271,5310,5310,4810,4810,500,0,0,0,0,0,0,0,0,0,0,0,0,0,3760,144,750,360,312,86
2020,051700281,6716,5456,956,956,4500,1260,0,0,0,0,1260,1260,0,0,2500,2500,1200,0,1032,84,24,110,144,14
2020,051700311,62060,12360,12360,12360,0,49700,44900,32000,12900,0,4800,2800,2000,0,21200,21200,21200,0,3500,500,30,400,200,185
2020,051700321,38449,21649,21649,21649,0,16800,16000,10000,6000,0,800,0,800,0,0,0,0,0,1274,220,50,180,84,73
2020,051700351,1550,1150,1150,1150,0,400,0,0,0,0,400,0,400,0,0,0,0,0,895,100,40,35,60,16
2020,051700361,8652,8352,1852,1852,6500,300,0,0,0,0,300,300,0,0,1400,1400,900,0,3165,120,20,200,120,159
2020,051700371,501,501,1,1,500,0,0,0,0,0,0,0,0,0,2260,2260,0,2260,1858,880,25,17,116,1
2020,051700381,100,100,100,100,0,0,0,0,0,0,0,0,0,0,0,0,0,0,460,70,30,30,30,1
2020,051700391,69148,34528,34528,34528,0,34620,27500,20000,7500,0,7120,4000,3120,0,0,0,0,0,4600,360,360,480,180,552
2020,051800201,1320,1040,640,640,400,280,0,0,0,0,280,280,0,0,2300,2300,0,2300,3018,408,30,350,310,141
2020,051800211,23170,640,640,640,0,22530,21500,16500,5000,0,1030,800,230,0,70,70,0,0,2252,900,50,120,72,40
2020,051800221,24800,800,800,800,0,24000,24000,24000,0,0,0,0,0,0,5000,5000,5000,0,1992,248,180,36,60,1
2020,051800241,210,210,10,10,200,0,0,0,0,0,0,0,0,0,0,0,0,0,1046,450,10,10,96,54
2020,051800251,36166,10416,10416,10416,0,25750,25000,25000,0,0,750,750,0,0,0,0,0,0,4674,360,100,54,300,664
2020,051800291,23679,1379,1379,1379,0,22300,20000,20000,0,0,2300,2300,0,0,12300,12300,11400,900,2440,360,80,250,240,84
2020,051800311,3990,3800,3800,3800,0,190,0,0,0,0,190,0,190,0,0,0,0,0,720,85,50,30,45,3
2020,051800321,13464,3464,3464,3464,0,10000,10000,10000,0,0,0,0,0,0,200,0,0,0,956,120,30,20,72,28
2020,051800331,10380,3080,3080,3080,0,7300,7300,7300,0,0,0,0,0,0,100,0,0,0,600,60,60,20,30,12
2020,051800341,29549,16049,16049,16049,0,13500,12000,12000,0,0,1500,1500,0,0,0,0,0,0,3685,180,100,135,360,87
2020,051800351,35000,4800,4800,4800,0,30200,24000,24000,0,0,6200,6200,0,0,0,0,0,0,5200,600,50,620,180,1974
2020,051800391,3040,3040,40,40,3000,0,0,0,0,0,0,0,0,0,0,0,0,0,730,200,40,20,40,1
2020,051900201,65484,6684,6684,5684,0,58800,45000,45000,0,0,13800,10800,0,3000,39539,39539,30000,3000,2382,200,300,200,192,36
2020,051900211,11104,30,30,30,0,11074,11000,11000,0,0,74,0,74,0,0,0,0,0,620,130,50,40,0,6
2020,051900231,53320,5920,5920,5920,0,47400,46000,22000,24000,0,1400,1400,0,0,1000,0,0,0,2416,540,240,360,120,668
2020,051900241,10619,2602,2602,2602,0,8017,8000,8000,0,0,17,0,17,0,0,0,0,0,1115,100,400,120,35,10
2020,051900251,12850,600,600,600,0,12250,12000,12000,0,0,250,250,0,0,0,0,0,0,1380,240,10,260,120,47
2020,051900261,1770,370,70,70,300,1400,200,0,200,0,1200,1200,0,0,1700,1700,0,1700,2954,480,50,480,300,31
2020,051900281,325,325,125,125,200,0,0,0,0,0,0,0,0,0,4000,4000,0,4000,2694,240,1000,480,192,417
2020,051900291,21105,205,205,205,0,20900,20000,20000,0,0,900,900,0,0,7843,7843,7843,0,3702,300,120,720,276,250
2020,051900311,2350,250,250,250,0,2100,1500,1500,0,0,600,600,0,0,0,0,0,0,2010,250,20,480,216,32
2020,051900321,14480,3480,3480,3480,0,11000,11000,3000,8000,0,0,0,0,0,0,0,0,0,900,100,250,120,45,9
2020,051900331,7590,990,990,990,0,6600,6500,6500,0,0,100,100,0,0,0,0,0,0,1440,240,100,100,150,37
2020,051900341,13300,300,300,300,0,13000,10000,10000,0,0,3000,3000,0,0,2500,2500,2500,0,1140,120,150,20,50,107
2020,051900371,71580,41400,41400,31400,0,30180,27000,11000,16000,0,3180,2050,1130,0,0,0,0,0,3610,240,1000,500,360,1088
2020,051900381,1550,150,150,150,0,1400,1400,1400,0,0,0,0,0,0,0,0,0,0,855,150,10,50,35,2
2020,051900391,400,400,400,400,0,0,0,0,0,0,0,0,0,0,8000,8000,0,6000,775,250,20,50,100,5
2020,052000232,86695,5045,5045,5045,0,81650,77700,63000,0,14700,3950,3650,300,0,6460,6460,0,6360,4763,360,348,180,95,452
2020,052000242,16960,16960,460,460,16500,0,0,0,0,0,0,0,0,0,100,100,0,0,2084,290,500,10,84,1
2020,052000252,67890,15790,15790,12790,0,52100,50000,26000,24000,0,2100,2100,0,0,17344,2344,0,2344,4600,500,300,300,200,1311
2020,052000272,448200,46200,20200,20200,26000,402000,400000,0,300000,100000,2000,2000,0,0,110000,100000,100000,0,2774,240,10,960,84,818
2020,052000282,36396,4896,4896,4896,0,31500,30000,30000,0,0,1500,1500,0,0,14000,14000,14000,0,3660,300,120,360,300,1043
2020,052000292,57845,9145,9145,9145,0,48700,45000,45000,0,0,3700,3700,0,0,18420,18420,17420,1000,2840,240,300,250,100,166
2020,052000302,6150,6150,1150,1150,5000,0,0,0,0,0,0,0,0,0,0,0,0,0,1182,288,48,72,84,1
2020,052000312,5015,5015,15,15,5000,0,0,0,0,0,0,0,0,0,3772,3772,2880,892,1437,300,3,72,132,4
2020,052000322,57082,10482,10482,10482,0,46600,45000,10000,35000,0,1600,1600,0,0,5350,350,350,0,2950,360,10,720,180,204
2020,052000342,77160,7240,7240,7240,0,69920,68400,2000,66400,0,1520,1500,20,0,0,0,0,0,1268,162,300,60,96,64
2020,052000352,15615,2270,2270,2270,0,13345,12000,12000,0,0,1345,1345,0,0,3000,3000,3000,0,2994,268,20,336,320,63
2020,052000362,17574,2874,2874,2874,0,14700,12000,12000,0,0,2700,2700,0,0,6000,6000,6000,0,2960,160,40,180,210,959
2020,052000372,4010,10,10,10,0,4000,4000,4000,0,0,0,0,0,0,0,0,0,0,439,60,72,12,24,3
2020,052600251,11180,130,130,130,0,11050,11000,11000,0,0,50,50,0,0,0,0,0,0,1540,240,40,120,120,40
2020,052600261,11320,320,320,320,0,11000,11000,11000,0,0,0,0,0,0,900,900,900,0,707,240,60,5,72,14
2020,052600271,16912,1712,1712,1712,0,15200,15000,0,15000,0,200,200,0,0,4430,4130,3950,0,2174,180,120,240,144,31
2020,052600291,21328,4128,4128,4128,0,17200,14500,14500,0,0,2700,2700,0,0,6500,6500,6000,0,1666,156,360,340,30,97
2020,052600301,2068,2068,268,268,1800,0,0,0,0,0,0,0,0,0,1500,1500,0,500,565,180,5,20,80,0
2020,052600331,9810,310,310,310,0,9500,9500,5000,4500,0,0,0,0,0,1000,1000,0,1000,848,60,60,20,48,4
2020,052600341,3177,677,677,677,0,2500,2000,1000,1000,0,500,500,0,0,3980,3980,2500,1480,1624,81,700,120,96,12
2020,052600351,24262,7912,912,912,7000,16350,0,0,0,0,16350,13350,0,3000,23244,23244,5600,1444,1953,183,60,400,270,406
2020,052600361,11156,1156,1156,1156,0,10000,10000,10000,0,0,0,0,0,0,0,0,0,0,591,75,80,15,15,5
2020,052600371,12940,2640,2640,2640,0,10300,10000,10000,0,0,300,300,0,0,300,300,0,0,2987,303,120,240,204,16
2020,052700221,7625,7625,1825,1825,5800,0,0,0,0,0,0,0,0,0,2900,2900,2900,0,1517,91,21,66,120,48
2020,052700251,24542,24342,2342,2342,22000,200,0,0,0,0,200,200,0,0,0,0,0,0,3960,360,20,400,280,47
2020,052700261,32120,2120,2120,2120,0,30000,24000,24000,0,0,6000,6000,0,0,21900,21900,12300,9600,5340,400,300,800,240,287
2020,052700281,46480,31080,31080,31080,0,15400,15000,15000,0,0,400,400,0,0,0,0,0,0,2200,250,500,440,70,230
2020,052700291,220,220,220,220,0,0,0,0,0,0,0,0,0,0,0,0,0,0,977,360,192,15,54,1
2020,052700301,230,230,230,230,0,0,0,0,0,0,0,0,0,0,0,0,0,0,665,120,60,29,36,1
2020,052700311,37700,4800,4800,4800,0,32900,32700,2700,30000,0,200,0,200,0,0,0,0,0,1220,280,360,50,60,47
2020,052700321,3100,100,100,100,0,3000,3000,3000,0,0,0,0,0,0,0,0,0,0,528,70,18,36,24,4
2020,052700331,9950,1300,1300,1300,0,8650,7800,4000,3800,0,850,850,0,0,156,156,0,0,1450,200,700,110,90,16
2020,052700351,9700,1800,1800,1800,0,7900,7900,5500,2400,0,0,0,0,0,0,0,0,0,389,150,50,30,24,4
2020,052700361,870,270,270,270,0,600,600,600,0,0,0,0,0,0,0,0,0,0,320,82,34,25,24,2
2020,052700381,58749,9710,9710,9210,0,49039,43800,2000,41800,0,5239,3300,1939,0,4170,4170,0,1300,4172,266,660,600,216,69
2020,052800201,20236,1236,1236,1236,0,19000,19000,19000,0,0,0,0,0,0,0,0,0,0,1780,400,350,60,100,24
2020,052800231,12500,1500,1500,1500,0,11000,11000,11000,0,0,0,0,0,0,52,52,0,0,2014,210,0,84,80,24
2020,052800271,67990,2990,2990,990,0,65000,63000,63000,0,0,2000,1700,300,0,0,0,0,0,3026,240,2000,180,36,120
2020,052800291,41330,11080,11080,11080,0,30250,30000,30000,0,0,250,250,0,0,1000,0,0,0,761,162,180,10,71,142
2020,052800301,32355,14125,10825,10825,3300,18230,0,0,0,0,18230,230,18000,0,10900,10900,9600,1300,2680,220,400,250,300,82
2020,052800311,22436,5506,5506,5506,0,16930,15000,15000,0,0,1930,1930,0,0,5000,5000,5000,0,3471,360,31,480,220,330
2020,052800321,193400,8650,8650,8650,0,184750,182000,5000,177000,0,2750,0,2750,0,0,0,0,0,2075,245,250,120,110,52
2020,052800331,3150,3150,3150,3150,0,0,0,0,0,0,0,0,0,0,0,0,0,0,562,144,160,10,36,1
2020,052800341,1855,1855,55,55,1800,0,0,0,0,0,0,0,0,0,1800,1800,0,1800,2838,600,10,50,200,89
2020,052800361,12945,792,792,792,0,12153,11000,1000,10000,0,1153,1000,153,0,0,0,0,0,803,150,220,120,68,39
2020,052800371,10,10,10,10,0,0,0,0,0,0,0,0,0,0,0,0,0,0,608,302,36,12,18,1
2020,052900201,20123,17323,4323,4323,13000,2800,0,0,0,0,2800,2800,0,0,0,0,0,0,2770,250,300,240,240,391
2020,052900231,14720,14520,6020,6020,8500,200,0,0,0,0,200,200,0,0,8000,8000,4000,4000,2855,180,60,423,180,482
2020,052900271,18750,2550,2550,550,0,16200,14000,14000,0,0,2200,2200,0,0,14700,14700,11700,3000,3625,240,30,550,265,108
2020,052900281,25880,7880,7880,4880,0,18000,16500,14000,0,2500,1500,0,1500,0,3999,3999,3999,0,958,204,70,60,84,12
2020,052900291,1020,1020,20,20,1000,0,0,0,0,0,0,0,0,0,750,750,0,500,1000,420,20,20,0,145
2020,052900301,28285,2285,2285,2285,0,26000,24000,8000,16000,0,2000,500,0,1500,1730,1730,0,1700,1189,124,20,240,120,72
2020,052900311,6660,1660,1660,1660,0,5000,5000,5000,0,0,0,0,0,0,0,0,0,0,622,130,36,30,16,13
2020,052900321,7280,180,180,180,0,7100,5500,5500,0,0,1600,1600,0,0,300,300,300,0,1834,220,24,180,200,66
2020,052900331,13328,5098,5098,5098,0,8230,6800,6800,0,0,1430,1430,0,0,0,0,0,0,3546,240,30,120,336,58
2020,052900351,11753,8153,8153,7153,0,3600,3000,3000,0,0,600,600,0,0,0,0,0,0,3883,299,36,1240,108,31
2020,052900361,11500,1100,100,100,1000,10400,10000,0,10000,0,400,400,0,0,5000,5000,5000,0,835,300,10,130,60,24
2020,052900371,17600,7050,7050,7050,0,10550,8000,8000,0,0,2550,2550,0,0,0,0,0,0,1070,170,40,220,120,60
2020,053000202,88875,87575,62575,62575,25000,1300,0,0,0,0,1300,1300,0,0,0,0,0,0,2186,252,70,720,84,700
2020,053000212,41480,580,580,580,0,40900,40500,17000,16000,7500,400,400,0,0,6500,6500,6500,0,830,120,180,240,65,32
2020,053000222,27827,27,27,27,0,27800,25200,25200,0,0,2600,2600,0,0,15300,15000,0,0,1929,207,60,354,336,46
2020,053000232,31700,500,500,500,0,31200,30000,30000,0,0,1200,1000,200,0,5000,5000,5000,0,1086,150,150,15,41,326
2020,053600211,22200,3200,3200,3200,0,19000,19000,19000,0,0,0,0,0,0,0,0,0,0,2246,192,100,300,144,112
2020,060000212,21590,19610,19610,19610,0,1980,0,0,0,0,1980,1880,100,0,0,0,0,0,3760,360,100,360,210,3963
2020,060000222,31320,6620,6620,6620,0,24700,15000,15000,0,0,9700,2700,7000,0,8000,8000,8000,0,3385,312,300,960,480,3759
2020,060000232,70890,32340,32340,32340,0,38550,38000,37000,1000,0,550,550,0,0,0,0,0,0,6020,960,600,480,240,1165
2020,060000252,49970,17470,17470,17470,0,32500,26400,26400,0,0,6100,6100,0,0,0,0,0,0,4810,300,150,190,290,1838
2020,060000282,272700,1000,1000,1000,0,271700,271000,41000,230000,0,700,700,0,0,150000,150000,150000,0,1334,360,50,120,84,1378
2020,060000292,32722,19122,3122,3122,16000,13600,10000,0,10000,0,3600,3600,0,0,10000,10000,10000,0,3670,360,300,240,240,28
2020,060000312,8500,8000,0,0,8000,500,0,0,0,0,500,500,0,0,8000,8000,8000,0,1310,60,10,240,90,14
2020,060000332,4655,2555,2255,2255,300,2100,0,0,0,0,2100,2100,0,0,1000,1000,0,0,827,102,20,200,28,1
2020,060000352,37900,9700,9700,9700,0,28200,27400,27400,0,0,800,800,0,0,2310,310,0,0,1420,116,305,180,60,106
2020,060000362,61190,16440,16440,16440,0,44750,42300,22300,20000,0,2450,2450,0,0,1700,1700,1000,700,2845,128,50,180,132,1599
2020,060000382,41912,3762,3762,3762,0,38150,37000,27000,8000,2000,1150,1150,0,0,5000,5000,5000,0,3722,252,400,360,240,309
2020,060000392,482460,149400,149400,149400,0,333060,320000,45000,275000,0,13060,2800,10260,0,0,0,0,0,3676,396,500,240,120,2050
2020,060600211,4644,2644,1844,1844,800,2000,0,0,0,0,2000,2000,0,0,772,772,0,772,1810,230,80,130,100,32
2020,060600221,78840,16040,16040,16040,0,62800,59000,59000,0,0,3800,3500,300,0,160,160,0,0,4966,312,660,240,300,1187
2020,060600231,44020,11120,9120,7120,2000,32900,19000,0,19000,0,13900,8100,300,5500,10974,10974,10774,0,1750,600,100,100,170,109
2020,060600311,23930,600,600,600,0,23330,22600,10000,12600,0,730,0,730,0,0,0,0,0,693,259,80,100,24,19
2020,060600331,37090,2920,2920,2920,0,34170,34000,24000,10000,0,170,0,170,0,0,0,0,0,1192,120,24,10,60,40
2020,060600341,10823,10073,2573,2573,7500,750,0,0,0,0,750,750,0,0,4500,4500,4500,0,1492,180,1,100,125,5
2020,060600351,71270,150,150,150,0,71120,71000,11000,60000,0,120,0,120,0,0,0,0,0,545,74,120,24,41,606
2020,060600361,61292,6840,6840,6840,0,54452,45000,25000,20000,0,9452,0,9452,0,7000,7000,1000,3000,1326,180,420,196,60,29
2020,060700211,38123,14323,14323,14323,0,23800,23000,23000,0,0,800,600,200,0,400,0,0,0,2097,342,170,260,200,783
2020,060700221,9060,60,60,60,0,9000,9000,9000,0,0,0,0,0,0,0,0,0,0,820,110,360,30,50,6
2020,060700231,310,310,110,110,200,0,0,0,0,0,0,0,0,0,1048,1048,0,0,1596,450,360,40,96,1
2020,060700241,116410,15160,15160,15160,0,101250,98000,45000,53000,0,3250,3250,0,0,35000,13000,13000,0,3930,300,120,260,250,669
2020,060700251,53906,7556,7556,7556,0,46350,44000,32000,12000,0,2350,2200,150,0,5000,0,0,0,2325,300,150,400,75,148
2020,060700291,25656,2556,2556,2556,0,23100,23000,23000,0,0,100,100,0,0,0,0,0,0,815,120,25,200,60,61
2020,060700311,2200,200,200,200,0,2000,2000,2000,0,0,0,0,0,0,20,20,0,0,1692,240,480,60,72,1
2020,060700341,110890,30590,30590,30590,0,80300,75000,21000,50000,4000,5300,5300,0,0,32150,9150,9000,0,3922,192,20,70,240,492
2020,060700351,4802,802,802,802,0,4000,4000,4000,0,0,0,0,0,0,0,0,0,0,1389,88,660,48,78,7
2020,060700361,145598,42748,17748,17748,25000,102850,100000,0,100000,0,2850,2850,0,0,2000,0,0,0,3340,280,30,240,84,421
2020,060700371,54233,4883,4883,4883,0,49350,47000,17000,30000,0,2350,2350,0,0,2500,2000,0,0,6562,720,120,504,348,120
2020,060700391,16888,7438,7438,7438,0,9450,9000,9000,0,0,450,250,200,0,2676,2676,2176,500,6236,404,1060,276,240,572
2020,060800221,2334,2334,2334,2334,0,0,0,0,0,0,0,0,0,0,0,0,0,0,854,170,70,50,44,1
2020,060800241,185640,12140,12140,12140,0,173500,172500,32000,140500,0,1000,700,300,0,55000,48000,48000,0,3560,180,150,180,180,2021
2020,060800251,66430,930,930,930,0,65500,64000,12000,52000,0,1500,1500,0,0,38000,38000,38000,0,2266,376,120,240,120,124
2020,060800261,66147,7497,7497,7497,0,58650,53000,53000,0,0,5650,5400,50,200,24040,24040,24040,0,2600,100,100,400,200,238
2020,060800271,18904,2254,2254,1254,0,16650,15000,15000,0,0,1650,650,0,1000,7700,7700,7700,0,2070,70,200,200,190,35
2020,060800281,44316,2116,2116,2116,0,42200,41000,27000,14000,0,1200,1200,0,0,5050,50,0,0,1820,200,100,200,50,97
2020,060800291,30536,2436,2436,2436,0,28100,28000,28000,0,0,100,100,0,0,0,0,0,0,626,156,20,120,50,28
2020,060800311,8021,3021,3021,3021,0,5000,4000,4000,0,0,1000,1000,0,0,0,0,0,0,2167,342,20,300,192,16
2020,060800321,19401,651,651,651,0,18750,18500,11000,7500,0,250,250,0,0,9000,9000,7000,2000,2696,240,36,240,240,35
2020,060800331,19380,1980,1980,1980,0,17400,17000,17000,0,0,400,400,0,0,9900,9900,9900,0,2506,360,36,240,180,152
2020,060800341,7152,5152,3152,3152,2000,2000,0,0,0,0,2000,0,0,2000,0,0,0,0,3364,1800,20,360,34,5
2020,060800351,12180,180,180,180,0,12000,12000,4000,8000,0,0,0,0,0,0,0,0,0,250,50,30,5,35,4
2020,060800361,64930,8330,8330,8330,0,56600,50000,38000,12000,0,6600,3000,2800,800,7080,7080,3800,0,2930,360,280,350,250,143
2020,060800381,60,60,60,60,0,0,0,0,0,0,0,0,0,0,0,0,0,0,689,140,60,60,24,1
2020,060800391,16471,5371,5371,5371,0,11100,11000,11000,0,0,100,0,100,0,0,0,0,0,1033,165,60,72,36,17
2020,060900211,34700,1700,1700,1700,0,33000,33000,33000,0,0,0,0,0,0,800,0,0,0,1056,358,228,40,30,24
2020,060900221,112840,15840,15840,15840,0,97000,78000,78000,0,0,19000,19000,0,0,40000,40000,40000,0,3456,300,36,480,340,378
2020,060900231,73220,5320,5320,5320,0,67900,63000,43000,20000,0,4900,4900,0,0,3230,3230,3200,0,5210,330,25,365,360,1168
2020,060900241,35150,14200,14200,13200,0,20950,18800,18800,0,0,2150,1550,100,500,200,200,0,0,3260,660,150,120,180,88
2020,060900251,32320,5790,5790,5790,0,26530,26000,26000,0,0,530,530,0,0,40,40,0,0,1600,240,100,240,120,326
2020,060900271,3582,3582,3332,3332,250,0,0,0,0,0,0,0,0,0,1150,1150,0,1150,1364,300,110,72,72,1
2020,060900291,4560,4560,4360,2360,200,0,0,0,0,0,0,0,0,0,1910,1910,400,1400,2178,384,1400,12,22,2
2020,060900311,34080,13680,13680,13680,0,20400,20000,5000,15000,0,400,400,0,0,2000,2000,0,2000,2405,120,75,180,480,71
2020,060900331,467480,47420,47420,47420,0,420060,413000,43000,370000,0,7060,7060,0,0,124000,120000,110000,10000,9168,1420,20,960,480,3366
2020,060900341,40939,8044,8044,8044,0,32895,21000,16000,5000,0,11895,1850,45,10000,0,0,0,0,1544,238,60,120,60,46
2020,060900351,85686,26126,26126,2626,0,59560,55000,25000,30000,0,4560,3500,660,400,0,0,0,0,7018,570,1180,750,408,2437
2020,060900361,34800,800,800,800,0,34000,34000,9000,25000,0,0,0,0,0,0,0,0,0,1048,72,180,36,60,57
2020,060900371,42416,5416,5366,5366,50,37000,37000,0,3000,34000,0,0,0,0,26800,26800,0,26800,3426,296,300,500,240,499
2020,060900381,98705,14160,14160,14160,0,84545,78000,78000,0,0,6545,6545,0,0,43065,43065,34065,9000,6560,500,20,530,340,1150
2020,061000202,70160,1060,1060,1060,0,69100,68500,25000,43500,0,600,600,0,0,22700,22500,20000,2500,2920,240,60,480,250,1327
2020,061000212,50770,5720,5720,5720,0,45050,45000,30000,15000,0,50,50,0,0,0,0,0,0,3228,240,650,600,108,50
2020,061000222,39001,9201,9201,9201,0,29800,28000,28000,0,0,1800,1500,300,0,0,0,0,0,2232,180,140,180,180,356
2020,061000232,23894,5794,5794,5794,0,18100,18000,18000,0,0,100,100,0,0,9400,9400,9400,0,2074,180,24,170,240,73
2020,061000242,17921,16280,13280,10280,3000,1641,1000,0,1000,0,641,641,0,0,2500,2500,0,0,3686,816,60,300,240,33
2020,061000262,2100,1500,1000,1000,500,600,0,0,0,0,600,600,0,0,0,0,0,0,1562,196,36,180,150,50
2020,061000272,9760,5310,4810,4810,500,4450,3000,0,3000,0,1450,1450,0,0,2300,2300,400,0,3810,876,140,600,204,1140
2020,061000292,30100,100,100,100,0,30000,30000,30000,0,0,0,0,0,0,0,0,0,0,768,144,120,60,24,16
2020,061000302,3030,30,30,30,0,3000,3000,3000,0,0,0,0,0,0,0,0,0,0,283,88,20,17,36,2
2020,061000312,7450,150,150,150,0,7300,7000,7000,0,0,300,300,0,0,2650,2650,2650,0,2829,408,884,360,96,9
2020,061000322,39737,27737,27737,27737,0,12000,12000,7000,5000,0,0,0,0,0,500,0,0,0,731,156,20,20,15,22
2020,061000332,8030,130,130,130,0,7900,7800,6800,1000,0,100,0,100,0,0,0,0,0,1359,168,240,60,144,7
2020,061000342,25982,599,599,599,0,25383,24000,24000,0,0,1383,1112,271,0,12400,12400,12400,0,2257,228,15,264,144,62
2020,061000362,14523,5450,5450,5450,0,9073,8100,6000,2100,0,973,860,113,0,2637,2637,2000,0,3746,182,132,610,240,109
2020,061000372,7159,648,648,648,0,6511,6000,6000,0,0,511,470,41,0,30,30,0,0,2069,160,20,252,100,37
2020,061000382,35700,1800,1800,1300,0,33900,13500,9000,4500,0,20400,3400,17000,0,0,0,0,0,2730,154,30,900,276,154
2020,061000392,21057,2316,2316,2316,0,18741,8000,3000,5000,0,10741,600,10141,0,5300,5300,1800,3500,1141,81,0,240,110,32
2020,061600201,54380,22980,22980,22980,0,31400,30000,30000,0,0,1400,1400,0,0,0,0,0,0,5664,250,130,500,450,1629
2020,061600221,22460,7260,7260,7260,0,15200,15000,15000,0,0,200,100,100,0,4120,4120,4100,0,2560,180,600,80,240,46
2020,061600231,10830,780,780,780,0,10050,10000,10000,0,0,50,50,0,0,8300,8300,8300,0,1020,180,90,10,60,28
2020,061600241,1540,1540,40,40,1500,0,0,0,0,0,0,0,0,0,0,0,0,0,2162,600,24,360,168,1
2020,061600261,18550,550,550,550,0,18000,18000,12000,6000,0,0,0,0,0,0,0,0,0,991,322,60,36,36,19
2020,061600271,5290,4340,340,340,4000,950,0,0,0,0,950,900,50,0,1000,1000,0,1000,1784,230,60,335,75,66
2020,061600291,63280,26980,26980,6980,0,36300,28000,28000,0,0,8300,2300,6000,0,12100,12100,12100,0,3560,350,30,480,200,698
2020,061600301,49502,17183,17183,17183,0,32319,32000,32000,0,0,319,250,69,0,2520,2520,520,0,3624,255,108,265,180,1189
2020,061600311,56534,22254,22254,22254,0,34280,30000,30000,0,0,4280,3500,780,0,300,300,0,0,4729,230,35,625,276,489
2020,061600321,86150,28750,28750,28750,0,57400,57000,32000,25000,0,400,400,0,0,150,150,0,0,6511,444,450,360,240,949
2020,061600331,104561,20561,20561,20561,0,84000,75000,25000,50000,0,9000,3700,5300,0,22500,22500,19500,3000,4797,240,20,420,192,1069
2020,061600371,703,703,703,703,0,0,0,0,0,0,0,0,0,0,0,0,0,0,388,58,3,30,27,1
2020,061600381,27678,321,321,321,0,27357,27300,3500,23800,0,57,0,57,0,0,0,0,0,805,94,254,40,44,13
2020,061600391,63220,16220,16220,15720,0,47000,45000,10000,35000,0,2000,250,1750,0,0,0,0,0,1191,180,120,90,36,133
2020,061700201,30135,5485,5485,5485,0,24650,22000,22000,0,0,2650,1900,750,0,6650,6650,6650,0,3170,280,40,320,200,66
2020,061700211,29500,26500,8500,8500,18000,3000,0,0,0,0,3000,3000,0,0,0,0,0,0,2420,360,200,360,120,1174
2020,061700231,245190,99090,54090,54090,45000,146100,140000,0,140000,0,6100,5100,1000,0,25000,0,0,0,6760,400,80,200,180,276
2020,061700251,34695,16945,16945,8945,0,17750,17700,17000,700,0,50,50,0,0,8000,8000,8000,0,3296,192,150,240,144,44
2020,061700261,9744,9644,8684,8484,960,100,0,0,0,0,100,100,0,0,0,0,0,0,1861,156,60,80,80,31
2020,061700291,17998,5548,5548,5548,0,12450,8000,8000,0,0,4450,1950,0,2500,0,0,0,0,2579,144,250,905,120,97
2020,061700301,18442,6942,6942,6942,0,11500,11000,9000,2000,0,500,500,0,0,5020,5020,2520,2500,2250,179,12,270,120,52
2020,061700321,211196,17996,17996,17996,0,193200,188000,28000,160000,0,5200,5100,100,0,19740,14240,10000,3500,3824,540,260,490,120,2848
2020,061700331,57347,19647,19647,19647,0,37700,36200,18000,0,18200,1500,1500,0,0,21000,21000,3000,18000,6053,300,3000,334,252,901
2020,061700341,40,40,40,40,0,0,0,0,0,0,0,0,0,0,0,0,0,0,792,258,24,12,87,1
2020,061700351,29136,1336,1336,1336,0,27800,12000,12000,0,0,15800,15800,0,0,13640,13640,7040,0,2064,144,50,120,300,24
2020,061700361,22038,8707,8707,8707,0,13331,12400,10000,2400,0,931,650,281,0,0,0,0,0,1663,150,100,410,84,27
2020,061700371,4563,240,240,240,0,4323,4200,3500,700,0,123,0,123,0,0,0,0,0,496,98,25,22,24,2
2020,061700381,1450,200,200,200,0,1250,1200,1200,0,0,50,50,0,0,2000,2000,0,2000,432,52,20,130,24,6
2020,061800201,49930,6230,6230,6230,0,43700,43000,30000,13000,0,700,700,0,0,14500,14500,9000,5500,3662,200,12,360,240,124
2020,061800211,20894,8724,8724,8724,0,12170,12000,0,12000,0,170,150,20,0,7000,7000,7000,0,3850,600,10,500,240,259
2020,061800221,6070,70,70,70,0,6000,6000,0,6000,0,0,0,0,0,2000,0,0,0,1450,300,350,20,40,6
2020,061800231,30212,20969,10969,10969,10000,9243,8500,0,8500,0,743,623,120,0,4000,2500,2500,0,4758,240,450,180,264,336
2020,061800241,160277,14677,14677,14477,0,145600,142500,70000,72500,0,3100,1700,1200,200,500,0,0,0,3527,360,120,480,300,239
2020,061800251,62580,11760,11760,11760,0,50820,48800,26000,0,22800,2020,2020,0,0,35800,35800,12900,22150,6374,264,100,850,380,490
2020,061800261,21788,4788,4788,4788,0,17000,17000,15000,2000,0,0,0,0,0,0,0,0,0,750,50,100,50,40,126
2020,061800271,56570,25460,7460,7460,18000,31110,30000,0,30000,0,1110,860,250,0,0,0,0,0,2880,180,110,450,180,49
2020,061800281,23477,2114,2114,2114,0,21363,17000,17000,0,0,4363,4100,263,0,15280,15280,12220,3000,4584,252,72,180,420,488
2020,061800291,4422,4072,3072,3072,1000,350,0,0,0,0,350,350,0,0,0,0,0,0,3138,660,50,180,108,236
2020,061800301,60211,15798,15798,5798,0,44413,38000,38000,0,0,6413,6300,113,0,1180,1180,0,480,2444,402,320,410,120,561
2020,061800311,23641,19028,13028,13028,6000,4613,2400,0,0,2400,2213,2100,113,0,1600,1600,0,1600,3350,360,150,200,140,113
2020,061800321,59764,4684,4684,4684,0,55080,55000,20000,35000,0,80,0,80,0,0,0,0,0,486,84,12,25,20,27
2020,061800331,16880,10280,8280,8280,2000,6600,0,0,0,0,6600,3600,3000,0,500,500,0,0,2580,680,5,300,240,73
2020,061800341,15319,10749,9449,8949,1300,4570,2000,0,2000,0,2570,1670,400,500,1847,1847,0,1347,4587,896,1,480,480,282
2020,061800361,6440,150,150,150,0,6290,5500,2500,3000,0,790,790,0,0,0,0,0,0,780,120,60,180,60,5
2020,061800371,41916,2016,2016,2016,0,39900,22400,22400,0,0,17500,2500,15000,0,13650,13650,13500,0,2900,276,108,300,252,232
2020,061800391,18720,290,290,290,0,18430,18400,9400,9000,0,30,0,30,0,0,0,0,0,462,128,60,15,19,5
2020,061900201,120861,4911,4911,3411,0,115950,114000,104000,10000,0,1950,1950,0,0,20200,19200,19000,0,1698,228,20,430,60,207
2020,061900211,3220,3220,820,820,2400,0,0,0,0,0,0,0,0,0,0,0,0,0,770,150,200,70,40,1
2020,061900231,15947,15040,5040,5040,10000,907,0,0,0,0,907,907,0,0,160,160,0,0,3661,156,15,180,240,242
2020,061900241,500,500,500,500,0,0,0,0,0,0,0,0,0,0,0,0,0,0,254,60,15,12,24,1
2020,061900261,5694,4494,3494,1994,1000,1200,0,0,0,0,1200,1200,0,0,0,0,0,0,1950,420,50,140,120,33
2020,061900271,34453,3853,3853,3853,0,30600,29500,25000,4500,0,1100,540,560,0,2000,0,0,0,4150,250,20,400,180,1213
2020,061900291,44318,10368,10368,10368,0,33950,33000,33000,0,0,950,950,0,0,1400,1400,1400,0,4252,360,480,264,120,992
2020,061900301,4050,50,50,50,0,4000,4000,4000,0,0,0,0,0,0,4000,4000,0,0,32,7,5,0,20,4
2020,061900311,8032,7356,3856,3856,3500,676,0,0,0,0,676,450,226,0,0,0,0,0,1441,144,12,145,87,25
2020,061900321,12470,2309,2309,2309,0,10161,9535,2500,7035,0,626,0,626,0,0,0,0,0,1148,106,384,67,245,8
2020,061900331,8048,348,348,348,0,7700,7700,7700,0,0,0,0,0,0,0,0,0,0,588,132,60,20,36,3
2020,061900351,33059,3659,3659,3659,0,29400,24000,18000,6000,0,5400,5300,100,0,18000,18000,9000,9000,5552,572,200,390,360,811
2020,061900361,10760,2414,2414,2414,0,8346,1400,1400,0,0,6946,4020,2926,0,8500,8500,1200,3540,3606,120,305,461,420,37
2020,061900381,54830,5730,5730,5730,0,49100,49000,1200,47800,0,100,0,100,0,0,0,0,0,1340,250,230,100,40,21
2020,061900391,36240,4140,4140,4140,0,32100,31000,13000,18000,0,1100,1000,100,0,0,0,0,0,1266,130,70,300,126,10
2020,062000302,190,190,190,190,0,0,0,0,0,0,0,0,0,0,0,0,0,0,384,112,2,10,15,0
2020,062000322,35167,14867,14867,14867,0,20300,18500,18500,0,0,1800,1800,0,0,0,0,0,0,6184,220,2200,250,264,1451
2020,062000332,27720,3770,3770,3770,0,23950,23000,13000,10000,0,950,950,0,0,1000,1000,0,500,3092,212,550,180,240,127
2020,062000342,44771,8130,8130,8130,0,36641,36000,8000,28000,0,641,531,110,0,3220,3220,3220,0,1076,172,30,110,79,28
2020,062000352,25428,6127,6127,6127,0,19301,15000,3000,12000,0,4301,1720,2581,0,70000,70000,70000,0,3806,171,431,980,203,167
2020,062000362,21370,570,570,570,0,20800,20600,1000,19600,0,200,150,50,0,0,0,0,0,416,82,54,12,48,33
2020,062000372,4760,3760,3760,3760,0,1000,1000,1000,0,0,0,0,0,0,0,0,0,0,607,83,60,0,24,3
2020,062600311,2646,38,38,38,0,2608,2500,1750,750,0,108,0,108,0,0,0,0,0,684,54,10,55,30,3
2020,062600321,16748,6748,6248,4248,500,10000,10000,0,10000,0,0,0,0,0,0,0,0,0,1523,543,45,123,60,15
2020,062600331,16130,8110,8110,8110,0,8020,8000,0,8000,0,20,0,20,0,0,0,0,0,4181,2690,700,30,41,22
2020,062600341,300,300,300,300,0,0,0,0,0,0,0,0,0,0,0,0,0,0,514,90,130,30,24,1
2020,062600351,1545,5,5,5,0,1540,1500,1500,0,0,40,0,40,0,0,0,0,0,771,131,70,50,120,1
2020,062600361,14630,6530,6530,6530,0,8100,2000,2000,0,0,6100,1500,4600,0,0,0,0,0,2382,208,300,480,120,78
2020,062700301,25700,544,544,544,0,25156,19000,15000,4000,0,6156,5930,226,0,4620,4620,0,100,4433,533,140,630,180,337
2020,062700311,17309,3259,3259,3259,0,14050,12050,5000,7050,0,2000,100,1900,0,8000,8000,4000,0,1950,240,300,100,170,70
2020,062700321,2850,100,100,100,0,2750,0,0,0,0,2750,250,2500,0,11700,11700,11700,0,574,60,10,220,27,33
2020,062700331,9640,2960,2960,2960,0,6680,6000,6000,0,0,680,680,0,0,0,0,0,0,969,55,24,144,66,63
2020,062700371,181,31,31,31,0,150,0,0,0,0,150,0,150,0,0,0,0,0,447,51,30,15,10,1
2020,062800301,6868,2468,2468,2468,0,4400,4400,2000,2400,0,0,0,0,0,0,0,0,0,1177,140,730,15,26,5
2020,062800311,3610,610,610,610,0,3000,3000,600,2400,0,0,0,0,0,0,0,0,0,594,70,52,58,40,3
2020,062800321,6565,598,598,598,0,5967,5900,1000,4900,0,67,0,67,0,0,0,0,0,493,68,120,58,42,4
2020,062800371,16145,228,228,228,0,15917,15800,5000,10800,0,117,0,117,0,0,0,0,0,938,108,260,28,48,8
2020,062900301,80656,23040,23040,23040,0,57616,44990,7000,37990,0,12626,800,11826,0,330,330,0,0,3200,110,1270,560,150,63
2020,062900311,22580,2410,2410,2410,0,20170,16150,4000,12150,0,4020,2450,1570,0,3000,3000,2000,1000,1733,208,220,200,100,65
2020,062900321,8515,615,615,615,0,7900,7800,3000,4800,0,100,0,100,0,0,0,0,0,958,156,120,36,24,8
2020,062900331,24205,360,360,360,0,23845,23700,17700,6000,0,145,100,45,0,0,0,0,0,818,214,124,36,51,24
2020,062900341,6731,531,531,531,0,6200,6200,2200,4000,0,0,0,0,0,0,0,0,0,551,96,48,12,15,4
2020,062900351,2246,746,746,746,0,1500,0,0,0,0,1500,1500,0,0,0,0,0,0,948,170,20,240,158,1
2020,070000312,4919,1919,1919,1919,0,3000,3000,3000,0,0,0,0,0,0,0,0,0,0,596,168,60,10,48,3
2020,070000322,13430,3030,3030,3030,0,10400,10000,10000,0,0,400,400,0,0,0,0,0,0,1730,60,50,300,240,56
2020,070000332,27650,500,500,500,0,27150,27000,5000,22000,0,150,0,150,0,0,0,0,0,476,89,0,36,18,5
2020,070000342,13500,500,500,500,0,13000,13000,7000,6000,0,0,0,0,0,0,0,0,0,347,81,84,10,24,6
2020,070000362,15560,560,560,560,0,15000,15000,15000,0,0,0,0,0,0,0,0,0,0,3038,240,2180,70,48,8
2020,070000372,505,505,5,5,500,0,0,0,0,0,0,0,0,0,3925,3925,0,3925,1890,580,150,120,120,4
2020,070000382,25500,6000,6000,6000,0,19500,19500,15000,4500,0,0,0,0,0,0,0,0,0,1476,312,180,60,36,42
2020,070000392,18107,1137,1137,1137,0,16970,16000,16000,0,0,970,970,0,0,9600,9600,8600,1000,2008,336,100,600,72,76
2020,070600311,235074,19874,19874,19874,0,215200,213500,28000,185500,0,1700,1100,600,0,6000,0,0,0,3980,300,300,400,240,2476
2020,070600321,76202,8672,8672,8672,0,67530,67000,20000,47000,0,530,530,0,0,15000,0,0,0,5030,240,300,400,250,777
2020,070600341,11115,27,27,27,0,11088,11000,11000,0,0,88,0,88,0,0,0,0,0,1110,170,50,120,50,23
2020,070600371,5088,4788,4788,4788,0,300,0,0,0,0,300,300,0,0,0,0,0,0,1004,60,24,240,60,16
2020,070600381,10220,220,220,220,0,10000,10000,10000,0,0,0,0,0,0,0,0,0,0,402,96,36,24,36,5
2020,070600391,18200,200,200,200,0,18000,16800,16800,0,0,1200,1200,0,0,11200,11200,10600,0,2218,108,40,180,130,24
2020,070700321,2166,2118,118,118,2000,48,0,0,0,0,48,0,48,0,0,0,0,0,1011,228,50,50,21,1
2020,070700341,112700,5400,5400,5400,0,107300,107000,14000,93000,0,300,300,0,0,5150,5150,5000,0,4240,300,40,500,400,236
2020,070700371,5,5,5,5,0,0,0,0,0,0,0,0,0,0,400,400,0,400,483,120,10,12,36,1
2020,070700381,46180,25880,25880,25880,0,20300,16000,16000,0,0,4300,4300,0,0,5940,5940,1440,3000,3630,380,80,650,240,547
2020,070700391,25698,17248,17248,15248,0,8450,6000,6000,0,0,2450,150,1500,800,2000,2000,0,2000,1497,96,800,60,60,41
2020,070800311,8544,1844,1844,1844,0,6700,5500,5500,0,0,1200,1200,0,0,0,0,0,0,905,240,50,200,72,55
2020,070800321,20695,2595,2595,2595,0,18100,17500,17500,0,0,600,600,0,0,0,0,0,0,3570,240,100,120,120,7916
2020,070800331,14502,1902,1902,1902,0,12600,9000,9000,0,0,3600,2600,1000,0,12337,12337,7000,800,2786,300,100,400,16,108
2020,070800341,66586,19437,19437,19437,0,47149,44749,25000,19749,0,2400,2400,0,0,12640,12640,12640,0,5220,250,570,500,200,1268
2020,070800371,38770,8070,8070,8070,0,30700,29000,9000,20000,0,1700,1700,0,0,3000,3000,0,3000,6310,360,100,650,280,1221
2020,070900311,19632,2722,2722,2722,0,16910,16500,16500,0,0,410,180,230,0,0,0,0,0,1130,160,200,200,80,62
2020,070900321,7520,2220,2220,2220,0,5300,5000,5000,0,0,300,300,0,0,20,20,0,0,1813,100,84,180,96,28
2020,070900341,5660,5660,3660,3660,2000,0,0,0,0,0,0,0,0,0,0,0,0,0,1510,240,20,120,120,1
2020,070900351,50410,8110,8110,8110,0,42300,39000,30000,9000,0,3300,3300,0,0,20000,20000,20000,0,6940,240,600,900,500,1427
2020,070900361,19608,19608,19608,18608,0,0,0,0,0,0,0,0,0,0,40,40,0,0,3112,300,70,124,108,270
2020,070900381,74028,26058,26058,26058,0,47970,44000,0,44000,0,3970,1700,2270,0,0,0,0,0,3983,816,10,360,191,89
2020,071000302,759,759,759,759,0,0,0,0,0,0,0,0,0,0,0,0,0,0,1308,28,12,120,48,1
2020,071000312,17300,17300,12300,12000,5000,0,0,0,0,0,0,0,0,0,0,0,0,0,2520,360,100,300,60,337
2020,071000332,7160,5560,5060,5060,500,1600,0,0,0,0,1600,1600,0,0,0,0,0,0,1352,360,36,120,60,149
2020,071000362,3700,1200,1200,1200,0,2500,2500,2500,0,0,0,0,0,0,0,0,0,0,682,123,66,24,19,3
2020,071000372,21150,4000,4000,4000,0,17150,14500,14500,0,0,2650,2650,0,0,800,800,0,0,5500,260,300,500,140,396
2020,071000382,14110,110,110,110,0,14000,10000,10000,0,0,4000,4000,0,0,2000,2000,0,2000,4348,300,100,260,216,39
2020,071600311,15800,5600,5600,5600,0,10200,8000,8000,0,0,2200,2200,0,0,2890,2890,2890,0,1402,216,10,300,96,79
2020,071600321,10500,100,100,100,0,10400,10000,10000,0,0,400,0,400,0,0,0,0,0,940,200,70,30,30,11
2020,071600331,317650,47500,47500,39500,0,270150,260500,25500,235000,0,9650,3650,5000,1000,166000,140000,140000,0,7850,600,150,1450,300,3950
2020,071600341,1254,1104,1004,1004,100,150,0,0,0,0,150,150,0,0,770,770,0,0,1686,338,20,450,120,25
2020,071600351,15291,15071,8571,8571,6500,220,0,0,0,0,220,140,80,0,0,0,0,0,3730,600,30,200,240,26
2020,071600361,51924,13984,13984,13984,0,37940,33000,23000,10000,0,4940,3440,1500,0,500,500,0,0,2650,240,20,100,180,106
2020,071600371,24058,22058,10058,10058,12000,2000,0,0,0,0,2000,2000,0,0,400,400,0,400,4020,200,100,340,20,628
2020,071600391,10034,3434,3434,3434,0,6600,6000,6000,0,0,600,600,0,0,0,0,0,0,2265,300,50,600,170,25
2020,071700301,13050,1050,1050,1050,0,12000,12000,12000,0,0,0,0,0,0,0,0,0,0,970,150,120,120,40,300
2020,071700311,16270,2820,2820,2820,0,13450,13000,13000,0,0,450,450,0,0,8000,8000,3500,4500,3250,350,250,600,300,351
2020,071700321,35890,11890,11890,9890,0,24000,22500,18000,4500,0,1500,900,600,0,5100,4900,4700,200,4065,425,800,400,290,1034
2020,071700331,150452,37702,18202,18202,19500,112750,111000,0,111000,0,1750,1750,0,0,80130,38130,38000,0,2980,280,100,250,250,913
2020,071700341,12930,2330,2330,2330,0,10600,8500,5000,3500,0,2100,100,2000,0,0,0,0,0,1948,276,1050,120,72,44
2020,071700371,5708,123,123,123,0,5585,5500,5500,0,0,85,0,85,0,0,0,0,0,916,127,93,16,22,7
2020,071700381,16450,7400,7400,7400,0,9050,7500,4000,3500,0,1550,450,1100,0,2068,2068,1700,368,3675,2300,50,100,50,46
2020,071700391,100,100,100,100,0,0,0,0,0,0,0,0,0,0,0,0,0,0,415,80,30,15,15,2
2020,071800311,3936,936,936,936,0,3000,3000,3000,0,0,0,0,0,0,0,0,0,0,1047,76,320,13,24,4
2020,071800341,26150,100,100,100,0,26050,25000,25000,0,0,1050,50,1000,0,200,200,0,200,858,100,200,60,48,99
2020,071800351,37196,11636,11636,11636,0,25560,9000,6000,3000,0,16560,150,16410,0,6500,6500,3200,3000,1453,333,200,120,120,36
2020,071800391,3390,3390,1590,1590,1800,0,0,0,0,0,0,0,0,0,3616,3616,1200,2416,982,282,100,150,130,20
2020,071900301,147840,33440,33440,33440,0,114400,87000,32000,55000,0,27400,15400,12000,0,0,0,0,0,8900,800,150,1000,350,4659
2020,071900311,48160,8960,8960,8960,0,39200,35000,35000,0,0,4200,3000,1200,0,19180,19180,19000,0,5540,480,500,600,360,5821
2020,071900321,123800,11800,11600,6600,200,112000,40000,0,40000,0,72000,2000,60000,10000,5000,5000,5000,0,4820,1200,500,400,120,241
2020,071900341,2860,2860,360,330,2500,0,0,0,0,0,0,0,0,0,0,0,0,0,2110,500,0,54,154,1
2020,071900351,24001,11624,11624,11624,0,12377,11000,11000,0,0,1377,1377,0,0,0,0,0,0,1740,200,80,150,100,180
2020,071900361,20980,480,480,480,0,20500,19000,19000,0,0,1500,950,550,0,4000,4000,0,4000,2360,132,360,360,276,110
2020,071900371,8040,1000,1000,1000,0,7040,7000,7000,0,0,40,0,40,0,0,0,0,0,597,210,95,50,47,17
2020,071900381,5700,1200,1200,1200,0,4500,4500,0,4500,0,0,0,0,0,500,0,0,0,717,272,48,12,80,36
2020,071900391,1420,1244,1244,1244,0,176,0,0,0,0,176,0,176,0,0,0,0,0,2655,240,65,500,200,1
2020,072000302,9000,400,400,400,0,8600,8000,5000,3000,0,600,600,0,0,0,0,0,0,990,150,120,150,120,22
2020,072000322,56360,26834,26834,26834,0,29526,28000,28000,0,0,1526,1300,226,0,0,0,0,0,7195,319,320,360,336,996
2020,072000332,7300,500,500,500,0,6800,6000,6000,0,0,800,800,0,0,3480,3480,1763,0,1424,150,103,300,61,34
2020,072000352,3400,100,100,100,0,3300,2500,2500,0,0,800,0,800,0,0,0,0,0,595,100,10,30,15,1
2020,072000362,54780,10500,10500,10500,0,44280,44000,7000,37000,0,280,100,180,0,15000,0,0,0,1407,182,180,90,80,33
2020,072000372,21876,14350,14350,14350,0,7526,6900,6900,0,0,626,400,226,0,0,0,0,0,2880,120,1200,120,60,26
2020,072000382,41130,18630,18630,18630,0,22500,22000,7000,15000,0,500,500,0,0,0,0,0,0,1510,236,360,360,164,189
2020,072600321,32805,11905,11905,11905,0,20900,20000,17000,0,3000,900,900,0,0,0,0,0,0,3442,300,50,240,324,346
2020,072600331,18066,17156,7156,7156,10000,910,0,0,0,0,910,800,110,0,2900,2900,0,2900,2655,240,20,390,180,304
2020,072600351,37534,4584,4584,4584,0,32950,26000,8000,18000,0,6950,1100,5850,0,6150,6150,0,6150,2770,300,20,500,250,17
2020,072600361,10696,1570,1570,1570,0,9126,8800,7000,1800,0,326,50,276,0,0,0,0,0,772,148,96,36,48,13
2020,072600371,65,65,65,65,0,0,0,0,0,0,0,0,0,0,0,0,0,0,460,62,60,12,36,1
2020,072700301,6100,50,50,50,0,6050,6000,6000,0,0,50,0,50,0,0,0,0,0,595,180,50,10,30,4
2020,072700331,3130,30,30,30,0,3100,3000,0,3000,0,100,0,100,0,0,0,0,0,401,70,120,40,36,7
2020,072700341,62100,10800,10800,10800,0,51300,30000,10000,20000,0,21300,1300,20000,0,800,800,800,0,1568,120,100,150,108,169
2020,072700351,41839,8039,8039,8039,0,33800,30000,20000,10000,0,3800,1500,2300,0,0,0,0,0,1620,120,120,120,60,86
2020,072700361,28,28,28,28,0,0,0,0,0,0,0,0,0,0,0,0,0,0,575,260,80,30,0,33
2020,072700371,1210,1210,1210,1210,0,0,0,0,0,0,0,0,0,0,0,0,0,0,644,140,170,40,24,1
2020,072800331,10144,3114,3114,3114,0,7030,7030,5530,1500,0,0,0,0,0,0,0,0,0,1068,128,220,120,96,7
2020,072800351,6150,100,100,100,0,6050,6000,6000,0,0,50,0,50,0,2124,2124,2124,0,1160,200,25,110,185,32
2020,072800361,17825,6575,6575,6500,0,11250,10700,6200,4500,0,550,200,350,0,5000,5000,5000,0,4360,360,450,440,198,397
2020,072800371,20078,2678,2678,2678,0,17400,8000,8000,0,0,9400,1900,7500,0,1000,1000,1000,0,1241,125,100,240,96,30
2020,072900311,24234,6184,6184,6184,0,18050,18000,18000,0,0,50,0,50,0,0,0,0,0,1248,312,120,60,36,96
2020,072900321,4800,3900,3600,3500,300,900,0,0,0,0,900,800,100,0,1520,1520,1520,0,3460,1300,50,120,180,31
2020,072900341,13194,4688,4688,4688,0,8506,8000,8000,0,0,506,280,226,0,0,0,0,0,1344,240,250,144,120,43
2020,072900361,5890,600,600,600,0,5290,5000,5000,0,0,290,0,290,0,0,0,0,0,806,150,70,85,55,8
2020,080000312,10205,3205,3205,3205,0,7000,7000,7000,0,0,0,0,0,0,0,0,0,0,887,130,11,108,48,21
2020,080000322,42205,7825,7825,3825,0,34380,31100,18400,12700,0,3280,1080,2200,0,7025,3025,2000,1000,3546,282,133,300,336,76
2020,080000342,11244,1194,1194,1194,0,10050,10000,10000,0,0,50,0,50,0,500,0,0,0,725,120,60,10,50,16
2020,080000362,86539,21044,21044,21044,0,65495,62760,18500,44260,0,2735,2390,345,0,6260,260,0,0,1864,168,24,408,120,350
2020,080000372,74650,5950,5950,5950,0,68700,60000,20000,40000,0,8700,700,8000,0,20150,20150,20000,0,2870,130,130,1200,150,96
2020,080000382,21500,2300,2300,2300,0,19200,19000,19000,0,0,200,0,200,0,0,0,0,0,1505,173,240,36,96,55
2020,080000392,68795,7580,7580,7580,0,61215,61000,22000,39000,0,215,215,0,0,4334,1334,1334,0,4524,420,800,420,192,174
2020,080600331,17670,4920,4920,4920,0,12750,12000,12000,0,0,750,750,0,0,0,0,0,0,1280,144,100,240,48,86
2020,080600341,1860,1560,960,360,600,300,0,0,0,0,300,300,0,0,2926,2926,0,2448,2900,357,390,360,353,42
2020,080600351,20038,38,38,38,0,20000,20000,20000,0,0,0,0,0,0,0,0,0,0,245,120,36,3,16,11
2020,080600371,30623,12040,12040,12040,0,18583,18000,18000,0,0,583,500,83,0,11050,11050,10850,0,4150,336,312,240,288,57
2020,080600391,6195,195,195,195,0,6000,6000,6000,0,0,0,0,0,0,0,0,0,0,615,89,200,12,29,3
2020,080700321,10987,987,987,987,0,10000,10000,10000,0,0,0,0,0,0,1000,0,0,0,1383,170,203,80,55,37
2020,080700331,46990,8390,8390,8390,0,38600,38000,19000,19000,0,600,600,0,0,1000,0,0,0,5135,660,1330,600,180,682
2020,080700341,8807,8807,5807,5807,3000,0,0,0,0,0,0,0,0,0,0,0,0,0,1473,261,60,190,148,1
2020,080700351,17399,5399,5399,4399,0,12000,10500,10500,0,0,1500,500,0,1000,7800,7800,6500,1000,3098,300,240,120,260,36
2020,080700361,130,130,130,130,0,0,0,0,0,0,0,0,0,0,0,0,0,0,850,100,40,30,70,1
2020,080700371,42020,20120,20120,18120,0,21900,15000,15000,0,0,6900,2900,2000,2000,100,100,0,0,4300,360,50,240,300,152
2020,080800311,400,100,100,100,0,300,0,0,0,0,300,300,0,0,0,0,0,0,1188,65,10,206,120,40
2020,080800321,3345,2045,2045,2045,0,1300,0,0,0,0,1300,1300,0,0,158,158,0,0,1517,149,310,200,134,1
2020,080800331,10584,2020,2020,2020,0,8564,8500,8500,0,0,64,0,64,0,3560,2560,2500,0,2094,1108,60,36,48,81
2020,080800341,11503,2342,2342,2342,0,9161,9000,9000,0,0,161,0,161,0,5610,5610,3500,2060,3709,800,418,230,311,62
2020,080800351,22658,5108,5108,4808,0,17550,17000,17000,0,0,550,550,0,0,7000,6000,3000,3000,4192,1131,356,460,234,65
2020,080800361,30228,7028,7028,7028,0,23200,19000,19000,0,0,4200,3900,300,0,0,0,0,0,3134,258,30,453,183,187
2020,080900311,11904,1904,1904,1904,0,10000,10000,10000,0,0,0,0,0,0,0,0,0,0,1790,180,120,60,120,36
2020,080900331,2494,2470,1470,1470,1000,24,0,0,0,0,24,0,24,0,1200,1200,0,0,2773,628,1020,80,234,1
2020,080900341,51114,9964,9964,9964,0,41150,41000,5500,35500,0,150,150,0,0,5000,0,0,0,1818,133,30,392,93,68
2020,080900351,3297,2297,2297,2297,0,1000,1000,1000,0,0,0,0,0,0,3000,3000,0,3000,1073,72,250,144,48,10
2020,080900371,139201,9551,9551,2051,0,129650,108300,26300,82000,0,21350,700,20650,0,48000,48000,47000,1000,4390,680,50,700,240,619
2020,080900381,8070,70,70,70,0,8000,8000,8000,0,0,0,0,0,0,0,0,0,0,692,180,10,10,132,8
2020,080900391,21484,8064,8064,8064,0,13420,13000,13000,0,0,420,300,120,0,4048,4048,4048,0,1362,192,50,240,60,123
2020,081000372,20,20,20,20,0,0,0,0,0,0,0,0,0,0,0,0,0,0,800,190,200,10,10,1
2020,081000382,7120,320,320,320,0,6800,6800,6800,0,0,0,0,0,0,70,70,0,0,900,153,30,50,30,20
2020,081000392,38349,16776,16776,14776,0,21573,20800,12800,8000,0,773,660,113,0,0,0,0,0,4368,240,60,700,180,1175
2020,081600301,63459,4859,4859,4859,0,58600,58000,16000,42000,0,600,600,0,0,17700,13700,13700,0,1680,300,80,180,130,126
2020,081600311,48362,12012,12012,12012,0,36350,36000,14000,22000,0,350,350,0,0,1000,0,0,0,4682,297,300,315,290,1208
2020,081600321,39564,16514,16514,15514,0,23050,22000,0,22000,0,1050,300,250,500,20506,19506,16990,0,3836,240,1000,150,246,74
2020,081600331,19300,300,300,300,0,19000,19000,19000,0,0,0,0,0,0,6930,6930,6930,0,1302,200,100,50,72,25
2020,081600351,107730,25900,25900,25900,0,81830,80000,30000,50000,0,1830,1830,0,0,16000,10000,5000,5000,2170,380,20,360,140,989
2020,081600361,7992,2202,2202,2202,0,5790,4900,4900,0,0,890,890,0,0,0,0,0,0,1746,156,60,300,70,143
2020,081600381,52140,2314,2314,2314,0,49826,48700,32000,16700,0,1126,900,226,0,0,0,0,0,2447,208,30,336,320,88
2020,081700321,18156,4456,4456,2456,0,13700,11000,11000,0,0,2700,700,2000,0,4250,4250,4250,0,3334,138,100,576,156,18
2020,081700331,44171,6938,6938,6938,0,37233,35000,35000,0,0,2233,1900,333,0,21470,21470,15000,3000,1781,450,25,360,228,82
2020,081700341,8228,180,180,180,0,8048,8000,8000,0,0,48,0,48,0,3300,3200,3000,200,873,152,63,36,31,11
2020,081700351,37715,18902,18902,18902,0,18813,18000,18000,0,0,813,700,113,0,21875,21875,13850,8000,4138,222,150,400,180,353
2020,081700371,137220,120,120,120,0,137100,135000,19000,116000,0,2100,2100,0,0,70000,68000,58000,10000,2838,296,200,510,192,1021
2020,081700381,7244,964,964,964,0,6280,6200,6200,0,0,80,0,80,0,0,0,0,0,1016,180,80,20,50,8
2020,081800301,37499,8499,8499,6499,0,29000,28000,23000,5000,0,1000,1000,0,0,6520,6520,6520,0,4514,980,120,50,144,363
2020,081800311,51600,3700,3700,3700,0,47900,44700,34700,10000,0,3200,3200,0,0,8000,8000,8000,0,1656,326,10,300,150,144
2020,081800351,200,200,200,200,0,0,0,0,0,0,0,0,0,0,0,0,0,0,1100,240,40,0,10,1
2020,081800361,34708,7708,7708,7708,0,27000,26500,9500,17000,0,500,0,500,0,0,0,0,0,1680,204,100,60,60,23
2020,081800371,19520,1420,1420,1420,0,18100,18000,0,18000,0,100,0,100,0,0,0,0,0,876,264,70,15,44,23
2020,081900301,43502,3352,3352,3352,0,40150,38000,13000,25000,0,2150,2000,150,0,29420,27420,27270,0,3210,250,800,180,120,376
2020,081900351,29790,4690,4690,4690,0,25100,25100,23000,2100,0,0,0,0,0,9250,9250,9200,0,7734,490,1200,150,254,1353
2020,081900361,48910,11410,11410,11410,0,37500,36000,24000,12000,0,1500,1300,200,0,15940,13940,13940,0,4606,276,150,70,340,88
2020,081900371,114090,15720,12720,9720,3000,98370,95000,0,95000,0,3370,1370,0,2000,36000,34500,32500,2000,3120,660,200,600,300,184
2020,081900381,24226,9893,9893,9393,0,14333,13500,13500,0,0,833,720,113,0,4700,4700,4600,0,4223,186,60,305,230,76
2020,081900391,73123,7093,7093,7093,0,66030,65000,50000,15000,0,1030,1030,0,0,5200,0,0,0,2877,228,45,360,264,108
2020,082000302,41825,3025,3025,3025,0,38800,38800,38000,800,0,0,0,0,0,10000,0,0,0,884,120,12,120,72,46
2020,082000312,13881,4145,4145,3645,0,9736,7000,7000,0,0,2736,2700,36,0,4400,4400,2000,0,4570,320,160,480,360,2883
2020,082000322,110,110,110,110,0,0,0,0,0,0,0,0,0,0,0,0,0,0,612,84,180,12,36,1
2020,082000332,94926,44200,44200,44200,0,50726,47500,11500,36000,0,3226,3000,226,0,0,0,0,0,3304,156,48,360,300,200
2020,082000342,67400,26000,26000,26000,0,41400,38000,38000,0,0,3400,3400,0,0,0,0,0,0,5846,456,100,600,240,7433
2020,082000352,11798,3398,3398,3398,0,8400,8400,7000,1400,0,0,0,0,0,1000,0,0,0,1295,225,36,24,48,34
2020,082000362,2884,2884,2684,2684,200,0,0,0,0,0,0,0,0,0,1320,1320,1320,0,1119,384,10,60,48,1
2020,082000372,39391,11048,11048,11048,0,28343,27600,11000,16600,0,743,517,226,0,2514,2514,0,2514,4370,294,536,166,262,2234
2020,082000382,2100,2100,100,100,2000,0,0,0,0,0,0,0,0,0,0,0,0,0,1812,520,153,10,49,2
2020,082000392,13,13,13,13,0,0,0,0,0,0,0,0,0,0,0,0,0,0,518,148,50,36,24,1
2020,082600301,42002,5396,5396,5396,0,36606,36306,10000,26306,0,300,300,0,0,0,0,0,0,1537,82,400,84,96,101
2020,082600321,50775,23547,23547,18547,0,27228,21000,21000,0,0,6228,5170,1058,0,8978,8978,8928,0,3532,312,30,360,180,149
2020,082600351,8143,2723,2723,2723,0,5420,5000,5000,0,0,420,420,0,0,0,0,0,0,1094,84,18,148,144,48
2020,082600361,8012,12,12,12,0,8000,8000,8000,0,0,0,0,0,0,0,0,0,0,1179,102,221,55,192,10
2020,082600371,38341,9346,9346,9346,0,28995,26050,11500,14550,0,2945,2900,45,0,0,0,0,0,4470,198,209,500,198,880
2020,082600381,5550,50,50,50,0,5500,5500,5500,0,0,0,0,0,0,0,0,0,0,473,84,48,18,41,5
2020,082600391,23233,2752,2752,2752,0,20481,18800,18800,0,0,1681,1342,339,0,8574,8574,7654,0,2505,204,260,320,160,53
2020,082700301,34106,15456,15456,10956,0,18650,11000,11000,0,0,7650,5650,0,2000,10700,10700,10500,200,4682,1110,300,600,360,453
2020,082700311,160376,2026,2026,2026,0,158350,151000,12000,139000,0,7350,2350,5000,0,70000,70000,70000,0,4796,1196,700,280,240,217
2020,082700341,5668,5300,3800,3800,1500,368,0,0,0,0,368,100,268,0,1880,1880,0,300,2949,528,850,396,180,32
2020,082700351,16938,5688,5688,5688,0,11250,11000,11000,0,0,250,200,50,0,0,0,0,0,1890,208,180,120,252,407
2020,082700361,10080,10080,2080,2080,8000,0,0,0,0,0,0,0,0,0,0,0,0,0,1052,96,260,36,36,1
2020,082700371,4200,4200,200,200,4000,0,0,0,0,0,0,0,0,0,0,0,0,0,752,216,84,80,24,2
2020,082800311,14628,5928,5928,5928,0,8700,8600,8600,0,0,100,100,0,0,6740,6740,6700,0,1770,200,10,120,150,29
2020,082800321,27110,7510,7510,7510,0,19600,19000,0,19000,0,600,600,0,0,4530,4530,4000,500,3500,240,120,1200,240,65
2020,082800331,100365,7796,7796,7796,0,92569,85000,45000,40000,0,7569,6900,669,0,40820,21820,0,11820,3998,264,45,400,156,1988
2020,082800361,8702,1452,1452,1452,0,7250,4000,4000,0,0,3250,3250,0,0,2000,2000,2000,0,1586,116,72,240,84,80
2020,082800371,6600,100,100,100,0,6500,6500,6500,0,0,0,0,0,0,0,0,0,0,557,120,91,20,20,4
2020,082800381,5050,50,50,50,0,5000,5000,5000,0,0,0,0,0,0,1000,1000,0,0,1422,190,236,50,60,8
2020,082800391,13300,300,300,300,0,13000,13000,1000,12000,0,0,0,0,0,7000,7000,7000,0,529,51,200,20,15,3
2020,082900311,2700,2700,200,200,2500,0,0,0,0,0,0,0,0,0,0,0,0,0,533,138,20,20,15,1
2020,082900321,40095,4310,4310,4310,0,35785,32000,32000,0,0,3785,3785,0,0,2300,2300,2300,0,3480,260,30,500,200,176
2020,082900331,52770,4470,4470,4470,0,48300,47500,23500,24000,0,800,800,0,0,18000,5000,5000,0,4250,360,100,340,360,150
2020,082900341,1030,30,30,30,0,1000,1000,1000,0,0,0,0,0,0,0,0,0,0,596,96,24,10,6,3
2020,082900351,1050,1050,50,50,1000,0,0,0,0,0,0,0,0,0,500,500,0,0,1686,636,10,60,40,1
2020,082900361,1075,1075,1075,1075,0,0,0,0,0,0,0,0,0,0,0,0,0,0,476,61,120,42,31,1
2020,082900371,8060,1940,1940,1940,0,6120,5500,5500,0,0,620,300,320,0,970,970,970,0,840,60,120,120,60,56
2020,082900381,6900,6900,6900,6900,0,0,0,0,0,0,0,0,0,0,0,0,0,0,1475,120,600,20,15,1
2020,082900391,18400,2700,2700,2700,0,15700,7500,7500,0,0,8200,1200,7000,0,6155,6155,5000,0,1337,108,146,360,147,15
2020,083000302,76390,1390,1390,1390,0,75000,75000,10000,65000,0,0,0,0,0,0,0,0,0,1409,200,250,120,36,51
2020,083000312,110,110,110,110,0,0,0,0,0,0,0,0,0,0,0,0,0,0,1430,120,30,30,72,1
2020,083000322,12230,730,730,730,0,11500,9500,4000,5500,0,2000,2000,0,0,1200,1200,0,1200,1761,216,300,240,100,28
2020,083600301,6318,318,318,318,0,6000,6000,6000,0,0,0,0,0,0,0,0,0,0,816,110,215,80,36,5
2020,083600311,64598,3398,3398,3398,0,61200,61000,10000,51000,0,200,0,200,0,0,0,0,0,2180,70,920,70,30,15
2020,083700301,36530,4580,4580,4580,0,31950,28500,20000,8500,0,3450,600,2850,0,7000,7000,4000,3000,2120,320,720,120,120,34
2020,083700311,400,400,400,400,0,0,0,0,0,0,0,0,0,0,0,0,0,0,581,80,120,36,15,1
2020,083800301,11797,597,597,597,0,11200,10000,10000,0,0,1200,1200,0,0,2280,2280,0,0,1906,136,10,200,75,13
2020,083800311,12664,3519,3519,3519,0,9145,9100,7000,2100,0,45,0,45,0,0,0,0,0,608,120,100,35,33,4
2020,083900301,42854,7004,7004,7004,0,35850,11500,5000,6500,0,24350,2350,22000,0,5500,5500,4000,0,3736,360,400,720,336,70
2020,083900311,11320,820,820,820,0,10500,10500,7500,3000,0,0,0,0,0,0,0,0,0,608,104,250,10,24,6
2020,090000212,25088,3388,3388,3388,0,21700,20500,20500,0,0,1200,1200,0,0,0,0,0,0,2611,347,87,300,190,190
2020,090000232,14430,2270,2270,1770,0,12160,8500,8500,0,0,3660,160,3000,500,1500,1500,0,0,2647,720,360,93,180,35
2020,090000262,5232,1232,1232,1232,0,4000,4000,4000,0,0,0,0,0,0,350,350,0,350,952,60,50,280,72,16
2020,090000272,3640,1340,40,40,1300,2300,0,0,0,0,2300,2000,300,0,11000,11000,0,10000,2385,480,500,600,180,351
2020,090000282,24538,7788,5288,5288,2500,16750,15000,0,15000,0,1750,1550,200,0,7120,7120,7000,120,2920,700,50,240,130,194
2020,090000292,67636,16436,4331,4331,12105,51200,50000,0,50000,0,1200,1200,0,0,250,250,0,0,2922,72,25,450,45,350
2020,090000312,13600,3600,3600,3600,0,10000,10000,10000,0,0,0,0,0,0,0,0,0,0,586,40,60,0,36,4
2020,090000322,21632,432,432,432,0,21200,20000,20000,0,0,1200,1200,0,0,1800,1800,0,1500,4106,240,1000,144,276,27
2020,090000332,260,260,260,260,0,0,0,0,0,0,0,0,0,0,1700,1700,0,0,2494,726,12,10,120,1
2020,090000342,20850,16550,6550,5550,10000,4300,0,0,0,0,4300,2800,500,1000,0,0,0,0,2900,96,12,120,240,51
2020,090000352,17853,16053,2053,2053,14000,1800,0,0,0,0,1800,1800,0,0,10800,10800,10800,0,1884,180,70,160,144,43
2020,090000392,39198,10198,10198,3198,0,29000,20000,20000,0,0,9000,2000,0,7000,12500,12500,9000,2000,6919,160,180,240,288,73
2020,090600241,48925,6849,6849,6849,0,42076,35000,15000,20000,0,7076,1800,5276,0,4200,4200,800,2200,3385,336,600,1170,89,32
2020,090600311,1150,1150,50,50,1100,0,0,0,0,0,0,0,0,0,0,0,0,0,720,180,30,60,30,3
2020,090600321,45150,26000,26000,26000,0,19150,15000,15000,0,0,4150,4000,150,0,100,100,0,0,908,100,30,120,24,35
2020,090600351,6528,6028,3028,3028,3000,500,0,0,0,0,500,500,0,0,1960,1960,0,1900,2810,360,180,240,240,33
2020,090600371,30550,400,400,400,0,30150,30000,30000,0,0,150,150,0,0,19400,19400,19400,0,2810,240,30,360,360,62
2020,090700211,64741,9641,9641,9641,0,55100,54000,30000,24000,0,1100,1100,0,0,600,600,600,0,1801,300,12,240,84,87
2020,090700221,212418,28018,5018,5018,23000,184400,183500,0,183500,0,900,900,0,0,59000,5000,0,5000,5275,880,100,710,115,464
2020,090700241,21780,19480,4480,4480,15000,2300,0,0,0,0,2300,2300,0,0,5100,5100,5000,0,3238,219,70,209,204,88
2020,090700311,7824,6824,6824,6824,0,1000,0,0,0,0,1000,1000,0,0,3000,3000,0,3000,2940,500,360,260,170,115
2020,090700341,25360,200,200,200,0,25160,25000,25000,0,0,160,160,0,0,50,0,0,0,1850,204,240,360,96,37
2020,090700381,28072,7572,7572,7572,0,20500,20000,20000,0,0,500,500,0,0,0,0,0,0,2746,502,48,60,204,234
2020,090700391,4636,1836,1336,1336,500,2800,0,0,0,0,2800,2800,0,0,2805,2805,1000,0,3110,780,50,250,200,121
2020,090800231,12600,100,100,100,0,12500,12500,12500,0,0,0,0,0,0,0,0,0,0,942,240,12,30,80,52
2020,090800251,71130,2580,2580,2580,0,68550,62000,12000,50000,0,6550,5450,1100,0,19000,19000,14000,0,1890,180,10,150,120,1018
2020,090800281,201,201,1,1,200,0,0,0,0,0,0,0,0,0,0,0,0,0,769,338,30,20,30,0
2020,090800321,96500,500,500,500,0,96000,96000,6000,90000,0,0,0,0,0,200,0,0,0,480,55,12,12,24,16
2020,090800331,401,401,401,401,0,0,0,0,0,0,0,0,0,0,0,0,0,0,746,120,10,20,36,1
2020,090800341,71620,13620,13620,13620,0,58000,54000,20000,34000,0,4000,4000,0,0,910,910,0,910,4794,264,620,720,300,229
2020,090800351,17190,2090,2090,2090,0,15100,15000,15000,0,0,100,100,0,0,0,0,0,0,1156,120,50,24,36,19
2020,090800361,497683,74505,74505,62505,0,423178,420000,20000,400000,0,3178,2500,678,0,100,0,0,0,4528,660,100,720,240,695
2020,090800371,27705,6195,6095,6095,100,21510,0,0,0,0,21510,10,20000,1500,1500,1500,0,1500,4510,566,1000,600,168,32
2020,090800391,1584,1584,1384,1384,200,0,0,0,0,0,0,0,0,0,0,0,0,0,1290,660,10,20,240,76
2020,090900211,61110,16300,16300,16300,0,44810,42000,17000,25000,0,2810,2810,0,0,1734,1734,0,1734,6840,240,700,300,300,792
2020,090900221,4219,219,219,219,0,4000,4000,4000,0,0,0,0,0,0,0,0,0,0,302,120,12,12,24,14
2020,090900241,610700,5900,5900,5900,0,604800,565000,65000,500000,0,39800,1200,38600,0,70000,70000,50000,20000,3670,600,300,200,70,419
2020,090900251,30000,500,500,500,0,29500,29500,5500,24000,0,0,0,0,0,0,0,0,0,584,60,120,24,60,8
2020,090900261,13900,5900,5900,5900,0,8000,5000,5000,0,0,3000,3000,0,0,0,0,0,0,2610,50,80,200,200,512
2020,090900281,51166,4466,4466,4466,0,46700,44000,38000,6000,0,2700,2700,0,0,4600,4600,2600,0,3150,300,200,400,150,230
2020,090900311,2100,2100,2100,2100,0,0,0,0,0,0,0,0,0,0,0,0,0,0,497,50,30,0,18,2
2020,090900321,45000,7000,7000,7000,0,38000,36000,36000,0,0,2000,2000,0,0,1011,11,0,0,2710,910,60,60,72,78
2020,090900341,2150,350,300,300,50,1800,0,0,0,0,1800,1800,0,0,2200,2200,0,0,1775,286,5,240,120,4
2020,090900351,25230,14730,14730,14730,0,10500,10000,10000,0,0,500,500,0,0,0,0,0,0,1396,160,100,82,84,31
2020,090900361,1900,1000,1000,1000,0,900,0,0,0,0,900,900,0,0,1000,1000,1000,0,2140,550,350,200,280,23
2020,090900371,26470,11770,9970,9970,1800,14700,0,0,0,0,14700,2700,12000,0,3000,3000,0,3000,3334,372,60,480,192,321
2020,090900391,12250,4550,4350,4350,200,7700,6000,0,6000,0,1700,1700,0,0,1500,1500,1500,0,1270,120,100,200,120,155
2020,091000212,141870,30120,30120,30120,0,111750,110000,60000,50000,0,1750,1750,0,0,15000,0,0,0,6952,1000,180,276,136,1309
2020,091000222,71951,24217,24217,24217,0,47734,45000,45000,0,0,2734,2734,0,0,12546,12546,12000,500,4899,400,1900,300,200,191
2020,091000302,137428,828,828,828,0,136600,135000,35000,100000,0,1600,1400,200,0,3000,3000,2000,1000,3346,84,120,360,216,56
2020,091000312,29680,2680,2680,2680,0,27000,27000,27000,0,0,0,0,0,0,1400,1400,0,0,1455,65,200,60,164,15
2020,091000332,857,857,5,5,852,0,0,0,0,0,0,0,0,0,0,0,0,0,299,91,20,15,24,0
2020,091000342,42940,40140,240,240,39900,2800,0,0,0,0,2800,2800,0,0,30000,30000,30000,0,4570,240,240,240,600,280
2020,091000352,73120,31320,22320,22320,9000,41800,40000,0,40000,0,1800,1800,0,0,30000,0,0,0,4625,325,100,180,240,405
2020,091600311,23817,6162,6162,6162,0,17655,15000,0,15000,0,2655,500,2155,0,0,0,0,0,786,142,120,60,72,61
2020,091600321,21688,14188,14188,14188,0,7500,0,0,0,0,7500,500,7000,0,0,0,0,0,1704,108,100,360,168,109
2020,091600341,575770,304120,304120,304120,0,271650,242000,28000,214000,0,29650,4150,25500,0,10000,10000,10000,0,7775,360,15,500,500,1203
2020,091700301,43280,2200,2200,2200,0,41080,41000,0,41000,0,80,0,80,0,0,0,0,0,1062,180,360,24,36,26
2020,091700331,8580,80,80,80,0,8500,8500,8500,0,0,0,0,0,0,5924,5924,4324,1540,2074,94,240,150,300,15
2020,091700341,69730,3230,3230,3230,0,66500,66000,38000,28000,0,500,0,500,0,100,100,0,0,1654,200,360,36,48,36
2020,091800221,24336,7636,7636,7636,0,16700,15500,15500,0,0,1200,1200,0,0,0,0,0,0,2700,300,20,240,240,850
2020,091800231,24105,2200,2200,2200,0,21905,21000,21000,0,0,905,400,505,0,11405,11405,11405,0,1759,180,20,154,156,61
2020,091800241,43501,713,713,713,0,42788,42000,22000,20000,0,788,500,288,0,28330,28330,27430,900,1394,170,40,185,108,48
2020,091800301,4108,2508,2458,2458,50,1600,0,0,0,0,1600,1600,0,0,3400,3400,0,3000,3330,1000,60,240,180,73
2020,091800311,103580,18580,18580,17580,0,85000,82000,40000,42000,0,3000,3000,0,0,11612,11412,8262,3000,5010,720,50,400,240,1315
2020,091800331,21030,5030,5030,5030,0,16000,15000,15000,0,0,1000,1000,0,0,6088,6088,6000,0,3330,180,100,300,300,39
2020,091800351,3600,1100,1100,100,0,2500,0,0,0,0,2500,2500,0,0,100,100,0,0,1660,1000,10,120,80,61
2020,091900201,84500,14200,14200,14200,0,70300,67000,57000,0,10000,3300,3300,0,0,10000,10000,0,10000,2929,276,300,198,276,1391
2020,091900211,83660,15660,15660,15660,0,68000,65000,50000,15000,0,3000,3000,0,0,20000,10000,10000,0,3542,300,100,160,192,554
2020,091900231,3848,3398,2398,2398,1000,450,0,0,0,0,450,450,0,0,1640,1640,0,1540,3136,756,40,160,180,16
2020,091900331,27600,1450,1450,1450,0,26150,25000,10000,15000,0,1150,1050,100,0,1025,1025,860,0,2965,200,1200,385,180,28
2020,092800221,9561,61,61,61,0,9500,9500,9500,0,0,0,0,0,0,0,0,0,0,695,105,300,25,32,1
2020,092800281,103872,320,320,320,0,103552,102500,22500,80000,0,1052,600,452,0,38770,28770,27000,1700,2547,192,50,240,240,462
2020,093800201,1226,876,876,876,0,350,0,0,0,0,350,350,0,0,0,0,0,0,1770,180,10,580,60,17
2020,093800261,22820,21920,8920,8920,13000,900,0,0,0,0,900,900,0,0,0,0,0,0,3004,324,340,150,180,593
2020,093800281,33851,2351,351,351,2000,31500,31000,0,31000,0,500,500,0,0,15400,12400,12100,0,5880,960,150,300,360,115
2020,094800201,81452,21652,6652,652,15000,59800,53000,0,53000,0,6800,4800,0,2000,33974,28974,24574,3000,2348,240,300,360,168,102
2020,094800211,83020,7500,7500,7500,0,75520,74000,62000,12000,0,1520,1520,0,0,0,0,0,0,3050,300,240,600,144,173
2020,094800231,52958,8932,8932,8932,0,44026,41000,41000,0,0,3026,2800,226,0,8214,8214,5139,3075,2140,240,200,300,200,55
2020,094800241,19838,19578,578,578,19000,260,0,0,0,0,260,260,0,0,14000,14000,10000,0,1900,180,40,190,210,80
2020,095800201,70950,4950,4950,4950,0,66000,64000,40000,0,24000,2000,2000,0,0,3000,3000,0,3000,4380,300,100,240,240,706
2020,095800241,20185,19685,1685,1685,18000,500,0,0,0,0,500,500,0,0,14916,14916,14000,916,2450,264,30,250,420,117
2020,110000102,116750,16750,16750,16750,0,100000,96000,75000,21000,0,4000,4000,0,0,24700,24700,24000,0,5688,488,100,500,400,1603
2020,110000132,201076,5776,5776,5776,0,195300,192000,180000,12000,0,3300,3300,0,0,3100,100,0,0,7950,1100,430,650,220,1260
2020,110000142,4360,4140,140,140,4000,220,0,0,0,0,220,0,220,0,0,0,0,0,418,84,50,2,36,1
2020,110000152,23200,13200,5200,5200,8000,10000,10000,0,10000,0,0,0,0,0,8000,0,0,0,988,180,36,14,360,40
2020,110000172,251200,81200,81200,73200,0,170000,160000,140000,20000,0,10000,2000,8000,0,37000,37000,37000,0,3220,70,50,100,100,4297
2020,110000182,46040,3640,3640,3640,0,42400,39000,38000,1000,0,3400,3400,0,0,0,0,0,0,2106,240,72,224,120,102
2020,110000202,4573,4460,1460,1460,3000,113,0,0,0,0,113,0,113,0,0,0,0,0,936,420,60,12,54,1
2020,110000212,302,302,2,2,300,0,0,0,0,0,0,0,0,0,12,12,0,0,957,310,10,36,84,2
2020,110000222,89893,7253,7253,7253,0,82640,82000,22000,60000,0,640,590,50,0,42000,39500,35000,4000,5551,408,72,360,384,1848
2020,110000232,4017,3567,1567,1567,2000,450,0,0,0,0,450,450,0,0,70,70,0,0,4914,974,480,270,240,276
2020,110000242,36950,2368,2368,2368,0,34582,31500,31500,0,0,3082,3000,82,0,5300,5300,5300,0,5310,464,30,192,84,189
2020,110000252,16300,5300,5300,5300,0,11000,11000,11000,0,0,0,0,0,0,2000,0,0,0,1990,856,480,24,72,21
2020,110000262,56436,15936,15936,11936,0,40500,36000,36000,0,0,4500,1800,700,2000,9000,9000,9000,0,5844,400,340,220,216,135
2020,110000282,17680,16780,4780,4780,12000,900,0,0,0,0,900,900,0,0,100,100,0,100,5370,300,120,600,240,454
2020,110000292,84839,13808,13808,13808,0,71031,69800,29800,40000,0,1231,1000,231,0,2910,70,0,0,2980,300,50,250,180,642
2020,110000312,62753,12974,12974,12974,0,49779,49000,49000,0,0,779,779,0,0,0,0,0,0,1550,129,30,20,71,69
2020,110000322,6300,6300,800,800,5500,0,0,0,0,0,0,0,0,0,0,0,0,0,1146,180,30,96,120,3
2020,110000362,9120,9120,120,120,9000,0,0,0,0,0,0,0,0,0,0,0,0,0,1160,240,120,50,100,1
2020,110000382,2829,2829,2729,2729,100,0,0,0,0,0,0,0,0,0,0,0,0,0,935,340,90,30,54,1
2020,110000392,59784,12784,12784,10784,0,47000,42000,42000,0,0,5000,1100,900,3000,19250,19250,17000,2200,4230,240,60,120,180,90
2020,110600141,31820,1820,1820,1820,0,30000,30000,30000,0,0,0,0,0,0,0,0,0,0,1490,100,480,60,150,17
2020,110600151,20020,20,20,20,0,20000,20000,20000,0,0,0,0,0,0,3000,3000,3000,0,1375,90,15,110,60,16
2020,110600161,5450,5450,1450,1450,4000,0,0,0,0,0,0,0,0,0,0,0,0,0,1415,312,10,6,42,72
2020,110600171,150,150,50,50,100,0,0,0,0,0,0,0,0,0,0,0,0,0,880,600,1,4,20,1
2020,110600181,4192,4192,892,892,3300,0,0,0,0,0,0,0,0,0,96,96,30,66,680,100,50,50,120,11
2020,110600191,3830,3800,800,800,3000,30,0,0,0,0,30,0,30,0,0,0,0,0,882,172,80,180,48,2
2020,110600211,32470,10070,10070,10070,0,22400,20000,20000,0,0,2400,1000,1400,0,0,0,0,0,2258,240,120,400,168,41
2020,110600231,2530,2530,30,30,2500,0,0,0,0,0,0,0,0,0,0,0,0,0,566,72,40,60,24,1
2020,110600241,310,310,10,10,300,0,0,0,0,0,0,0,0,0,0,0,0,0,763,240,5,30,19,1
2020,110600251,28430,16150,6150,5150,10000,12280,10500,0,10500,0,1780,800,680,300,5600,5400,5000,400,4960,1100,60,540,280,429
2020,110600261,40429,13929,13929,13929,0,26500,26000,26000,0,0,500,500,0,0,0,0,0,0,4260,240,300,450,200,494
2020,110600281,26346,24716,4716,4716,20000,1630,0,0,0,0,1630,1500,130,0,12421,12421,11500,0,3750,180,190,280,140,125
2020,110600331,39760,38160,5160,2660,33000,1600,0,0,0,0,1600,1000,600,0,15000,15000,15000,0,3110,290,100,620,200,32
2020,110600361,57120,15000,15000,15000,0,42120,42000,42000,0,0,120,0,120,0,0,0,0,0,1995,240,1300,60,70,65
2020,110600371,15813,3413,3413,3413,0,12400,12000,12000,0,0,400,400,0,0,6551,6551,6186,0,2815,180,50,240,120,32
2020,110600381,300,300,300,300,0,0,0,0,0,0,0,0,0,0,0,0,0,0,1786,360,360,10,36,1
2020,110601101,100600,600,600,600,0,100000,100000,100000,0,0,0,0,0,0,6500,0,0,0,1547,240,500,10,72,163
2020,110601111,9200,9200,2000,2000,7200,0,0,0,0,0,0,0,0,0,2300,2300,2300,0,2660,360,500,180,240,82
2020,110700121,150520,11620,11620,11620,0,138900,135000,100000,0,35000,3900,3900,0,0,31200,31200,15600,15600,4142,398,204,720,144,1441
2020,110700131,23660,3660,3660,3660,0,20000,20000,20000,0,0,0,0,0,0,5300,5300,5200,0,1420,120,30,150,120,832
2020,110700151,23650,10650,150,150,10500,13000,13000,0,13000,0,0,0,0,0,1500,1000,1000,0,755,70,280,30,45,41
2020,110700211,72900,2600,2600,2600,0,70300,70000,50000,20000,0,300,0,300,0,20000,0,0,0,2768,660,20,120,120,66
2020,110700221,18583,3450,3450,3450,0,15133,14400,12000,2400,0,733,698,35,0,6290,6290,6280,0,2674,200,65,360,300,267
2020,110700231,18940,940,940,940,0,18000,18000,18000,0,0,0,0,0,0,4000,4000,0,4000,3636,216,800,336,144,88
2020,110700241,61785,3732,3732,3732,0,58053,58000,24000,34000,0,53,0,53,0,7000,5500,0,5500,3430,240,300,300,190,523
2020,110700251,15045,7800,7800,3800,0,7245,4000,4000,0,0,3245,0,245,3000,0,0,0,0,2282,192,20,90,180,28
2020,110700261,10700,4700,4700,4700,0,6000,6000,6000,0,0,0,0,0,0,0,0,0,0,1630,180,480,10,60,6
2020,110700271,58456,7676,7676,7676,0,50780,50500,50000,500,0,280,280,0,0,10000,0,0,0,5005,300,3000,150,140,603
2020,110700281,67730,20730,20730,20730,0,47000,45000,15000,30000,0,2000,2000,0,0,0,0,0,0,2320,120,300,360,120,75
2020,110700291,14010,510,510,510,0,13500,12000,12000,0,0,1500,1500,0,0,1000,1000,0,0,2132,300,500,120,120,20
2020,110700331,6730,6730,2030,2030,4700,0,0,0,0,0,0,0,0,0,3700,3700,2700,0,1158,378,150,108,60,5
2020,110700341,63842,11742,11742,11742,0,52100,52000,52000,0,0,100,0,100,0,22500,22500,17500,5000,6810,420,150,350,200,2278
2020,110700361,8320,8320,7820,7820,500,0,0,0,0,0,0,0,0,0,0,0,0,0,2197,576,10,240,120,34
2020,110701101,109910,8110,8110,8110,0,101800,100000,100000,0,0,1800,1800,0,0,42000,2000,2000,0,1484,173,60,51,192,296
2020,110800111,118732,7232,7232,7232,0,111500,110000,110000,0,0,1500,1500,0,0,0,0,0,0,6050,400,100,200,250,1204
2020,110800181,240490,9290,9290,9290,0,231200,230000,230000,0,0,1200,1200,0,0,0,0,0,0,2563,420,100,152,15,2166
2020,110800201,33520,3520,20,20,3500,30000,30000,0,30000,0,0,0,0,0,13450,9450,9450,0,1176,336,200,60,60,43
2020,110800221,18538,2538,2538,2538,0,16000,16000,16000,0,0,0,0,0,0,7490,1590,0,1500,2590,1660,30,90,110,23
2020,110800231,4255,2205,2105,2105,100,2050,2000,0,2000,0,50,0,50,0,0,0,0,0,1252,232,180,96,96,7
2020,110800241,21336,4254,4254,4254,0,17082,15000,15000,0,0,2082,2000,82,0,13500,3500,0,3500,2488,185,30,360,240,64
2020,110800281,67154,904,904,904,0,66250,65000,50000,15000,0,1250,500,750,0,530,30,0,0,2480,60,1200,60,60,60
2020,110800331,177800,18800,18800,18800,0,159000,155000,55000,100000,0,4000,3500,500,0,20000,0,0,0,7028,400,200,600,228,566
2020,110800341,24000,23400,5600,600,17800,600,0,0,0,0,600,600,0,0,18400,18400,16900,500,3220,600,80,550,150,119
2020,110800351,4200,3800,1400,1400,2400,400,0,0,0,0,400,400,0,0,0,0,0,0,2650,600,100,350,100,32
2020,110800371,16566,16066,7066,7066,9000,500,0,0,0,0,500,500,0,0,1850,1850,1850,0,2154,146,100,288,120,22
2020,110800391,2752,2752,1752,1752,1000,0,0,0,0,0,0,0,0,0,0,0,0,0,1090,140,10,120,60,16
2020,110801101,28640,640,640,640,0,28000,28000,28000,0,0,0,0,0,0,14500,14500,14500,0,2064,108,200,100,300,37
2020,110900161,118700,3200,3200,3200,0,115500,115000,90000,25000,0,500,500,0,0,20200,18500,18000,500,6450,480,50,360,350,367
2020,110900201,11990,3990,3990,3990,0,8000,7000,7000,0,0,1000,1000,0,0,1500,1500,1500,0,978,72,20,140,96,13
2020,110900211,32780,11000,11000,11000,0,21780,18000,10000,8000,0,3780,3780,0,0,2600,2600,0,0,2260,190,20,300,300,66
2020,110900221,10223,9883,3883,3383,6000,340,0,0,0,0,340,0,340,0,4548,4548,0,3640,2729,360,35,50,24,1
2020,110900241,4185,3365,1365,365,2000,820,0,0,0,0,820,270,400,150,3050,3050,3050,0,1918,504,120,240,84,49
2020,110900251,4830,4010,1010,1010,3000,820,0,0,0,0,820,720,100,0,700,700,0,0,1292,480,10,24,120,15
2020,110900261,32324,2211,2211,2211,0,30113,30000,22000,8000,0,113,0,113,0,0,0,0,0,582,160,40,48,36,23
2020,110900271,38210,7610,7610,7610,0,30600,30000,30000,0,0,600,600,0,0,2000,0,0,0,5250,630,360,300,480,555
2020,110900281,59760,4560,4560,4560,0,55200,52900,44900,8000,0,2300,2300,0,0,10000,10000,10000,0,2942,240,10,384,216,279
2020,110900291,2450,2450,450,450,2000,0,0,0,0,0,0,0,0,0,0,0,0,0,1548,360,20,12,120,41
2020,110900321,400,400,100,100,300,0,0,0,0,0,0,0,0,0,0,0,0,0,1336,96,1000,12,28,0
2020,110900331,17000,1000,1000,1000,0,16000,16000,16000,0,0,0,0,0,0,0,0,0,0,1187,108,100,24,60,33
2020,110900341,109720,46620,46620,29620,0,63100,58000,36000,22000,0,5100,3100,0,2000,8500,0,0,0,3478,144,700,446,204,153
2020,110900351,11000,8550,2550,2550,6000,2450,0,0,0,0,2450,2450,0,0,4380,4380,2680,0,1190,150,120,180,120,42
2020,110900361,62990,19690,14190,14190,5500,43300,43000,0,43000,0,300,300,0,0,30300,25300,25300,0,2134,240,100,220,200,128
2020,110900381,77300,32050,8050,8050,24000,45250,42000,0,42000,0,3250,3250,0,0,35400,13400,12000,0,4020,276,36,516,240,73
2020,110900391,118460,5460,5460,5460,0,113000,110000,50000,0,60000,3000,3000,0,0,60000,60000,0,60000,7750,480,100,300,240,2607
2020,110901101,101110,1110,1110,1110,0,100000,100000,100000,0,0,0,0,0,0,3000,0,0,0,1076,84,130,62,60,111
2020,111000102,8051,8051,51,51,8000,0,0,0,0,0,0,0,0,0,0,0,0,0,2270,780,40,600,180,1
2020,111000112,570,570,70,70,500,0,0,0,0,0,0,0,0,0,0,0,0,0,812,300,5,10,30,0
2020,111000172,137050,5300,5300,5300,0,131750,131750,128000,3750,0,0,0,0,0,28000,8000,8000,0,2124,360,200,36,48,250
2020,111000202,13020,20,20,20,0,13000,13000,13000,0,0,0,0,0,0,0,0,0,0,2413,186,10,168,300,11
2020,111000242,80100,64000,24000,24000,40000,16100,0,0,0,0,16100,16100,0,0,52000,52000,52000,0,4640,360,600,100,100,20518
2020,111000252,54482,22672,22672,22672,0,31810,30000,30000,0,0,1810,1300,510,0,10900,8900,2900,6000,3546,96,120,300,180,136
2020,111000262,11238,2238,2238,2238,0,9000,9000,9000,0,0,0,0,0,0,0,0,0,0,2560,50,650,120,120,11
2020,111000272,12972,2072,2072,2072,0,10900,9000,9000,0,0,1900,1900,0,0,2000,2000,2000,0,2970,180,150,320,200,14
2020,111000282,1320,1320,120,120,1200,0,0,0,0,0,0,0,0,0,0,0,0,0,1413,69,20,60,36,1
2020,111000302,36513,30400,400,400,30000,6113,0,0,0,0,6113,6000,113,0,21660,21660,20000,0,3486,276,300,120,300,492
2020,111000312,1926,1026,26,26,1000,900,0,0,0,0,900,0,900,0,3500,3500,0,0,3044,650,400,144,360,1
2020,111000322,15372,14900,2400,2400,12500,472,0,0,0,0,472,472,0,0,2434,2434,900,1534,2200,140,70,250,140,178
2020,111000332,96110,87110,65110,65110,22000,9000,9000,0,6000,3000,0,0,0,0,10000,10000,10000,0,2730,200,480,80,100,2
2020,111000362,1814,1314,314,314,1000,500,0,0,0,0,500,500,0,0,0,0,0,0,2008,480,180,120,48,26
2020,111000372,19011,16511,1511,1511,15000,2500,0,0,0,0,2500,2500,0,0,13000,13000,10000,3000,2407,220,60,120,216,45
2020,111000382,14058,14058,1558,1558,12500,0,0,0,0,0,0,0,0,0,10560,10560,10500,0,3826,360,20,330,360,196
2020,111000392,32872,146,146,146,0,32726,30000,30000,0,0,2726,2500,226,0,2660,2660,0,0,4320,360,70,150,300,74
2020,111600101,20100,20100,3100,3100,17000,0,0,0,0,0,0,0,0,0,12000,12000,12000,0,1400,180,10,20,60,22
2020,111600111,8490,8490,5490,5490,3000,0,0,0,0,0,0,0,0,0,0,0,0,0,2710,600,20,240,240,28
2020,111600131,73303,20233,20233,15233,0,53070,53000,25000,28000,0,70,70,0,0,25000,0,0,0,4878,840,130,360,360,135
2020,111600141,320328,30428,30428,10428,0,289900,283000,68000,215000,0,6900,6700,200,0,36000,30000,8000,22000,4688,300,20,840,324,556
2020,111600151,100165,18165,18165,18165,0,82000,80000,70000,10000,0,2000,2000,0,0,27400,26900,26900,0,3500,360,100,400,120,1506
2020,111600161,48111,611,611,611,0,47500,45000,45000,0,0,2500,2000,500,0,22640,22640,16950,3200,2390,100,100,300,300,147
2020,111600181,54010,6210,6210,6210,0,47800,41500,37000,4500,0,6300,200,100,6000,0,0,0,0,3640,300,300,960,240,165
2020,111600201,490,40,40,40,0,450,0,0,0,0,450,450,0,0,0,0,0,0,866,160,10,40,96,31
2020,111600211,52000,8700,8700,8700,0,43300,43000,40000,3000,0,300,300,0,0,4500,0,0,0,1529,130,45,220,94,119
2020,111600221,53945,13445,13445,13445,0,40500,40000,40000,0,0,500,500,0,0,3000,3000,3000,0,4410,190,1560,600,180,166
2020,111600231,59015,17890,7890,7890,10000,41125,40000,0,40000,0,1125,1000,125,0,26800,11800,9900,1900,3810,290,150,700,200,191
2020,111600251,1120,1120,120,120,1000,0,0,0,0,0,0,0,0,0,1544,1544,0,1544,2640,680,20,180,180,36
2020,111600281,14836,3836,3836,3836,0,11000,11000,11000,0,0,0,0,0,0,5000,5000,3000,2000,1578,192,200,60,36,14
2020,111600291,20978,2150,2150,2150,0,18828,16000,16000,0,0,2828,2150,678,0,1000,1000,1000,0,3926,216,100,350,210,323
2020,111600311,550,400,400,400,0,150,0,0,0,0,150,150,0,0,857,857,0,857,2160,180,140,240,144,25
2020,111600321,40770,3550,3550,3550,0,37220,37000,37000,0,0,220,100,120,0,7799,7799,7799,0,4808,420,50,56,340,11
2020,111600351,22564,2564,2564,2564,0,20000,20000,20000,0,0,0,0,0,0,8300,0,0,0,1678,584,320,240,60,31
2020,111600381,86639,63639,8639,8639,55000,23000,23000,0,23000,0,0,0,0,0,25000,21000,18000,3000,4960,750,150,300,180,123
2020,111700111,15390,14190,4190,4190,10000,1200,0,0,0,0,1200,1200,0,0,0,0,0,0,1240,240,50,200,60,47
2020,111700141,70250,13250,13250,13250,0,57000,57000,57000,0,0,0,0,0,0,0,0,0,0,3772,480,670,600,72,88
2020,111700181,61126,14826,14826,14826,0,46300,45000,45000,0,0,1300,700,600,0,4900,4900,4900,0,4750,240,320,360,240,269
2020,111700191,52303,7190,7190,7190,0,45113,45000,45000,0,0,113,0,113,0,0,0,0,0,1280,240,120,60,60,38
2020,111700201,24420,9680,9680,9680,0,14740,14400,14400,0,0,340,340,0,0,0,0,0,0,2148,252,30,260,96,984
2020,111700211,1390,990,290,290,700,400,0,0,0,0,400,0,200,200,0,0,0,0,2240,480,240,100,120,1
2020,111700221,4096,4096,96,96,4000,0,0,0,0,0,0,0,0,0,0,0,0,0,3504,600,24,180,180,82
2020,111700231,17550,550,550,550,0,17000,17000,17000,0,0,0,0,0,0,0,0,0,0,1246,120,36,40,60,16
2020,111700241,31839,8572,8572,8572,0,23267,23000,15000,8000,0,267,200,67,0,520,20,0,0,2132,123,360,300,120,60
2020,111700251,19742,742,742,742,0,19000,19000,19000,0,0,0,0,0,0,5557,5557,5317,240,1222,156,20,100,146,31
2020,111700271,22250,1650,1650,1650,0,20600,20000,20000,0,0,600,500,100,0,0,0,0,0,3050,360,120,440,150,69
2020,111700281,21915,3870,3870,3870,0,18045,16000,16000,0,0,2045,45,2000,0,6000,6000,6000,0,2420,180,10,300,240,28
2020,111700291,31162,6662,6662,6662,0,24500,23000,15000,8000,0,1500,1500,0,0,10147,10147,10147,0,4482,192,170,240,180,57
2020,111700321,18275,1775,1775,775,0,16500,15000,15000,0,0,1500,0,200,1300,13364,13364,9784,0,2540,140,20,200,300,41
2020,111700331,36030,36030,6030,6030,30000,0,0,0,0,0,0,0,0,0,0,0,0,0,599,120,10,120,105,31
2020,111700341,73468,3468,3468,3468,0,70000,70000,35000,35000,0,0,0,0,0,1000,0,0,0,1477,240,36,96,55,67
2020,111700351,118774,90774,40774,40774,50000,28000,28000,0,28000,0,0,0,0,0,57250,30250,30000,0,2660,360,500,50,100,1336
2020,111700371,5440,5440,3440,3440,2000,0,0,0,0,0,0,0,0,0,4150,4150,3150,0,1516,100,150,120,36,19
2020,111700381,800,800,40,40,760,0,0,0,0,0,0,0,0,0,4841,4841,541,0,539,108,40,20,49,1
2020,111800111,37730,230,230,230,0,37500,35000,35000,0,0,2500,2500,0,0,12600,12600,10000,2000,4120,384,60,240,360,87
2020,111800121,121727,48227,4227,4227,44000,73500,70000,0,70000,0,3500,1200,0,2300,8000,0,0,0,5280,180,500,600,200,84
2020,111800141,58810,11810,11810,11810,0,47000,45000,45000,0,0,2000,2000,0,0,1800,800,0,800,5220,360,120,240,180,1505
2020,111800151,892,892,492,492,400,0,0,0,0,0,0,0,0,0,1800,1800,0,1400,2404,634,50,360,240,14
2020,111800171,209840,88590,88590,88590,0,121250,120000,70000,50000,0,1250,250,1000,0,3000,0,0,0,3750,360,240,220,360,508
2020,111800191,57510,7410,7410,7410,0,50100,50000,50000,0,0,100,100,0,0,0,0,0,0,3824,300,1200,120,204,728
2020,111800201,39280,11940,11940,11940,0,27340,27000,27000,0,0,340,0,340,0,0,0,0,0,1658,156,100,150,132,60
2020,111800211,38800,11100,11100,11100,0,27700,26000,26000,0,0,1700,1700,0,0,8920,8920,8800,0,4100,180,140,320,200,99
2020,111800221,70710,11410,11410,11410,0,59300,58000,58000,0,0,1300,1300,0,0,300,300,0,0,6148,288,250,550,280,2253
2020,111800231,54691,10041,10041,10041,0,44650,43000,43000,0,0,1650,1000,650,0,6000,6000,0,6000,3942,255,30,460,180,645
2020,111800281,22129,1814,1814,1814,0,20315,20000,16000,4000,0,315,0,315,0,0,0,0,0,1530,180,20,100,200,75
2020,111800301,156920,58120,22120,22120,36000,98800,95000,0,60000,35000,3800,3800,0,0,51400,51400,34000,16000,9000,1000,2000,800,500,1893
2020,111800311,234735,5700,5700,5700,0,229035,228000,75000,153000,0,1035,900,135,0,1300,0,0,0,2170,400,600,200,200,627
2020,111900161,39000,9000,9000,9000,0,30000,30000,30000,0,0,0,0,0,0,0,0,0,0,656,120,120,12,24,46
2020,111900171,3410,3410,2910,2910,500,0,0,0,0,0,0,0,0,0,1944,1944,0,1944,1100,480,100,100,120,99
2020,111900181,14900,14200,1700,1700,12500,700,0,0,0,0,700,700,0,0,0,0,0,0,1890,240,100,360,240,31
2020,111900191,4620,4620,2620,2620,2000,0,0,0,0,0,0,0,0,0,1040,1040,0,0,3140,600,100,300,330,25
2020,111900221,80,80,80,80,0,0,0,0,0,0,0,0,0,0,0,0,0,0,649,60,60,15,24,1
2020,111900231,10670,670,670,670,0,10000,10000,10000,0,0,0,0,0,0,0,0,0,0,1488,116,110,92,96,19
2020,111900241,3360,3360,360,360,3000,0,0,0,0,0,0,0,0,0,0,0,0,0,658,280,80,20,48,1
2020,111900251,700,700,430,430,270,0,0,0,0,0,0,0,0,0,400,400,0,0,616,116,20,30,40,0
2020,111900261,14262,4862,4862,3862,0,9400,7500,7500,0,0,1900,900,1000,0,0,0,0,0,3540,540,10,300,180,107
2020,111900271,36544,10244,10244,10244,0,26300,15000,15000,0,0,11300,1300,10000,0,11647,11647,11647,0,3438,228,1100,600,110,211
2020,111900291,20161,16161,16161,16161,0,4000,0,0,0,0,4000,4000,0,0,0,0,0,0,5810,360,400,120,180,514
2020,111900301,76616,43590,15590,15290,28000,33026,30000,0,30000,0,3026,2800,226,0,9700,9700,7000,0,4905,240,120,360,360,908
2020,111900311,12722,12422,422,422,12000,300,0,0,0,0,300,300,0,0,5000,5000,3000,0,2079,170,20,372,192,147
2020,111900331,257590,51690,51690,51690,0,205900,200000,150000,50000,0,5900,3500,2400,0,13700,13700,13100,600,9400,600,200,500,300,2221
2020,111900381,11880,2830,2830,830,0,9050,0,0,0,0,9050,50,7500,1500,3280,3280,2600,0,732,0,100,150,60,23
2020,111900391,36920,6520,6520,6520,0,30400,30000,30000,0,0,400,400,0,0,9700,9700,9700,0,2955,250,250,170,270,307
2020,112000102,3579,3379,1879,1879,1500,200,0,0,0,0,200,0,200,0,100,100,0,0,1384,360,20,40,144,1
2020,112000142,2660,2660,160,160,2500,0,0,0,0,0,0,0,0,0,0,0,0,0,1626,444,50,48,84,1
2020,112000172,2220,2220,1220,420,1000,0,0,0,0,0,0,0,0,0,740,740,0,740,2426,756,50,180,240,31
2020,112000202,20437,8387,8387,5387,0,12050,12000,12000,0,0,50,50,0,0,4922,4922,4922,0,1356,252,20,240,168,17
2020,112000212,33136,9436,9436,9436,0,23700,18000,16000,2000,0,5700,1700,4000,0,0,0,0,0,2397,234,65,240,108,62
2020,112000222,9375,225,225,225,0,9150,9000,9000,0,0,150,150,0,0,1300,1300,0,0,2194,200,100,120,324,60
2020,112000242,8819,1819,1819,1819,0,7000,7000,7000,0,0,0,0,0,0,1000,1000,1000,0,1329,114,100,75,80,87
2020,112000252,16100,100,100,100,0,16000,16000,16000,0,0,0,0,0,0,0,0,0,0,618,180,108,10,60,17
2020,112000262,3100,1900,900,900,1000,1200,0,0,0,0,1200,200,1000,0,14000,14000,0,14000,4263,800,50,850,300,528
2020,112000272,22100,8800,8800,8800,0,13300,13000,13000,0,0,300,300,0,0,0,0,0,0,2261,154,70,270,128,130
2020,112000282,7020,20,20,20,0,7000,7000,7000,0,0,0,0,0,0,536,536,536,0,1196,172,120,96,60,23
2020,112000292,16730,330,330,330,0,16400,16300,15000,1300,0,100,0,100,0,320,20,0,0,666,180,90,20,30,31
2020,112000312,21279,17840,8340,8340,9500,3439,0,0,0,0,3439,3100,339,0,1130,1130,0,980,3400,210,80,450,360,68
2020,112000322,85736,58556,58556,58556,0,27180,26000,26000,0,0,1180,900,280,0,8900,8900,8900,0,2878,312,50,156,110,412
2020,112000332,32000,21000,6000,6000,15000,11000,10000,0,10000,0,1000,1000,0,0,500,0,0,0,1616,216,100,180,180,35
2020,112000342,42954,2604,2604,2604,0,40350,40000,40000,0,0,350,350,0,0,20000,20000,20000,0,3033,408,5,160,180,78
2020,112000352,335000,27400,27400,27400,0,307600,300000,100000,200000,0,7600,2600,5000,0,10000,0,0,0,3770,600,300,300,120,4181
2020,112000362,162100,48100,48100,48100,0,114000,110000,70000,40000,0,4000,4000,0,0,33000,10000,0,10000,4340,400,400,400,120,292
2020,112000372,4770,4770,270,270,4500,0,0,0,0,0,0,0,0,0,100,100,0,0,2390,180,200,150,180,3
2020,112000382,10220,220,220,220,0,10000,10000,10000,0,0,0,0,0,0,1000,1000,0,1000,1660,120,250,200,120,53
2020,112600101,126594,7144,7144,7144,0,119450,119000,82800,36200,0,450,450,0,0,0,0,0,0,5469,692,127,120,240,331
2020,112600131,26936,936,936,936,0,26000,26000,26000,0,0,0,0,0,0,20800,20800,15800,0,3180,240,50,180,240,303
2020,112600141,104905,32905,2905,2905,30000,72000,72000,0,72000,0,0,0,0,0,57925,32925,30200,2725,2555,400,55,120,150,505
2020,112600161,6862,6794,794,794,6000,68,0,0,0,0,68,0,68,0,0,0,0,0,919,120,198,12,24,1
2020,112600171,14050,50,50,50,0,14000,14000,14000,0,0,0,0,0,0,0,0,0,0,751,67,198,20,36,21
2020,112600201,43215,9195,9195,9195,0,34020,33500,16000,17500,0,520,180,340,0,1980,980,980,0,3070,540,20,270,180,76
2020,112600211,42260,8060,8060,8060,0,34200,33000,33000,0,0,1200,1100,100,0,2200,2200,2200,0,3154,444,360,600,192,126
2020,112600261,31810,770,770,770,0,31040,31000,23000,8000,0,40,0,40,0,2500,0,0,0,1972,220,130,55,67,48
2020,112600271,11240,3740,3740,3440,0,7500,7000,7000,0,0,500,0,500,0,1200,1000,0,1000,1746,180,120,240,156,396
2020,112600281,37564,7764,7764,7764,0,29800,27800,27800,0,0,2000,2000,0,0,17000,17000,17000,0,4776,300,20,300,156,49
2020,112600291,45090,2090,2090,2090,0,43000,43000,40000,3000,0,0,0,0,0,5000,5000,0,1000,2220,120,840,36,24,20
2020,112600321,209000,27150,27150,27150,0,181850,180000,180000,0,0,1850,1850,0,0,130000,0,0,0,4470,800,200,600,180,595
2020,112600331,16812,16712,3712,3712,13000,100,0,0,0,0,100,0,100,0,6800,6800,6400,400,1427,228,14,36,96,3
2020,112600361,18760,5960,5960,5960,0,12800,5000,0,5000,0,7800,800,0,7000,2900,2900,2900,0,2360,400,200,120,120,321
2020,112600391,6139,6039,5039,5039,1000,100,0,0,0,0,100,0,100,0,850,850,0,600,1891,650,150,50,200,189
2020,112700101,50,50,50,50,0,0,0,0,0,0,0,0,0,0,0,0,0,0,1990,240,100,20,30,1
2020,112700161,82490,14240,14240,14240,0,68250,68000,68000,0,0,250,250,0,0,0,0,0,0,3940,360,150,200,120,1501
2020,112700181,129220,45420,45420,45420,0,83800,80000,80000,0,0,3800,3800,0,0,0,0,0,0,8620,320,2000,360,240,399
2020,112700191,6928,6748,1148,1148,5600,180,0,0,0,0,180,180,0,0,0,0,0,0,2418,180,50,280,170,24
2020,112700211,66280,4080,4080,4080,0,62200,60000,60000,0,0,2200,1700,500,0,40420,40420,33620,6800,7746,420,120,216,180,1199
2020,112700251,8349,7399,399,399,7000,950,0,0,0,0,950,950,0,0,3500,3500,0,3500,2201,96,55,100,180,22
2020,112700281,13528,528,528,528,0,13000,13000,13000,0,0,0,0,0,0,5660,5660,5160,0,1690,180,10,250,120,100
2020,112700301,2869,2869,269,269,2600,0,0,0,0,0,0,0,0,0,0,0,0,0,536,168,45,20,25,1
2020,112700311,166240,24240,4240,4240,20000,142000,140000,0,80000,60000,2000,2000,0,0,3000,3000,0,3000,2700,200,500,300,100,1565
2020,112700331,15555,13255,1255,1255,12000,2300,0,0,0,0,2300,2300,0,0,11965,11965,10000,0,2936,480,37,120,24,90
2020,112700351,15901,15901,401,401,15500,0,0,0,0,0,0,0,0,0,4500,4500,0,2000,3169,300,400,299,150,29
2020,112700361,29698,27498,12498,12498,15000,2200,0,0,0,0,2200,2200,0,0,0,0,0,0,3730,500,10,450,180,163
2020,112700371,140000,11000,11000,11000,0,129000,125000,50000,75000,0,4000,4000,0,0,27250,7250,7200,0,3170,240,450,300,100,211
2020,112700381,62890,16240,16240,16240,0,46650,45000,45000,0,0,1650,1150,500,0,10100,10100,10100,0,3836,216,150,250,120,294
2020,112700391,10080,10000,2100,2100,7900,80,0,0,0,0,80,80,0,0,4900,4900,4900,0,1836,456,40,330,80,24
2020,112800111,33983,8475,8475,8475,0,25508,20000,20000,0,0,5508,3700,1808,0,4748,4748,4748,0,2810,180,100,150,240,171
2020,112800121,88692,7692,7692,4692,0,81000,80000,48000,32000,0,1000,1000,0,0,12000,1000,0,1000,2230,250,100,360,120,145
2020,112800151,27550,5450,5450,5450,0,22100,19000,19000,0,0,3100,3100,0,0,2004,2004,0,0,2902,240,30,400,332,149
2020,112800191,36360,5060,5060,5060,0,31300,30000,30000,0,0,1300,1300,0,0,4700,4700,4700,0,2370,240,50,360,360,155
2020,112800211,26362,4662,4662,4662,0,21700,20000,20000,0,0,1700,1500,200,0,30,30,0,0,2636,240,20,164,120,243
2020,112800231,44945,695,695,695,0,44250,37000,17000,20000,0,7250,250,5000,2000,38455,38455,33000,5455,3340,220,50,900,300,131
2020,112800251,11640,140,140,140,0,11500,11500,11500,0,0,0,0,0,0,7000,7000,7000,0,1436,156,50,100,100,50
2020,112800261,40119,2019,2019,2019,0,38100,35000,35000,0,0,3100,3000,100,0,3000,0,0,0,1920,108,42,215,186,350
2020,112800311,4800,4200,1700,1700,2500,600,0,0,0,0,600,600,0,0,750,750,0,500,1937,750,60,350,216,1
2020,112800321,110116,61316,61316,61316,0,48800,48000,23000,25000,0,800,800,0,0,1180,180,0,0,3232,232,360,720,180,218
2020,112800331,54168,11368,11368,11368,0,42800,40000,0,40000,0,2800,2500,300,0,0,0,0,0,2772,360,72,60,360,149
2020,112800341,47115,6435,6435,6435,0,40680,38000,38000,0,0,2680,2500,180,0,9000,9000,5000,4000,2442,360,30,192,240,82
2020,112800351,384668,14768,14768,14768,0,369900,365000,65000,300000,0,4900,4900,0,0,160000,0,0,0,9900,600,100,800,400,11771
2020,112800371,2093,2093,1793,353,300,0,0,0,0,0,0,0,0,0,13600,13600,0,0,655,400,10,60,50,24
2020,112800381,3010,3010,10,10,3000,0,0,0,0,0,0,0,0,0,0,0,0,0,3446,1056,24,180,240,193
2020,112800391,12800,300,300,300,0,12500,12000,12000,0,0,500,500,0,0,6200,6200,4000,0,3220,100,50,150,300,175
2020,112900101,146800,800,800,800,0,146000,145000,65000,80000,0,1000,1000,0,0,29500,14500,12000,2500,2236,240,96,120,120,165
2020,112900111,33624,8924,8924,5194,0,24700,23000,23000,0,0,1700,0,700,1000,0,0,0,0,2226,120,30,200,180,69
2020,112900131,84988,14288,14288,13288,0,70700,68000,68000,0,0,2700,2700,0,0,28000,28000,22000,6000,5260,260,20,240,240,424
2020,112900151,4100,4100,1100,1100,3000,0,0,0,0,0,0,0,0,0,900,900,0,600,1086,100,0,96,60,1
2020,112900181,3150,3000,500,500,2500,150,0,0,0,0,150,150,0,0,0,0,0,0,3460,1200,20,600,200,30
2020,112900191,1150,1150,150,150,1000,0,0,0,0,0,0,0,0,0,0,0,0,0,1560,624,36,108,60,19
2020,112900201,21450,5450,3950,3950,1500,16000,16000,0,16000,0,0,0,0,0,4000,0,0,0,1414,150,500,30,34,34
2020,112900211,24900,1900,1900,1900,0,23000,20000,17000,3000,0,3000,3000,0,0,0,0,0,0,1077,120,40,60,67,95
2020,112900231,56390,8690,8690,8690,0,47700,44000,44000,0,0,3700,3700,0,0,12250,12250,12250,0,6460,570,100,600,360,1442
2020,112900241,22069,8069,8069,8069,0,14000,14000,14000,0,0,0,0,0,0,0,0,0,0,1751,319,50,88,96,15
2020,112900261,11045,945,945,945,0,10100,10000,10000,0,0,100,0,100,0,3000,0,0,0,918,120,120,48,30,15
2020,112900271,9080,1080,1080,1080,0,8000,8000,8000,0,0,0,0,0,0,100,0,0,0,1078,84,500,36,48,5
2020,112900291,57473,5973,5973,5973,0,51500,50000,50000,0,0,1500,500,1000,0,0,0,0,0,4610,210,50,150,100,378
2020,112900301,31740,1440,1440,1440,0,30300,29000,29000,0,0,1300,1300,0,0,10000,10000,10000,0,3508,350,25,300,350,96
2020,112900341,79939,31039,31039,13039,0,48900,42000,42000,0,0,6900,6900,0,0,0,0,0,0,4854,288,100,420,300,222
2020,112900351,30291,30291,5291,5291,25000,0,0,0,0,0,0,0,0,0,8000,8000,8000,0,1800,160,60,240,180,363
2020,112900361,12640,1140,1140,1140,0,11500,10000,10000,0,0,1500,1500,0,0,682,682,640,0,4059,150,105,898,300,183
2020,112900371,10574,9374,1374,1374,8000,1200,0,0,0,0,1200,1200,0,0,500,500,0,500,4110,360,30,360,360,168
2020,112900381,620,620,120,120,500,0,0,0,0,0,0,0,0,0,410,410,0,410,2540,600,20,120,360,12
2020,113000112,32160,2060,2060,1860,0,30100,30000,30000,0,0,100,100,0,0,0,0,0,0,2740,180,1000,360,120,123
2020,113000122,32863,2863,2863,1863,0,30000,30000,30000,0,0,0,0,0,0,50,50,0,0,1262,72,20,120,100,31
2020,113000132,60739,739,739,739,0,60000,60000,30000,30000,0,0,0,0,0,1000,0,0,0,1117,90,98,6,53,99
2020,113000142,48280,23080,3080,3080,20000,25200,25000,0,25000,0,200,200,0,0,17000,0,0,0,3546,240,50,100,156,96
2020,113000152,7572,5572,2572,2572,3000,2000,0,0,0,0,2000,2000,0,0,1957,1957,0,647,2285,960,70,360,144,80
2020,113000162,22330,6230,6230,6230,0,16100,15000,15000,0,0,1100,1100,0,0,50,50,0,0,2564,132,500,456,120,171
2020,113000172,21080,2100,2100,100,0,18980,17500,17500,0,0,1480,1250,230,0,0,0,0,0,2748,192,600,288,144,71
2020,113000182,8520,8520,20,20,8500,0,0,0,0,0,0,0,0,0,0,0,0,0,2130,360,20,120,180,9
2020,113000192,88050,26200,26200,26200,0,61850,60000,60000,0,0,1850,1850,0,0,430,430,0,0,3813,440,110,125,218,348
2020,113000202,80,80,80,80,0,0,0,0,0,0,0,0,0,0,0,0,0,0,1008,80,350,24,24,1
2020,113000212,44251,13088,13088,13088,0,31163,29000,29000,0,0,2163,2000,163,0,0,0,0,0,2301,248,10,90,132,126
2020,113000222,19796,1796,1796,1796,0,18000,18000,18000,0,0,0,0,0,0,0,0,0,0,1136,210,30,36,72,17
2020,113000232,20905,2005,2005,2005,0,18900,18000,18000,0,0,900,900,0,0,0,0,0,0,2605,240,50,480,284,159
2020,113000262,97650,16950,450,450,16500,80700,80000,0,80000,0,700,700,0,0,35000,0,0,0,2329,216,150,180,110,84
2020,113000302,1180,1180,180,180,1000,0,0,0,0,0,0,0,0,0,0,0,0,0,1696,456,120,20,100,1
2020,113000322,48450,16050,16050,16050,0,32400,31700,29000,0,2700,700,700,0,0,0,0,0,0,2324,240,300,160,120,149
2020,113000332,20230,230,230,230,0,20000,20000,20000,0,0,0,0,0,0,2000,2000,2000,0,1759,324,200,72,215,91
2020,113000352,34970,7870,7870,7870,0,27100,10000,10000,0,0,17100,2100,0,15000,0,0,0,0,3591,181,100,560,240,107
2020,113000362,2905,605,105,105,500,2300,0,0,0,0,2300,2300,0,0,12900,12900,0,11200,2048,744,24,250,180,126
2020,113000372,22118,3418,2418,2168,1000,18700,17000,0,17000,0,1700,1700,0,0,17908,15908,12000,3800,3511,792,60,24,240,27
2020,113000382,23768,3328,3328,3328,0,20440,20000,20000,0,0,440,440,0,0,12400,12400,12000,400,2620,360,60,360,300,279
2020,113600121,57880,10880,10880,8880,0,47000,45000,30000,15000,0,2000,0,2000,0,3475,3175,3175,0,3590,360,10,200,240,75
2020,113600141,43676,5176,5176,5176,0,38500,30000,10000,20000,0,8500,1500,0,7000,3000,3000,3000,0,1495,180,55,60,160,12
2020,113600161,19360,2010,2010,10,0,17350,14000,14000,0,0,3350,350,0,3000,12984,12984,6984,1400,870,70,90,120,120,25
2020,113600181,20920,920,920,920,0,20000,18000,18000,0,0,2000,2000,0,0,7500,7500,6000,0,3730,360,150,400,500,71
2020,113600211,21680,21610,1610,1610,20000,70,0,0,0,0,70,0,70,0,16080,16080,16000,0,2324,240,60,180,144,1
2020,113600221,98680,25980,25980,25980,0,72700,72000,72000,0,0,700,600,100,0,0,0,0,0,4370,540,50,360,180,266
2020,113600231,4454,2809,2569,2569,240,1645,0,0,0,0,1645,1500,145,0,930,930,0,0,1574,228,126,240,120,31
2020,113600251,21405,4445,945,945,3500,16960,0,0,0,0,16960,960,16000,0,11030,11030,11000,0,3233,723,60,250,360,222
2020,113600271,2010,510,310,310,200,1500,0,0,0,0,1500,500,1000,0,1040,1040,0,440,1780,320,200,180,140,41
2020,113600311,36340,22900,2500,2500,20400,13440,13000,0,13000,0,440,440,0,0,0,0,0,0,1044,204,120,120,42,114
2020,113600341,3280,3280,180,180,3100,0,0,0,0,0,0,0,0,0,3070,3070,3070,0,2638,420,120,840,288,67
2020,113600381,2000,2000,1000,1000,1000,0,0,0,0,0,0,0,0,0,0,0,0,0,2020,960,120,120,120,15
2020,113600391,11936,11936,2936,2936,9000,0,0,0,0,0,0,0,0,0,2000,2000,0,2000,1980,190,20,170,300,85
2020,113700141,88025,125,125,125,0,87900,86000,16000,70000,0,1900,1900,0,0,47305,10805,8260,2545,1164,100,20,20,72,91
2020,113700151,37630,12600,12600,12600,0,25030,25000,20000,5000,0,30,30,0,0,7264,7264,7164,0,2720,120,100,300,200,204
2020,113700191,43684,1684,1684,1684,0,42000,42000,42000,0,0,0,0,0,0,0,0,0,0,1054,180,150,60,84,121
2020,113700201,31100,14400,14400,4400,0,16700,14000,0,14000,0,2700,2500,200,0,3850,0,0,0,5600,360,240,420,300,849
2020,113700211,28691,1578,1578,1578,0,27113,27000,27000,0,0,113,0,113,0,4800,4800,4800,0,984,120,100,120,74,23
2020,113700231,42850,6050,6050,6050,0,36800,35000,30000,5000,0,1800,1800,0,0,0,0,0,0,3674,240,240,576,324,535
2020,113700251,25846,8246,5746,4746,2500,17600,17000,0,12000,5000,600,100,0,500,5900,900,0,900,2140,700,200,20,60,73
2020,113700271,12277,12277,1277,960,11000,0,0,0,0,0,0,0,0,0,0,0,0,0,1690,220,60,50,210,20
2020,113700311,11102,11102,5602,5602,5500,0,0,0,0,0,0,0,0,0,0,0,0,0,4230,220,100,300,360,136
2020,113700341,7180,680,680,680,0,6500,6500,6500,0,0,0,0,0,0,0,0,0,0,698,100,140,0,48,32
2020,113700361,11735,735,735,735,0,11000,11000,11000,0,0,0,0,0,0,0,0,0,0,830,108,144,15,17,13
2020,113800111,80110,10,10,10,0,80100,80000,0,80000,0,100,0,100,0,31000,31000,30000,0,1342,240,36,240,120,81
2020,113800131,3500,3400,100,100,3300,100,0,0,0,0,100,100,0,0,0,0,0,0,1289,144,240,240,120,18
2020,113800161,18574,18374,1374,1374,17000,200,0,0,0,0,200,200,0,0,700,700,0,400,3760,240,480,720,300,28
2020,113800171,41125,3125,25,25,3100,38000,38000,0,38000,0,0,0,0,0,13880,13880,11930,0,1120,150,80,100,90,28
2020,113800181,8830,6000,6000,6000,0,2830,0,0,0,0,2830,2830,0,0,800,800,0,0,4898,400,100,580,68,513
2020,113800191,21260,260,260,260,0,21000,21000,21000,0,0,0,0,0,0,3252,3252,3252,0,1874,144,1000,80,120,60
2020,113800211,917,917,117,117,800,0,0,0,0,0,0,0,0,0,15,15,0,0,2019,240,35,86,264,6
2020,113800231,93782,2482,2482,2482,0,91300,90000,60000,30000,0,1300,1300,0,0,60000,46000,46000,0,3736,356,40,360,120,112
2020,113800241,20448,16998,4998,998,12000,3450,1500,0,1500,0,1950,1900,50,0,220,220,0,0,3074,264,150,320,190,48
2020,113800251,25783,2783,2783,2783,0,23000,20000,16000,0,4000,3000,3000,0,0,1900,1900,0,0,4440,180,800,550,180,68
2020,113800301,66038,13538,13538,13538,0,52500,52000,52000,0,0,500,500,0,0,6700,6700,6400,0,6960,360,600,600,240,1045
2020,113800321,87378,26088,26088,26088,0,61290,58000,25000,33000,0,3290,3290,0,0,1910,400,0,0,8223,390,1800,420,240,396
2020,113800331,5526,26,26,26,0,5500,5500,5500,0,0,0,0,0,0,1000,1000,0,0,386,50,20,10,36,9
2020,113800391,18098,4598,4598,4598,0,13500,12000,12000,0,0,1500,1200,300,0,0,0,0,0,2372,800,536,180,180,35
2020,113900111,28650,650,650,650,0,28000,28000,28000,0,0,0,0,0,0,14230,14230,14230,0,2662,120,60,192,240,118
2020,113900121,37894,2894,2894,2894,0,35000,35000,35000,0,0,0,0,0,0,0,0,0,0,4020,400,200,200,420,60
2020,113900131,35010,5010,5010,5010,0,30000,30000,30000,0,0,0,0,0,0,0,0,0,0,733,280,45,10,23,55
2020,113900161,80070,70,70,70,0,80000,80000,80000,0,0,0,0,0,0,43800,23800,23800,0,890,100,100,24,19,144
2020,113900171,58630,23330,2330,2330,21000,35300,35000,0,35000,0,300,300,0,0,3400,3400,3400,0,4750,360,500,750,240,133
2020,113900181,12646,12646,146,146,12500,0,0,0,0,0,0,0,0,0,10000,10000,10000,0,929,70,5,84,120,85
2020,113900231,2748,2748,1448,1448,1300,0,0,0,0,0,0,0,0,0,2000,2000,0,0,2637,460,5,280,62,2
2020,113900241,185938,36392,36392,35092,0,149546,145000,45000,100000,0,4546,3820,726,0,57000,54000,54000,0,7700,420,600,850,360,1260
2020,113900261,7094,5294,3294,3294,2000,1800,0,0,0,0,1800,1800,0,0,4050,4050,0,3500,5614,912,70,500,300,186
2020,113900311,11436,2336,2336,2336,0,9100,7000,7000,0,0,2100,2100,0,0,8000,8000,4600,2400,2916,288,60,384,240,70
2020,113900321,46800,1600,1600,1600,0,45200,45000,17000,28000,0,200,200,0,0,0,0,0,0,1354,150,50,120,84,7
2020,113900331,18448,5448,5448,5448,0,13000,13000,13000,0,0,0,0,0,0,0,0,0,0,916,144,60,14,120,26
2020,113900371,94729,14779,14779,14779,0,79950,78000,33000,40000,5000,1950,1950,0,0,12978,1978,1978,0,4710,480,480,600,420,799
2020,113900391,106986,26116,21116,19116,5000,80870,78500,0,75500,3000,2370,1700,670,0,34000,0,0,0,2842,120,60,370,72,1752
2020,114000112,39780,7280,7280,7280,0,32500,30000,30000,0,0,2500,2500,0,0,10600,10600,9600,1000,2748,194,20,138,348,157
2020,114000132,3810,682,682,682,0,3128,0,0,0,0,3128,3128,0,0,3683,3683,3683,0,2670,750,10,300,380,109
2020,114000192,1010,1010,10,10,1000,0,0,0,0,0,0,0,0,0,20000,20000,0,0,1338,120,8,108,100,1
2020,114000312,3960,3960,960,960,3000,0,0,0,0,0,0,0,0,0,0,0,0,0,1051,444,36,60,52,2
2020,114000322,46420,3920,3920,3920,0,42500,41500,41500,0,0,1000,1000,0,0,14615,14615,13615,0,6350,300,100,300,200,534
2020,114000332,52674,754,754,754,0,51920,40000,40000,0,0,11920,1920,0,10000,5880,5880,5880,0,3485,325,125,485,230,118
2020,114000342,5676,4376,1376,1376,3000,1300,0,0,0,0,1300,1300,0,0,0,0,0,0,3246,960,10,360,216,101
2020,114000352,28502,2050,2050,2050,0,26452,26000,26000,0,0,452,0,452,0,0,0,0,0,1192,295,120,60,67,31
2020,114000362,31450,9950,9950,6350,0,21500,20000,20000,0,0,1500,1500,0,0,5515,5515,5300,0,5414,243,210,756,488,194
2020,114000372,87500,300,300,300,0,87200,87000,80000,7000,0,200,200,0,0,20800,20000,20000,0,1540,180,30,180,90,112
2020,114600101,210800,10000,10000,8000,0,200800,200000,85000,115000,0,800,800,0,0,72000,0,0,0,1890,300,200,30,60,320
2020,114600121,137100,27100,27100,27100,0,110000,110000,110000,0,0,0,0,0,0,0,0,0,0,1922,262,150,70,120,151
2020,114600131,4190,4190,190,190,4000,0,0,0,0,0,0,0,0,0,0,0,0,0,603,95,50,20,18,1
2020,114600141,10,10,10,10,0,0,0,0,0,0,0,0,0,0,0,0,0,0,766,516,55,15,15,1
2020,114600151,6410,1610,1010,1010,600,4800,4500,0,4500,0,300,300,0,0,600,600,0,600,2170,410,120,130,140,114
2020,114600171,32730,32730,25730,7730,7000,0,0,0,0,0,0,0,0,0,2560,2560,0,800,4455,987,760,180,153,42
2020,114600311,58477,5740,5740,5740,0,52737,48000,48000,0,0,4737,4669,68,0,24108,24108,23808,300,2794,240,400,30,180,79
2020,114600321,60992,5392,5392,5392,0,55600,50000,50000,0,0,5600,5600,0,0,5265,5265,0,5200,5475,240,120,250,185,642
2020,114600331,25832,1632,1632,1632,0,24200,22000,22000,0,0,2200,2200,0,0,10220,10220,10200,0,2964,300,24,216,180,52
2020,114600341,76183,15593,15593,13593,0,60590,60000,60000,0,0,590,590,0,0,4130,4130,4000,0,4790,370,150,250,170,2081
2020,114600391,48610,9960,9960,9960,0,38650,36000,20000,16000,0,2650,2600,50,0,3975,3575,3575,0,3260,120,60,480,120,1533
2020,114700121,12230,12230,3930,3930,8300,0,0,0,0,0,0,0,0,0,0,0,0,0,635,80,120,40,15,14
2020,114700131,149952,27952,27952,27952,0,122000,120000,120000,0,0,2000,2000,0,0,0,0,0,0,9810,800,500,400,360,2676
2020,114700141,4610,4610,3010,3010,1600,0,0,0,0,0,0,0,0,0,0,0,0,0,2636,398,20,252,288,132
2020,114700151,26920,320,320,320,0,26600,25000,15000,0,10000,1600,1600,0,0,8850,8850,8850,0,2110,540,300,180,240,80
2020,114700161,6824,5324,1324,1074,4000,1500,0,0,0,0,1500,1500,0,0,2230,2230,2150,0,2020,240,60,240,300,58
2020,114700301,10430,10430,1930,1930,8500,0,0,0,0,0,0,0,0,0,0,0,0,0,1650,132,30,100,72,4
2020,114700321,22720,22420,2420,2420,20000,300,0,0,0,0,300,300,0,0,17600,17600,5600,0,2012,183,52,36,156,40
2020,114700331,71130,4830,4830,1830,0,66300,61000,60000,1000,0,5300,4500,800,0,45453,45453,40400,1853,3155,600,15,240,240,219
2020,114700351,98870,7270,7270,7270,0,91600,91000,65000,26000,0,600,420,180,0,19000,0,0,0,2781,384,65,120,228,245
2020,114700381,75366,11666,11666,11666,0,63700,60000,28000,32000,0,3700,3700,0,0,36500,14500,13000,0,4800,400,100,600,180,155
2020,114700391,79273,23073,23073,23073,0,56200,53000,27000,26000,0,3200,3200,0,0,20000,0,0,0,6320,600,50,1200,360,2118
2020,114800101,219616,4916,4916,4916,0,214700,214000,89000,125000,0,700,700,0,0,11750,8000,8000,0,3700,300,500,720,180,591
2020,114800111,95110,110,110,110,0,95000,95000,75000,20000,0,0,0,0,0,11000,4000,4000,0,922,350,50,2,25,75
2020,114800121,1287900,365100,255100,255100,110000,922800,910000,0,910000,0,12800,6800,6000,0,20000,0,0,0,8320,600,520,980,300,4764
2020,114800141,720,620,20,20,600,100,0,0,0,0,100,100,0,0,700,700,0,0,3144,624,250,160,210,61
2020,114800161,66140,9940,9940,9940,0,56200,55000,55000,0,0,1200,1200,0,0,15694,15694,0,15414,3655,360,900,55,240,1206
2020,114800191,5600,5600,5100,5100,500,0,0,0,0,0,0,0,0,0,700,700,0,0,2220,600,120,120,360,1
2020,114800301,44159,6740,6740,4740,0,37419,31000,31000,0,0,6419,1080,3339,2000,2922,2922,2609,200,5290,360,350,840,480,101
2020,114800311,52266,866,866,866,0,51400,50000,50000,0,0,1400,1400,0,0,4550,4550,4550,0,4446,353,295,627,315,665
2020,114800321,50960,160,160,160,0,50800,50000,50000,0,0,800,800,0,0,15500,15500,15500,0,1318,348,85,135,75,61
2020,114800331,152508,6540,6540,2540,0,145968,145000,55000,90000,0,968,968,0,0,87500,27500,27500,0,4990,300,50,100,240,664
2020,114800341,40189,5189,5189,5189,0,35000,35000,24000,0,11000,0,0,0,0,3850,3850,3850,0,3888,360,240,300,252,740
2020,114800351,37390,7800,2800,2800,5000,29590,29360,0,0,29360,230,230,0,0,0,0,0,0,1560,360,15,62,74,36
2020,114800361,21990,20690,12690,12690,8000,1300,0,0,0,0,1300,1300,0,0,0,0,0,0,1928,108,10,96,84,224
2020,114800371,35878,4078,3078,3078,1000,31800,31300,0,26000,5300,500,500,0,0,30948,27948,18170,9778,1971,378,300,144,144,747
2020,114800391,207140,14340,14340,14340,0,192800,190000,20000,170000,0,2800,1800,1000,0,57000,15000,15000,0,3550,400,420,720,120,1842
2020,114900121,26850,26650,8650,8650,18000,200,0,0,0,0,200,200,0,0,0,0,0,0,2116,118,10,420,264,23
2020,114900151,1798,1798,1298,1298,500,0,0,0,0,0,0,0,0,0,1184,1184,0,1181,1500,348,30,120,84,69
2020,114900171,1010,1010,10,10,1000,0,0,0,0,0,0,0,0,0,0,0,0,0,383,90,60,0,10,1
2020,114900311,78800,16500,16500,16500,0,62300,62000,62000,0,0,300,300,0,0,0,0,0,0,2136,396,270,80,125,101
2020,114900321,23540,2540,2540,2540,0,21000,21000,21000,0,0,0,0,0,0,0,0,0,0,1485,243,300,184,96,52
2020,114900331,26768,3918,3918,3918,0,22850,21000,21000,0,0,1850,1650,200,0,11557,11557,8632,985,4207,225,124,483,360,147
2020,114900341,14626,14626,7126,7126,7500,0,0,0,0,0,0,0,0,0,0,0,0,0,2163,123,12,15,121,1
2020,114900361,2280,780,380,380,400,1500,0,0,0,0,1500,1500,0,0,0,0,0,0,2313,492,29,240,180,7
2020,114900381,35304,4654,4654,4654,0,30650,30000,30000,0,0,650,650,0,0,11300,11300,11300,0,1860,336,20,240,192,255
2020,114900391,51875,28215,9215,2215,19000,23660,17860,0,15000,2860,5800,5800,0,0,49445,36445,28000,1200,4330,250,200,1400,480,109
2020,115000102,2619,2186,686,686,1500,433,0,0,0,0,433,350,83,0,800,800,0,800,1927,726,40,20,240,168
2020,115000122,32503,2303,2303,2303,0,30200,30000,0,30000,0,200,200,0,0,24000,11000,8000,3000,3152,360,100,180,360,183
2020,115000132,120700,7500,7500,7500,0,113200,110000,60000,50000,0,3200,700,2500,0,25200,21200,21000,0,3830,600,120,300,300,1148
2020,115000142,128493,15480,15480,15480,0,113013,111000,73000,38000,0,2013,1900,113,0,21000,0,0,0,5360,400,120,340,140,350
2020,115000152,405,405,300,300,105,0,0,0,0,0,0,0,0,0,0,0,0,0,934,170,0,120,12,0
2020,115000162,148,148,1,1,147,0,0,0,0,0,0,0,0,0,0,0,0,0,589,108,80,60,15,0
2020,115000182,4000,2500,500,300,2000,1500,0,0,0,0,1500,1500,0,0,0,0,0,0,1330,700,20,240,70,619
2020,115000302,44465,10255,10255,10255,0,34210,33000,33000,0,0,1210,1210,0,0,0,0,0,0,2249,245,51,315,182,104
2020,115000312,24318,2318,2318,2318,0,22000,22000,22000,0,0,0,0,0,0,4500,4500,4500,0,1068,210,10,204,84,19
2020,115000322,40166,3166,3166,3166,0,37000,35000,35000,0,0,2000,2000,0,0,5000,3000,3000,0,1045,240,20,180,180,97
2020,115000332,43640,1940,1940,1940,0,41700,40000,40000,0,0,1700,1700,0,0,0,0,0,0,1804,220,120,120,36,63
2020,115000352,18210,3110,3110,2110,0,15100,15000,15000,0,0,100,100,0,0,0,0,0,0,2380,243,210,460,108,56
2020,115000362,26560,60,60,60,0,26500,26500,14500,12000,0,0,0,0,0,1000,0,0,0,996,280,26,10,0,25
2020,115000372,47930,12430,12430,10430,0,35500,33000,18000,15000,0,2500,600,900,1000,16000,8000,0,8000,2094,224,300,360,180,218
2020,115000392,30378,5878,5878,4278,0,24500,23000,23000,0,0,1500,1500,0,0,7240,7240,6000,0,2637,158,50,492,210,90
2020,115600121,87685,2585,2585,2585,0,85100,85000,85000,0,0,100,100,0,0,13560,13560,13560,0,2240,360,10,240,180,905
2020,115600131,26330,3030,3030,3030,0,23300,23000,23000,0,0,300,300,0,0,0,0,0,0,2111,156,30,480,180,69
2020,115600311,50613,11793,11793,11793,0,38820,35000,35000,0,0,3820,3700,120,0,9160,9160,9160,0,5332,330,24,340,300,1353
2020,115600331,10736,1600,1600,1600,0,9136,9000,9000,0,0,136,0,136,0,7228,7228,5728,1500,1636,137,120,36,68,9
2020,115600361,1611,1611,1611,1611,0,0,0,0,0,0,0,0,0,0,2000,2000,0,2000,3040,240,0,360,120,47
2020,115600371,2490,2490,490,490,2000,0,0,0,0,0,0,0,0,0,0,0,0,0,460,52,12,12,36,1
2020,115600391,39080,5080,5080,5080,0,34000,32000,32000,0,0,2000,2000,0,0,19072,19072,10772,8300,3574,384,250,310,280,1175
2020,115700101,35650,650,650,650,0,35000,28000,28000,0,0,7000,7000,0,0,13000,13000,13000,0,3370,240,70,450,360,151
2020,115700111,21300,2300,2300,2300,0,19000,19000,19000,0,0,0,0,0,0,0,0,0,0,1274,240,600,36,48,21
2020,115700131,50940,8440,8440,5940,0,42500,40000,40000,0,0,2500,2500,0,0,0,0,0,0,4954,356,200,600,360,149
2020,115700151,2010,2010,10,10,2000,0,0,0,0,0,0,0,0,0,0,0,0,0,1094,360,440,3,24,0
2020,115700171,111776,29140,29140,29140,0,82636,80000,47000,33000,0,2636,1500,1136,0,2000,0,0,0,4020,360,36,262,192,662
2020,115700181,83744,83200,18200,18200,65000,544,0,0,0,0,544,544,0,0,64,64,0,0,3200,500,100,200,200,2600
2020,115700311,580,580,80,80,500,0,0,0,0,0,0,0,0,0,0,0,0,0,754,240,50,10,24,1
2020,115700321,40032,8852,8852,8852,0,31180,31000,31000,0,0,180,180,0,0,3200,3200,0,0,1440,360,30,50,100,161
2020,115700341,79297,23147,23147,20147,0,56150,56000,28000,28000,0,150,150,0,0,2436,2436,2436,0,4070,350,150,500,300,3126
2020,115700381,14107,4787,2787,2787,2000,9320,8500,0,0,8500,820,820,0,0,9900,9900,0,9900,2412,490,12,400,140,158
2020,115800101,900,900,400,400,500,0,0,0,0,0,0,0,0,0,4930,4930,0,3380,1945,540,150,120,75,214
2020,115800131,17868,1118,1118,1118,0,16750,16500,16500,0,0,250,250,0,0,0,0,0,0,834,51,50,180,120,120
2020,115800141,35301,14595,14595,14595,0,20706,19000,19000,0,0,1706,1000,706,0,167,167,0,0,5284,360,420,730,204,52
2020,115800151,14200,200,200,200,0,14000,12000,12000,0,0,2000,500,1500,0,0,0,0,0,991,160,50,50,108,35
2020,115800171,38396,7396,3896,3896,3500,31000,20000,0,20000,0,11000,2000,0,9000,9700,9700,6900,200,1757,180,240,300,87,29
2020,115800191,464800,112800,112800,112800,0,352000,350000,120000,230000,0,2000,2000,0,0,5000,0,0,0,2530,480,500,300,200,1163
2020,115800301,29340,1340,1340,1340,0,28000,28000,28000,0,0,0,0,0,0,580,580,580,0,830,130,180,60,80,22
2020,115800321,89326,21026,21026,21026,0,68300,68000,68000,0,0,300,100,200,0,0,0,0,0,2512,370,200,450,92,155
2020,115800351,17035,17035,35,35,17000,0,0,0,0,0,0,0,0,0,5896,5896,5896,0,1610,200,60,110,150,106
2020,115800371,23630,5880,5880,5880,0,17750,17500,17500,0,0,250,250,0,0,10488,10488,10488,0,2738,220,8,380,360,100
2020,115900101,26894,4294,4294,1774,0,22600,18000,18000,0,0,4600,4400,200,0,6520,6520,3000,0,4201,570,170,240,330,511
2020,115900141,10452,10452,2452,2452,8000,0,0,0,0,0,0,0,0,0,0,0,0,0,930,96,20,96,72,96
2020,115900151,16747,16547,1547,1547,15000,200,0,0,0,0,200,200,0,0,2868,2868,2868,0,2529,120,1400,84,72,38
2020,115900171,2930,2930,1030,1030,1900,0,0,0,0,0,0,0,0,0,1000,1000,1000,0,1194,120,200,84,120,1
2020,115900181,11448,11448,8300,8300,3148,0,0,0,0,0,0,0,0,0,0,0,0,0,518,120,50,18,0,12
2020,115900191,20370,270,270,270,0,20100,20000,20000,0,0,100,100,0,0,5000,5000,5000,0,1200,60,400,150,120,136
2020,115900311,30472,2372,2372,2372,0,28100,26000,26000,0,0,2100,2100,0,0,0,0,0,0,3360,450,100,500,360,234
2020,115900321,27000,150,150,150,0,26850,26000,26000,0,0,850,850,0,0,1344,1344,1200,0,1085,200,60,120,60,68
2020,115900371,32686,28286,14486,14486,13800,4400,4400,0,0,4400,0,0,0,0,9000,9000,0,9000,1657,132,300,60,180,21
2020,115900381,30600,19600,5600,5600,14000,11000,9000,0,0,9000,2000,2000,0,0,12000,12000,0,12000,2306,456,10,540,84,781
2020,116000102,27026,1800,1800,1800,0,25226,25000,25000,0,0,226,0,226,0,0,0,0,0,1736,240,500,120,96,106
2020,116000112,11096,8596,4596,4596,4000,2500,0,0,0,0,2500,2500,0,0,0,0,0,0,1928,418,10,480,180,198
2020,116000122,70000,2000,2000,2000,0,68000,68000,40000,28000,0,0,0,0,0,29500,16000,16000,0,1416,156,46,36,72,111
2020,116000132,26830,3630,3630,3630,0,23200,23000,23000,0,0,200,0,200,0,30,30,0,0,904,276,100,36,84,51
2020,116000142,42395,3495,3495,3495,0,38900,38900,38900,0,0,0,0,0,0,11900,11900,11900,0,2670,296,27,225,42,47
2020,116000172,61578,11578,3578,3078,8000,50000,50000,0,50000,0,0,0,0,0,21500,16500,16000,0,1505,50,50,60,120,106
2020,116000182,31602,31452,4452,4452,27000,150,0,0,0,0,150,100,50,0,20033,20033,20000,0,1226,144,10,180,72,20
2020,116000192,88140,6640,6640,6640,0,81500,80000,80000,0,0,1500,1500,0,0,2000,2000,2000,0,4450,450,360,500,420,162
2020,116000302,53728,6050,6050,2550,0,47678,35000,35000,0,0,12678,0,2678,10000,14070,14070,12000,2000,1956,276,180,180,168,99
2020,116000312,1971,1471,1071,1071,400,500,0,0,0,0,500,500,0,0,1700,1700,0,1100,2264,120,0,400,144,16
2020,116000322,72865,365,365,365,0,72500,70000,70000,0,0,2500,2500,0,0,25000,25000,25000,0,4490,300,100,800,300,190
2020,116000332,54900,8600,8600,8600,0,46300,46000,46000,0,0,300,300,0,0,0,0,0,0,1778,426,50,156,96,176
2020,116000342,19920,19920,2920,2920,17000,0,0,0,0,0,0,0,0,0,0,0,0,0,2312,252,20,120,120,1
2020,116000352,73680,17680,17680,17680,0,56000,56000,56000,0,0,0,0,0,0,0,0,0,0,2772,240,30,120,48,117
2020,116000392,12410,10010,10010,10010,0,2400,2400,2400,0,0,0,0,0,0,0,0,0,0,420,112,133,25,30,60
2020,116600121,64376,1376,1376,1376,0,63000,63000,63000,0,0,0,0,0,0,12800,800,0,0,2347,377,301,10,122,104
2020,116600131,11836,11836,3336,3336,8500,0,0,0,0,0,0,0,0,0,4500,4500,4500,0,1180,111,25,120,91,16
2020,116600141,16226,12426,3926,626,8500,3800,0,0,0,0,3800,800,3000,0,4440,4440,3940,500,3192,456,24,624,216,9
2020,116600181,113500,2300,2300,2300,0,111200,110000,110000,0,0,1200,1200,0,0,47640,47640,47640,0,4902,1300,120,180,132,268
2020,116600311,48070,270,270,270,0,47800,47000,47000,0,0,800,800,0,0,17000,17000,15000,0,2550,500,100,200,100,103
2020,116600321,28100,1800,1800,1800,0,26300,19000,19000,0,0,7300,1300,6000,0,450,450,0,0,1284,360,30,20,84,201
2020,116600361,274410,27584,27584,27584,0,246826,245000,40000,205000,0,1826,1600,226,0,1000,0,0,0,5650,600,500,400,250,2060
2020,116600371,38500,7000,7000,7000,0,31500,30000,30000,0,0,1500,1500,0,0,0,0,0,0,1841,180,21,360,120,419
2020,116600381,54313,15400,15400,10400,0,38913,30000,30000,0,0,8913,2400,6113,400,4350,4350,4350,0,4706,240,500,600,300,224
2020,116600391,14800,100,100,100,0,14700,13500,12000,1500,0,1200,1200,0,0,0,0,0,0,2000,240,100,280,82,151
2020,116700101,5100,5100,3100,3100,2000,0,0,0,0,0,0,0,0,0,1570,1570,1000,500,800,180,100,80,70,1
2020,116700111,8670,7970,4870,4870,3100,700,0,0,0,0,700,700,0,0,5000,5000,5000,0,1978,264,220,180,144,8
2020,116700121,7740,7740,1740,1740,6000,0,0,0,0,0,0,0,0,0,0,0,0,0,1284,120,50,90,60,12
2020,116700131,71294,13794,13794,11794,0,57500,52000,50000,2000,0,5500,500,0,5000,27500,27500,20000,7500,3384,276,320,300,360,278
2020,116700161,26149,1749,749,749,1000,24400,23000,0,23000,0,1400,1400,0,0,12200,5200,5200,0,3764,600,50,420,144,128
2020,116700311,323258,11458,11458,11458,0,311800,310000,80000,60000,170000,1800,1800,0,0,37500,37500,0,37500,2860,360,120,240,240,105
2020,116700321,100440,9940,9940,9940,0,90500,90000,80000,10000,0,500,500,0,0,0,0,0,0,1180,240,30,60,30,91
2020,116700351,52580,4380,4380,4380,0,48200,47000,47000,0,0,1200,1200,0,0,22600,22600,0,600,8300,500,300,600,400,220
2020,116800131,122030,2035,2035,2035,0,119995,115000,115000,0,0,4995,3300,1695,0,19800,19800,19800,0,6892,360,400,600,192,2032
2020,116800171,132250,30450,30450,30450,0,101800,100000,100000,0,0,1800,1800,0,0,25505,5,0,0,4380,310,190,200,400,646
2020,116800191,226278,75928,33928,13928,42000,150350,150000,0,150000,0,350,350,0,0,93140,61140,47400,13740,6470,450,450,200,240,858
2020,116800301,24850,5150,5150,5150,0,19700,17700,17700,0,0,2000,2000,0,0,42,42,0,0,2690,240,120,320,200,98
2020,116800311,17613,13,13,13,0,17600,17000,17000,0,0,600,600,0,0,9992,9992,492,0,2720,240,100,350,270,48
2020,116800331,135000,134000,69000,69000,65000,1000,0,0,0,0,1000,1000,0,0,0,0,0,0,6960,720,600,240,240,5987
2020,116800341,111393,4613,4613,4613,0,106780,106000,6000,100000,0,780,60,720,0,3000,3000,3000,0,1375,348,168,240,38,167
2020,116800351,2780,2780,180,180,2600,0,0,0,0,0,0,0,0,0,2000,2000,2000,0,1006,288,42,72,36,285
2020,116800361,38930,3930,3930,3930,0,35000,33500,33500,0,0,1500,1500,0,0,7240,7240,7160,0,4697,240,610,480,300,110
2020,116800371,49130,31330,10330,7330,21000,17800,0,0,0,0,17800,2000,1800,14000,15120,15120,15000,0,3634,380,20,336,240,405
2020,116800381,89630,7330,7330,5830,0,82300,76000,40000,36000,0,6300,6300,0,0,80700,80700,80000,700,5170,360,60,600,480,251
2020,116900101,16222,16222,1222,1222,15000,0,0,0,0,0,0,0,0,0,8600,8600,8600,0,1515,181,2,180,180,28
2020,116900121,152,152,10,10,142,0,0,0,0,0,0,0,0,0,0,0,0,0,834,132,180,60,27,1
2020,116900131,43640,250,250,250,0,43390,43000,43000,0,0,390,360,30,0,0,0,0,0,1249,264,180,36,37,75
2020,116900151,908,8,8,8,0,900,0,0,0,0,900,900,0,0,0,0,0,0,1451,296,40,75,180,62
2020,116900191,37700,35200,10200,10200,25000,2500,0,0,0,0,2500,2500,0,0,0,0,0,0,4170,420,50,180,180,305
2020,116900311,17180,3580,580,580,3000,13600,0,0,0,0,13600,1600,0,12000,1700,1700,900,800,4058,648,200,60,360,47
2020,116900321,24855,23455,5455,5455,18000,1400,0,0,0,0,1400,1400,0,0,17440,17440,14400,3040,2960,200,150,400,160,837
2020,116900331,34310,2310,2310,2310,0,32000,27000,27000,0,0,5000,5000,0,0,16570,16570,14000,2500,3850,324,320,240,312,306
2020,116900351,94850,850,850,850,0,94000,92000,55000,37000,0,2000,2000,0,0,33000,12000,12000,0,5400,360,200,360,240,362
2020,116900381,84300,4100,4100,4100,0,80200,80000,80000,0,0,200,0,200,0,250,250,0,0,2892,516,860,100,96,96
2020,117000102,60906,46906,8906,8906,38000,14000,11800,0,0,11800,2200,2200,0,0,200,200,0,200,3480,200,100,150,180,159
2020,117000112,81210,58210,46210,46210,12000,23000,23000,0,20000,3000,0,0,0,0,10000,0,0,0,2058,140,30,200,168,269
2020,117000142,159000,4000,4000,4000,0,155000,155000,140000,15000,0,0,0,0,0,2000,0,0,0,2140,600,100,50,30,222
2020,117000152,62316,7216,7216,7216,0,55100,55000,55000,0,0,100,100,0,0,0,0,0,0,5080,180,1300,500,200,392
2020,117000302,231682,24452,24452,24452,0,207230,194030,6530,187500,0,13200,6200,7000,0,0,0,0,0,3109,360,1500,219,120,262
2020,117000322,42250,1800,1800,1800,0,40450,37000,37000,0,0,3450,2850,600,0,17200,17200,15200,2000,4909,240,3,216,240,519
2020,117000332,14887,1887,1887,1887,0,13000,13000,13000,0,0,0,0,0,0,700,700,0,700,1054,300,60,10,48,9
2020,117000372,33699,2399,2399,2399,0,31300,31000,31000,0,0,300,300,0,0,16560,16560,14360,0,2099,300,15,240,144,56
2020,117000382,45900,1300,1300,1300,0,44600,43000,43000,0,0,1600,1600,0,0,0,0,0,0,3800,300,0,100,100,129
2020,117600101,80400,5400,5400,5400,0,75000,75000,75000,0,0,0,0,0,0,0,0,0,0,1860,240,60,24,42,60
2020,117600131,242600,62600,62600,62600,0,180000,180000,100000,80000,0,0,0,0,0,9500,0,0,0,3870,420,700,60,240,987
2020,117600141,8511,8511,1511,1511,7000,0,0,0,0,0,0,0,0,0,200,200,0,0,3100,360,200,384,276,25
2020,117600301,134511,16811,16811,16811,0,117700,117000,85000,32000,0,700,700,0,0,4970,4970,4970,0,5886,240,160,200,192,672
2020,117600341,2230,2230,630,630,1600,0,0,0,0,0,0,0,0,0,0,0,0,0,1560,180,400,100,30,1
2020,117600351,68800,5200,5200,5200,0,63600,60000,20000,40000,0,3600,3600,0,0,3000,3000,3000,0,4470,400,120,150,420,997
2020,117600361,30230,8530,5530,5530,3000,21700,20000,0,20000,0,1700,1700,0,0,0,0,0,0,3288,300,60,900,108,289
2020,117700101,49380,7080,7080,7080,0,42300,41000,41000,0,0,1300,1300,0,0,17000,17000,17000,0,2160,240,20,250,100,1017
2020,117700131,1049,1049,649,649,400,0,0,0,0,0,0,0,0,0,400,400,0,0,514,120,10,24,48,1
2020,117700141,9460,9460,1960,1960,7500,0,0,0,0,0,0,0,0,0,0,0,0,0,1998,132,12,56,216,18
2020,117700151,13410,410,410,410,0,13000,12600,12600,0,0,400,400,0,0,60,60,0,0,2562,228,180,340,180,71
2020,117700311,363360,117560,117560,117560,0,245800,244800,82000,162800,0,1000,0,1000,0,0,0,0,0,3050,480,1010,50,360,4538
2020,117700321,4259,3074,2074,2074,1000,1185,0,0,0,0,1185,1185,0,0,470,470,90,0,2972,960,50,300,180,71
2020,117700331,12200,4100,4100,4100,0,8100,8000,8000,0,0,100,100,0,0,4416,4416,3916,500,2026,180,0,300,156,63
2020,117700341,22327,3977,3977,3677,0,18350,16000,13000,3000,0,2350,1900,450,0,300,300,0,300,2956,860,180,500,216,47
2020,117700351,73486,13486,13486,13486,0,60000,60000,60000,0,0,0,0,0,0,15400,15400,15400,0,3762,204,100,300,108,1818
2020,117700361,28624,5624,5624,1524,0,23000,20500,20500,0,0,2500,2500,0,0,14040,14040,0,14040,1794,180,120,120,84,1058
2020,117700371,53500,6500,6500,6500,0,47000,44000,44000,0,0,3000,3000,0,0,33850,33850,27000,6350,5400,680,800,500,360,481
2020,117700381,76592,18392,18392,18392,0,58200,50000,50000,0,0,8200,3400,4800,0,25000,25000,25000,0,3530,300,50,200,240,590
2020,117700391,23685,1610,1610,1610,0,22075,21000,0,0,21000,1075,550,525,0,33000,33000,0,33000,3306,288,84,360,240,31
2020,117800111,56200,55700,6700,6700,49000,500,0,0,0,0,500,500,0,0,0,0,0,0,2050,300,150,100,100,814
2020,117800151,61500,60000,4000,4000,56000,1500,0,0,0,0,1500,1500,0,0,4900,4900,4900,0,3960,360,360,120,120,1124
2020,117800161,512556,11556,11556,11556,0,501000,499000,180000,319000,0,2000,2000,0,0,203889,103889,97589,6300,3940,400,150,220,220,1707
2020,117800171,10250,10250,250,250,10000,0,0,0,0,0,0,0,0,0,0,0,0,0,1786,426,384,12,24,1
2020,117800301,59230,3730,3730,3730,0,55500,50500,20500,30000,0,5000,4500,500,0,6292,6292,4128,2000,3200,480,240,300,290,1646
2020,117800331,56860,8060,8060,8060,0,48800,42000,12000,30000,0,6800,2800,0,4000,15300,15300,12000,3300,1770,240,20,240,300,154
2020,117800351,12198,2198,2198,2198,0,10000,10000,10000,0,0,0,0,0,0,0,0,0,0,1317,240,60,84,61,13
2020,117800371,18448,3380,3380,3380,0,15068,15000,15000,0,0,68,0,68,0,2000,0,0,0,829,82,510,20,46,15
2020,117800391,1659,1546,1546,1546,0,113,0,0,0,0,113,0,113,0,5500,5500,0,0,767,202,24,15,36,1
2020,117900101,88531,17031,17031,17031,0,71500,70000,70000,0,0,1500,1500,0,0,1832,1832,1832,0,4320,480,240,240,120,508
2020,117900111,104500,35500,35500,35500,0,69000,67000,67000,0,0,2000,2000,0,0,80,80,0,0,1740,240,10,300,120,195
2020,117900121,63210,12710,11410,5410,1300,50500,49000,0,49000,0,1500,1500,0,0,29000,2000,0,550,4110,400,120,150,80,289
2020,117900151,7000,7000,6000,6000,1000,0,0,0,0,0,0,0,0,0,0,0,0,0,1091,360,5,144,108,31
2020,117900161,1038,1038,788,788,250,0,0,0,0,0,0,0,0,0,500,500,0,500,2347,180,24,132,204,0
2020,117900171,191720,17220,17220,17220,0,174500,170000,90000,80000,0,4500,4000,500,0,42000,9000,7000,2000,7710,500,50,200,360,1436
2020,117900301,21458,3778,3778,3778,0,17680,16000,16000,0,0,1680,1680,0,0,7521,7521,7521,0,2983,360,80,495,240,60
2020,117900311,40496,6590,6590,6590,0,33906,30000,15000,15000,0,3906,3680,226,0,23700,11200,7700,0,3160,240,120,170,180,39
2020,117900321,19420,620,620,620,0,18800,16000,16000,0,0,2800,2800,0,0,13033,13033,8700,500,930,110,40,230,120,156
2020,117900341,35940,40,40,40,0,35900,35000,35000,0,0,900,900,0,0,0,0,0,0,1008,360,10,120,48,1409
2020,117900351,74750,5750,5750,5250,0,69000,65000,50000,15000,0,4000,3300,700,0,41500,27500,27500,0,1622,420,185,75,120,168
2020,117900361,730,80,80,80,0,650,0,0,0,0,650,650,0,0,0,0,0,0,1306,384,240,120,72,1
2020,117900371,27479,3097,3097,3097,0,24382,22000,22000,0,0,2382,2156,226,0,9300,9300,9100,0,4060,360,200,240,260,972
2020,117900391,68310,210,210,210,0,68100,67000,32000,35000,0,1100,1100,0,0,9000,8000,0,8000,3840,180,600,390,130,1104
2020,118000102,16400,400,400,400,0,16000,16000,16000,0,0,0,0,0,0,0,0,0,0,890,120,0,80,60,22
2020,118000112,8600,2100,2100,2000,0,6500,6500,6500,0,0,0,0,0,0,0,0,0,0,819,65,20,90,48,44
2020,118000132,10900,5900,900,900,5000,5000,1000,0,1000,0,4000,4000,0,0,100,100,0,0,3624,600,12,480,240,101
2020,118000302,5320,5320,3320,3320,2000,0,0,0,0,0,0,0,0,0,0,0,0,0,820,320,130,20,30,12
2020,118000322,23956,956,956,956,0,23000,21500,17000,4500,0,1500,1000,500,0,6350,2750,0,0,2364,264,60,360,180,34
2020,118000332,60808,13158,13158,13158,0,47650,46600,5000,41600,0,1050,900,150,0,0,0,0,0,2950,201,630,500,156,107
2020,118000342,14118,3118,3118,3118,0,11000,11000,9000,2000,0,0,0,0,0,0,0,0,0,1800,120,25,17,108,14
2020,118600131,125430,122430,57430,42430,65000,3000,0,0,0,0,3000,3000,0,0,25000,25000,0,25000,10440,1800,120,480,360,15559
2020,118600161,216000,61000,61000,41000,0,155000,155000,130000,25000,0,0,0,0,0,29000,14000,14000,0,945,250,30,15,20,290
2020,118600301,53470,29270,3270,3270,26000,24200,21000,0,21000,0,3200,3200,0,0,28000,28000,28000,0,2500,360,50,100,20,688
2020,118600321,10214,2324,2324,2324,0,7890,7000,7000,0,0,890,890,0,0,3200,3200,3200,0,3476,216,120,600,460,100
2020,118600331,22056,17556,5556,5556,12000,4500,0,0,0,0,4500,4500,0,0,4770,4770,4200,0,5940,400,200,400,300,871
2020,118600341,13820,5520,5520,4520,0,8300,8000,8000,0,0,300,0,300,0,0,0,0,0,750,108,35,20,12,9
2020,118700101,1210,1210,210,210,1000,0,0,0,0,0,0,0,0,0,4786,4786,0,4775,3412,672,20,120,180,73
2020,118700121,746400,168200,168200,168200,0,578200,560000,260000,300000,0,18200,2700,15500,0,104000,59000,59000,0,6430,500,120,560,240,3852
2020,118700151,816080,69080,69080,59080,0,747000,707000,320000,387000,0,40000,0,40000,0,8170,0,0,0,5824,960,600,124,180,2415
2020,118700171,85875,34875,8375,8375,26500,51000,50900,0,50900,0,100,100,0,0,50200,17200,16200,1000,6830,360,2000,120,240,81
2020,118700311,124780,24780,780,780,24000,100000,100000,0,100000,0,0,0,0,0,43200,19200,19200,0,1494,480,85,15,54,101
2020,118700321,180234,25234,25234,23234,0,155000,146000,26000,120000,0,9000,1000,8000,0,20280,20280,20280,0,6575,600,115,1000,480,255
2020,118700331,54058,20232,20232,15232,0,33826,31830,31500,0,330,1996,1770,226,0,5500,5500,3000,2500,3120,360,60,600,120,323
2020,118700361,7103,4603,3163,3163,1440,2500,0,0,0,0,2500,2500,0,0,0,0,0,0,2014,460,10,300,84,61
2020,118800111,45174,1274,1274,1274,0,43900,41000,27000,14000,0,2900,1100,1800,0,7360,7360,7000,0,2405,184,5,880,240,63
2020,118800121,69600,28600,23600,23600,5000,41000,40000,0,0,40000,1000,1000,0,0,8000,8000,0,8000,5463,4000,3,400,100,3445
2020,118800151,25650,200,200,200,0,25450,25000,25000,0,0,450,450,0,0,3000,3000,0,0,1844,120,180,100,144,44
2020,118800181,96779,30529,3529,3529,27000,66250,65700,0,52700,13000,550,550,0,0,19206,19206,19000,206,3600,120,20,204,288,193
2020,118800301,28660,660,660,660,0,28000,28000,28000,0,0,0,0,0,0,35100,35100,20000,15000,3844,324,50,180,240,129
2020,118900101,32000,11500,8500,6500,3000,20500,0,0,0,0,20500,500,0,20000,0,0,0,0,2500,180,30,400,120,52
2020,118900111,214100,13400,13400,13400,0,200700,200000,170000,30000,0,700,700,0,0,2000,0,0,0,2903,300,350,450,100,1174
2020,118900121,3210,3150,150,150,3000,60,0,0,0,0,60,60,0,0,0,0,0,0,3892,1380,30,108,198,31
2020,118900141,3000,3000,500,500,2500,0,0,0,0,0,0,0,0,0,0,0,0,0,475,120,120,10,15,1
2020,118900171,18200,17600,2100,2100,15500,600,0,0,0,0,600,600,0,0,0,0,0,0,4128,230,30,130,188,165
2020,118900191,65340,2960,2960,2960,0,62380,62000,62000,0,0,380,180,200,0,4500,4500,4000,500,2400,324,108,240,180,124
2020,118900301,10332,232,232,232,0,10100,10000,10000,0,0,100,100,0,0,0,0,0,0,1900,120,100,120,240,18
2020,118900311,14976,1226,1226,1226,0,13750,13500,13500,0,0,250,250,0,0,3000,3000,3000,0,1431,120,36,300,120,19
2020,118900321,36527,5027,5027,5027,0,31500,28500,20000,8000,500,3000,3000,0,0,2000,2000,2000,0,1300,180,50,230,60,84
2020,119000102,145600,52600,52600,52600,0,93000,90000,90000,0,0,3000,3000,0,0,0,0,0,0,4520,300,1000,500,350,220
2020,119000112,89500,3900,3900,3900,0,85600,85000,85000,0,0,600,500,100,0,33700,33700,28700,5000,6820,480,600,600,240,1483
2020,119000132,247150,35150,35150,35150,0,212000,210000,210000,0,0,2000,2000,0,0,0,0,0,0,5584,360,100,480,204,1897
2020,119000182,2260,2260,2260,1560,0,0,0,0,0,0,0,0,0,0,700,700,0,700,2530,0,10,50,60,1
2020,119000192,40950,2650,2650,2650,0,38300,36500,35000,0,1500,1800,1800,0,0,0,0,0,0,2510,210,200,240,240,103
2020,119700171,167812,7360,7360,7360,0,160452,160000,140000,20000,0,452,0,452,0,1000,0,0,0,1924,360,10,84,120,353
2020,119700181,8386,8236,236,236,8000,150,0,0,0,0,150,0,150,0,200,200,200,0,2880,240,120,140,300,44
2020,119700191,1280,1280,980,980,300,0,0,0,0,0,0,0,0,0,1060,1060,0,0,830,320,30,100,70,75
2020,119700301,74851,10611,10611,10611,0,64240,64000,45000,19000,0,240,240,0,0,26508,24508,19400,5000,4451,305,503,611,122,439
2020,119800111,78800,3000,3000,3000,0,75800,75000,75000,0,0,800,800,0,0,0,0,0,0,1160,360,100,150,120,136
2020,119800131,9450,9450,1450,1450,8000,0,0,0,0,0,0,0,0,0,0,0,0,0,2196,396,300,180,120,3
2020,119800151,5310,4810,1810,810,3000,500,0,0,0,0,500,0,0,500,0,0,0,0,1760,564,100,100,96,230
2020,119800181,23856,22446,2446,2446,20000,1410,0,0,0,0,1410,1410,0,0,17800,17800,16000,1800,3700,360,120,360,240,50
2020,119900121,224160,58360,48360,42360,10000,165800,157000,0,157000,0,8800,2800,0,6000,45960,30960,30960,0,8460,2040,50,480,480,1849
2020,119900131,2630,130,130,130,0,2500,0,0,0,0,2500,2500,0,0,0,0,0,0,1168,360,5,360,72,120
2020,119900151,3872,2172,1672,1672,500,1700,0,0,0,0,1700,1700,0,0,1600,1600,0,0,2500,600,10,500,180,259
2020,119900161,640,640,140,140,500,0,0,0,0,0,0,0,0,0,0,0,0,0,1028,288,10,30,80,1
2020,119900171,12530,12530,2530,2530,10000,0,0,0,0,0,0,0,0,0,40,40,0,0,1620,300,50,70,50,31
2020,120000202,2120,2120,1120,1120,1000,0,0,0,0,0,0,0,0,0,0,0,0,0,1482,360,10,60,32,3
2020,120000222,13996,11796,5796,4796,6000,2200,0,0,0,0,2200,1100,100,1000,0,0,0,0,2648,142,130,480,276,40
2020,120000242,14852,8610,8610,8610,0,6242,0,0,0,0,6242,5790,452,0,0,0,0,0,4700,500,500,500,200,461
2020,120000252,36931,7981,7981,5981,0,28950,28500,28500,0,0,450,300,150,0,25577,25577,20106,4871,2100,228,120,336,216,63
2020,120000262,9720,9620,120,120,9500,100,0,0,0,0,100,100,0,0,120,120,0,120,1800,240,10,180,150,21
2020,120000272,279,279,89,89,190,0,0,0,0,0,0,0,0,0,0,0,0,0,1648,104,20,60,73,2
2020,120000302,3205,3205,1205,1205,2000,0,0,0,0,0,0,0,0,0,0,0,0,0,1030,408,5,72,60,1
2020,120000322,28000,4500,4500,4500,0,23500,20000,20000,0,0,3500,3500,0,0,10150,10150,8000,2000,3570,300,50,150,360,99
2020,120000332,29240,9240,9240,9240,0,20000,16000,16000,0,0,4000,4000,0,0,0,0,0,0,2084,360,60,360,204,69
2020,120000342,30175,12810,12810,9810,0,17365,17000,17000,0,0,365,365,0,0,14004,14004,9954,4000,2430,230,100,180,120,207
2020,120000352,4895,4700,200,200,4500,195,0,0,0,0,195,195,0,0,300,300,0,300,1340,90,50,300,60,27
2020,120000362,117600,400,400,400,0,117200,115000,15000,100000,0,2200,2000,200,0,55000,55000,44000,11000,2145,15,720,276,144,97
2020,120000372,150,150,150,150,0,0,0,0,0,0,0,0,0,0,0,0,0,0,1380,444,200,30,60,2
2020,120600211,36100,13100,13100,13100,0,23000,21500,17500,4000,0,1500,1000,500,0,0,0,0,0,1388,200,150,84,60,49
2020,120600221,19540,4490,4490,4490,0,15050,15000,15000,0,0,50,50,0,0,0,0,0,0,1230,120,150,90,100,63
2020,120600231,16220,1140,1140,1140,0,15080,15000,15000,0,0,80,0,80,0,25,25,0,0,1460,100,180,30,120,13
2020,120600261,96748,192,192,192,0,96556,96500,26500,70000,0,56,56,0,0,54800,39000,39000,0,2190,200,500,120,180,135
2020,120600271,2180,120,120,120,0,2060,2000,0,2000,0,60,0,60,0,0,0,0,0,1346,280,150,110,36,3
2020,120600311,28680,12350,12350,12350,0,16330,16000,16000,0,0,330,330,0,0,0,0,0,0,2572,300,560,480,132,97
2020,120600321,34035,3535,3535,3535,0,30500,24000,24000,0,0,6500,6500,0,0,2500,2500,0,2500,4934,480,120,300,276,1211
2020,120600381,20808,3068,3068,3068,0,17740,15130,8500,6630,0,2610,2000,610,0,595,595,80,200,1122,135,60,367,120,15
2020,120700231,63810,7160,7160,7160,0,56650,54000,21000,33000,0,2650,2650,0,0,16250,16250,16250,0,4400,240,100,200,360,409
2020,120700241,335,335,35,35,300,0,0,0,0,0,0,0,0,0,170,170,0,0,1632,384,40,120,108,1
2020,120700251,550,550,250,250,300,0,0,0,0,0,0,0,0,0,0,0,0,0,1133,396,1,36,84,9
2020,120700261,18750,15700,5700,5700,10000,3050,3000,0,3000,0,50,0,50,0,0,0,0,0,1565,120,110,30,25,21
2020,120700271,3550,3550,1550,1550,2000,0,0,0,0,0,0,0,0,0,2520,2520,0,2520,2432,480,10,180,174,1
2020,120700291,35260,10460,10460,10460,0,24800,24000,24000,0,0,800,800,0,0,0,0,0,0,4810,360,300,300,150,158
2020,120700311,123962,2512,2512,2512,0,121450,121000,11000,110000,0,450,150,300,0,60050,60050,60000,0,1034,240,120,120,84,27
2020,120700331,44038,5748,5748,5748,0,38290,35290,27000,5000,3290,3000,2900,100,0,21900,21900,4400,17500,3290,240,90,300,156,494
2020,120700341,48358,14608,14608,14608,0,33750,27900,27900,0,0,5850,5850,0,0,2311,2311,0,0,5180,240,60,360,240,2430
2020,120700361,1650,1380,880,880,500,270,0,0,0,0,270,250,20,0,100,100,0,0,2926,660,10,360,300,51
2020,120700371,43798,7848,7848,7848,0,35950,35500,0,35500,0,450,450,0,0,13993,3993,1804,2000,3332,240,100,180,240,540
2020,120700381,60260,8860,8860,8860,0,51400,51000,18000,33000,0,400,400,0,0,20500,10000,10000,0,4285,300,155,110,120,460
2020,120800201,13900,0,0,0,0,13900,13000,0,13000,0,900,900,0,0,11280,1280,0,1200,1247,100,70,180,240,55
2020,120800221,25,25,25,25,0,0,0,0,0,0,0,0,0,0,0,0,0,0,687,280,50,20,40,1
2020,120800231,15069,5569,5569,5569,0,9500,7000,7000,0,0,2500,2500,0,0,960,960,660,0,2030,360,100,280,240,82
2020,120800241,22172,10772,10772,10772,0,11400,10000,10000,0,0,1400,1300,100,0,55,55,0,0,2300,370,30,300,240,49
2020,120800261,36176,6476,6476,6476,0,29700,27000,27000,0,0,2700,2200,500,0,2470,2470,1900,0,1812,192,120,60,180,43
2020,120800271,27659,7459,7459,7459,0,20200,20000,20000,0,0,200,200,0,0,800,800,710,0,2270,200,10,150,200,55
2020,120800291,2235,2235,235,235,2000,0,0,0,0,0,0,0,0,0,0,0,0,0,598,350,15,16,24,1
2020,120800301,31720,19780,19780,19780,0,11940,10500,4500,6000,0,1440,1200,240,0,0,0,0,0,2845,304,1200,100,96,176
2020,120800311,14541,3194,3194,3194,0,11347,10000,10000,0,0,1347,1000,347,0,0,0,0,0,1908,240,36,300,156,57
2020,120800321,20860,4060,4060,2060,0,16800,13000,13000,0,0,3800,3800,0,0,14000,14000,10150,0,3000,250,150,200,250,65
2020,120800341,2338,1538,1538,1538,0,800,0,0,0,0,800,800,0,0,0,0,0,0,2094,300,60,240,144,76
2020,120800351,61676,3676,3676,3676,0,58000,58000,50000,8000,0,0,0,0,0,38330,31030,30000,1000,950,150,50,12,72,83
2020,120800361,18975,1960,1960,1960,0,17015,17000,17000,0,0,15,15,0,0,0,0,0,0,1200,204,100,120,108,31
2020,120800371,65,50,50,50,0,15,0,0,0,0,15,15,0,0,0,0,0,0,1110,200,240,120,96,31
2020,120900201,17910,3180,3180,3180,0,14730,10000,10000,0,0,4730,400,130,4200,0,0,0,0,3130,120,2120,20,60,15
2020,120900211,11393,2363,2363,2363,0,9030,9000,9000,0,0,30,0,30,0,0,0,0,0,1208,160,50,12,96,11
2020,120900251,45130,8230,8230,8230,0,36900,35000,25000,10000,0,1900,1900,0,0,500,0,0,0,4000,300,800,300,180,356
2020,120900261,36660,11380,7880,7880,3500,25280,25000,0,25000,0,280,200,80,0,600,0,0,0,1660,150,50,200,60,64
2020,120900281,16455,3055,3055,3055,0,13400,13000,13000,0,0,400,400,0,0,0,0,0,0,1182,120,72,180,240,60
2020,120900291,17072,3972,3972,1672,0,13100,10000,10000,0,0,3100,100,3000,0,4000,4000,4000,0,1070,120,100,100,100,54
2020,120900311,30720,20,20,20,0,30700,30000,30000,0,0,700,0,500,200,5700,4700,4700,0,960,240,18,120,96,155
2020,120900321,13806,3206,3206,3206,0,10600,10500,10500,0,0,100,0,100,0,0,0,0,0,2544,84,168,120,192,210
2020,120900331,33100,5600,5600,5600,0,27500,25700,25700,0,0,1800,1800,0,0,5500,5500,4700,800,4086,380,300,400,156,283
2020,120900341,91640,4640,4640,4640,0,87000,84000,34000,50000,0,3000,3000,0,0,1250,0,0,0,3600,600,300,500,300,548
2020,120900351,40852,6752,6752,6752,0,34100,31800,21000,10800,0,2300,2300,0,0,500,0,0,0,5885,273,360,650,360,952
2020,120900361,29700,12200,12200,12200,0,17500,17500,14000,3500,0,0,0,0,0,0,0,0,0,1244,240,200,48,60,42
2020,120900371,10731,4931,4931,4931,0,5800,5000,5000,0,0,800,800,0,0,2487,2487,2487,0,1995,224,150,240,171,52
2020,121000202,37250,11540,11540,11540,0,25710,25000,25000,0,0,710,430,280,0,4300,4300,4000,0,2204,125,120,350,172,75
2020,121000222,24230,3980,3980,3980,0,20250,17000,15000,2000,0,3250,1200,50,2000,0,0,0,0,1275,120,240,60,72,17
2020,121000232,2118,2118,1638,1638,480,0,0,0,0,0,0,0,0,0,0,0,0,0,1398,278,60,110,72,1
2020,121000252,106800,75200,56200,56200,19000,31600,30000,0,30000,0,1600,1600,0,0,21000,0,0,0,2780,540,50,100,140,312
2020,121000292,56898,17384,17384,11384,0,39514,38500,37500,1000,0,1014,150,864,0,6900,6900,0,2800,4104,174,180,240,216,520
2020,121000302,1026,526,26,26,500,500,0,0,0,0,500,500,0,0,1300,1300,0,700,1601,240,15,180,360,26
2020,121000342,7360,5060,1560,1060,3500,2300,0,0,0,0,2300,2000,300,0,757,757,0,0,1208,264,40,120,84,2
2020,121000352,32617,13617,13617,13617,0,19000,18000,18000,0,0,1000,1000,0,0,0,0,0,0,1683,156,5,160,170,41
2020,121000362,330390,43800,43800,43800,0,286590,284000,40000,238000,6000,2590,2590,0,0,98000,3000,3000,0,4500,180,30,240,360,608
2020,121000372,500,500,500,500,0,0,0,0,0,0,0,0,0,0,0,0,0,0,494,110,48,12,24,1
2020,121000382,230,230,30,30,200,0,0,0,0,0,0,0,0,0,0,0,0,0,931,336,10,10,30,0
2020,121000392,10380,380,380,380,0,10000,10000,10000,0,0,0,0,0,0,0,0,0,0,1646,180,120,120,96,36
2020,121600201,46480,6220,4720,4720,1500,40260,36500,0,19000,17500,3760,3760,0,0,21800,21800,15100,2000,5360,2040,130,630,250,113
2020,121600251,55559,9359,9359,9359,0,46200,45500,15500,30000,0,700,700,0,0,10130,10130,10130,0,2590,660,100,300,180,140
2020,121600271,54520,20720,8720,6720,12000,33800,25000,0,25000,0,8800,3300,500,5000,21500,0,0,0,3480,250,120,470,420,136
2020,121600311,13984,484,484,484,0,13500,11000,11000,0,0,2500,2500,0,0,11920,11920,7394,1286,1755,360,8,142,171,97
2020,121600321,38836,9136,9136,9136,0,29700,25000,25000,0,0,4700,4700,0,0,8000,8000,8000,0,2210,400,10,200,100,316
2020,121600341,17260,1560,1560,1560,0,15700,15500,9000,6500,0,200,200,0,0,0,0,0,0,1146,130,70,50,36,56
2020,121600361,18748,11548,11548,11548,0,7200,7200,7200,0,0,0,0,0,0,0,0,0,0,988,128,10,10,60,29
2020,121600371,12672,1072,772,772,300,11600,0,0,0,0,11600,11600,0,0,11370,11370,0,220,1425,532,5,110,120,104
2020,121600381,31520,5240,5240,2360,0,26280,26000,11000,15000,0,280,280,0,0,3000,3000,0,3000,1776,220,60,210,60,132
2020,121700221,37485,17685,17685,7685,0,19800,17000,17000,0,0,2800,800,2000,0,0,0,0,0,2111,200,30,172,130,140
2020,121700231,34870,2620,2620,2620,0,32250,32000,32000,0,0,250,250,0,0,300,0,0,0,2702,320,180,250,182,86
2020,121700251,90474,9574,9574,9574,0,80900,80000,80000,0,0,900,660,240,0,16505,16505,14795,1500,2730,450,100,600,180,111
2020,121700261,56810,13820,13820,13820,0,42990,40000,20000,20000,0,2990,2600,390,0,1000,0,0,0,5305,630,300,500,350,167
2020,121700271,8284,8204,7204,7204,1000,80,0,0,0,0,80,80,0,0,0,0,0,0,3350,600,60,400,200,68
2020,121700281,53856,9730,8730,4230,1000,44126,37000,0,37000,0,7126,5000,2126,0,31500,7500,0,5000,2890,1200,60,240,240,126
2020,121700331,11750,2250,2250,2250,0,9500,9500,6000,3500,0,0,0,0,0,0,0,0,0,450,104,120,10,36,6
2020,121700341,15193,5804,5804,5804,0,9389,9000,9000,0,0,389,50,339,0,0,0,0,0,1622,189,30,192,96,80
2020,121700351,500,500,500,500,0,0,0,0,0,0,0,0,0,0,0,0,0,0,436,176,40,24,36,1
2020,121700361,14448,7058,7058,7058,0,7390,6000,6000,0,0,1390,150,1240,0,1020,1020,1020,0,1525,230,100,150,160,21
2020,121700371,52696,13670,13670,13670,0,39026,36000,16000,20000,0,3026,300,226,2500,200,200,0,0,2456,190,156,240,120,195
2020,121700381,26320,7168,7168,7168,0,19152,18000,13000,5000,0,1152,700,452,0,0,0,0,0,4136,425,130,398,179,61
2020,121800211,25372,15272,3272,3272,12000,10100,8000,0,8000,0,2100,2100,0,0,8880,8880,1880,3700,2790,150,0,360,360,68
2020,121800221,58179,10118,10118,10118,0,48061,46361,20000,6500,19861,1700,1400,300,0,4000,0,0,0,3900,150,150,300,300,223
2020,121800231,24075,1000,1000,1000,0,23075,23000,23000,0,0,75,0,75,0,0,0,0,0,1924,250,720,180,50,133
2020,121800241,68077,39232,15632,15632,23600,28845,28000,0,28000,0,845,800,45,0,23000,0,0,0,1805,200,250,250,150,62
2020,121800251,4094,3594,3294,2294,300,500,0,0,0,0,500,200,300,0,900,900,700,0,2535,1265,10,60,360,12
2020,121800301,4050,50,50,50,0,4000,4000,4000,0,0,0,0,0,0,0,0,0,0,743,232,144,36,36,2
2020,121800311,23452,5452,5452,5452,0,18000,18000,18000,0,0,0,0,0,0,7000,7000,7000,0,2718,238,10,240,120,168
2020,121800321,62630,7691,7691,7691,0,54939,50000,20000,30000,0,4939,1600,3339,0,10000,10000,10000,0,3730,500,200,1000,130,135
2020,121800351,55161,4161,4161,4161,0,51000,48000,8000,40000,0,3000,3000,0,0,1000,0,0,0,2235,160,420,180,79,118
2020,121800361,10678,9478,1478,1478,8000,1200,0,0,0,0,1200,1200,0,0,7350,7350,5700,0,2800,260,60,340,240,58
2020,121800371,22690,5030,5030,5030,0,17660,16600,12000,4600,0,1060,1000,60,0,0,0,0,0,4342,275,195,270,200,103
2020,121800381,8046,8046,3546,3546,4500,0,0,0,0,0,0,0,0,0,0,0,0,0,1260,60,50,50,120,117
2020,121800391,44845,44775,44775,43775,0,70,0,0,0,0,70,0,70,0,0,0,0,0,2282,320,600,200,72,378
2020,121900211,14030,2530,2530,2530,0,11500,11500,11500,0,0,0,0,0,0,0,0,0,0,1170,245,70,105,36,12
2020,121900241,1058,1008,508,508,500,50,0,0,0,0,50,0,50,0,60,60,0,0,1900,520,10,50,160,1
2020,121900281,40627,6727,6727,6727,0,33900,32000,32000,0,0,1900,1500,400,0,9500,9500,8000,1500,3450,300,100,500,200,290
2020,121900301,88324,35955,35955,35955,0,52369,49000,40000,8000,1000,3369,2530,839,0,4970,4970,4520,400,3734,180,30,744,240,609
2020,121900311,27855,3125,3125,3125,0,24730,23000,23000,0,0,1730,1230,500,0,1000,1000,1000,0,2077,203,50,200,144,172
2020,121900331,2820,2320,2020,2020,300,500,0,0,0,0,500,500,0,0,0,0,0,0,2346,372,60,130,114,48
2020,121900341,2120,120,120,120,0,2000,0,0,0,0,2000,2000,0,0,2163,2163,0,0,1315,450,15,60,150,27
2020,121900351,38092,23792,23792,23792,0,14300,13000,12000,1000,0,1300,1300,0,0,100,0,0,0,1850,120,600,100,20,115
2020,121900371,8460,210,210,210,0,8250,4500,4500,0,0,3750,3750,0,0,0,0,0,0,3639,169,540,735,168,85
2020,121900391,301,301,1,1,300,0,0,0,0,0,0,0,0,0,0,0,0,0,766,394,50,34,26,0
2020,122000202,23450,2950,2950,2950,0,20500,20400,20400,0,0,100,100,0,0,65,65,0,0,1445,228,100,150,70,45
2020,122000212,10758,10758,10658,10658,100,0,0,0,0,0,0,0,0,0,0,0,0,0,1482,360,60,12,60,172
2020,122000222,29898,4898,4898,4898,0,25000,25000,25000,0,0,0,0,0,0,300,0,0,0,1076,180,150,10,36,27
2020,122000242,72683,6265,6265,6265,0,66418,65800,29800,36000,0,618,505,113,0,37100,35100,35000,0,2527,285,15,280,158,162
2020,122000252,37065,4665,4665,4665,0,32400,27000,27000,0,0,5400,2400,0,3000,0,0,0,0,1488,276,30,100,72,231
2020,122000272,425,325,25,25,300,100,0,0,0,0,100,100,0,0,0,0,0,0,1360,204,12,50,204,21
2020,122000282,13700,1200,1200,1200,0,12500,12000,12000,0,0,500,500,0,0,7520,7520,7520,0,3800,240,80,360,360,76
2020,122000292,28488,5588,5588,5588,0,22900,14000,14000,0,0,8900,2900,0,6000,0,0,0,0,2090,220,100,250,240,262
2020,122000302,79086,18736,18736,15736,0,60350,53000,30000,23000,0,7350,2100,2500,2750,7080,7080,7000,0,2860,300,120,200,300,124
2020,122000312,17190,1290,1290,1290,0,15900,0,0,0,0,15900,900,15000,0,0,0,0,0,1575,195,175,280,95,20
2020,122000322,21055,6675,6675,6675,0,14380,3500,0,3500,0,10880,880,10000,0,5250,5250,5200,0,3372,230,30,540,336,43
2020,122000342,4400,700,700,700,0,3700,2300,500,1800,0,1400,0,1400,0,0,0,0,0,370,120,70,10,40,3
2020,122000352,35033,7543,7543,7543,0,27490,27240,0,27240,0,250,250,0,0,0,0,0,0,1562,228,56,368,158,183
2020,122000362,383,33,33,33,0,350,0,0,0,0,350,350,0,0,0,0,0,0,1121,120,156,70,0,1
2020,122600211,191494,89274,89274,78274,0,102220,100000,100000,0,0,2220,2100,120,0,0,0,0,0,5440,400,300,400,240,1091
2020,122600221,2540,2540,40,40,2500,0,0,0,0,0,0,0,0,0,0,0,0,0,546,60,60,50,36,1
2020,122600231,26764,6164,6164,4664,0,20600,20000,0,20000,0,600,500,100,0,4183,4183,4033,0,3630,600,120,360,350,215
2020,122600251,163322,2472,2472,2472,0,160850,153000,68000,85000,0,7850,850,7000,0,129000,129000,129000,0,4410,360,150,300,200,583
2020,122600261,10,10,10,10,0,0,0,0,0,0,0,0,0,0,0,0,0,0,511,120,36,10,6,1
2020,122600271,69640,40840,16840,16840,24000,28800,28000,0,28000,0,800,800,0,0,46700,22700,19000,3500,4740,420,150,760,220,368
2020,122600281,52892,13436,13436,8436,0,39456,38600,23000,0,15600,856,578,278,0,11700,11700,0,11700,3944,223,161,156,114,241
2020,122600291,18516,6716,6716,5216,0,11800,7000,7000,0,0,4800,1000,800,3000,9000,9000,4000,5000,2110,360,50,360,120,99
2020,122600311,4350,350,350,350,0,4000,4000,4000,0,0,0,0,0,0,1000,1000,0,1000,1002,120,144,36,50,19
2020,122600321,18058,11558,11558,11558,0,6500,6500,6500,0,0,0,0,0,0,700,700,0,0,730,156,70,60,36,34
2020,122600331,150,150,150,150,0,0,0,0,0,0,0,0,0,0,0,0,0,0,571,136,150,0,12,1
2020,122600341,17862,362,362,362,0,17500,17500,2500,15000,0,0,0,0,0,3000,3000,3000,0,678,200,40,15,25,11
2020,122600351,1400,1400,1400,1400,0,0,0,0,0,0,0,0,0,0,0,0,0,0,422,120,20,12,25,1
2020,122600361,39044,2544,2544,2544,0,36500,32000,12000,20000,0,4500,1500,3000,0,14000,14000,10000,4000,1484,240,300,240,144,43
2020,122700201,2820,2820,20,20,2800,0,0,0,0,0,0,0,0,0,0,0,0,0,826,350,100,19,22,1
2020,122700221,46534,43304,15304,15304,28000,3230,0,0,0,0,3230,2900,330,0,0,0,0,0,3660,120,1500,240,120,76
2020,122700231,1918,1850,1850,1850,0,68,0,0,0,0,68,0,68,0,0,0,0,0,1110,140,190,30,30,10
2020,122700251,20190,2190,2190,2190,0,18000,18000,18000,0,0,0,0,0,0,0,0,0,0,2006,250,460,20,50,28
2020,122700261,42646,13446,13446,10546,0,29200,18000,18000,0,0,11200,2200,0,9000,800,800,0,0,3510,650,120,300,240,117
2020,122700291,118184,5104,5104,5104,0,113080,111000,53000,58000,0,2080,1780,300,0,59400,30000,30000,0,2985,300,1000,250,120,266
2020,122700321,7426,2200,2200,2200,0,5226,5000,5000,0,0,226,0,226,0,0,0,0,0,1390,112,620,60,40,9
2020,122800201,141840,15640,15640,13640,0,126200,122100,77000,25000,20100,4100,4100,0,0,0,0,0,0,5650,500,50,600,300,10171
2020,122800221,300,300,50,50,250,0,0,0,0,0,0,0,0,0,0,0,0,0,710,220,10,50,20,0
2020,122800231,11090,1040,1040,1040,0,10050,9000,0,9000,0,1050,750,300,0,3650,150,0,0,2892,336,10,180,84,127
2020,122800261,75942,8192,8192,8192,0,67750,67000,32000,35000,0,750,250,500,0,28000,0,0,0,1790,250,50,200,150,67
2020,122800271,330,330,30,30,300,0,0,0,0,0,0,0,0,0,0,0,0,0,1203,128,60,75,20,4
2020,122800291,35843,6143,6143,6143,0,29700,28000,28000,0,0,1700,1200,500,0,8000,8000,8000,0,2570,480,200,150,100,54
2020,122800301,15484,11284,10784,10784,500,4200,3500,0,3500,0,700,700,0,0,0,0,0,0,1334,195,270,285,29,50
2020,122800311,1150,150,150,150,0,1000,1000,1000,0,0,0,0,0,0,0,0,0,0,535,78,48,75,32,2
2020,122800341,19886,5034,5034,5034,0,14852,12000,12000,0,0,2852,2400,452,0,0,0,0,0,2738,760,360,480,20,92
2020,122800351,60020,3810,3810,3810,0,56210,55000,28000,27000,0,1210,1000,210,0,0,0,0,0,1703,291,163,168,203,40
2020,122900221,25374,24174,24174,24174,0,1200,0,0,0,0,1200,700,500,0,1250,1250,0,1000,4410,300,400,600,200,578
2020,122900241,60696,12540,12540,12540,0,48156,46000,22000,22000,2000,2156,2000,156,0,1000,0,0,0,1730,240,50,240,20,165
2020,122900251,33390,5290,5290,5290,0,28100,25000,25000,0,0,3100,2900,200,0,20800,20800,16500,2000,3570,120,300,300,150,378
2020,122900261,1097,1097,97,97,1000,0,0,0,0,0,0,0,0,0,0,0,0,0,550,51,25,18,17,0
2020,122900271,93600,20400,20400,15400,0,73200,55000,28000,27000,0,18200,7700,10500,0,24400,6400,3600,2700,2750,300,30,700,200,465
2020,122900281,45290,27888,27888,27888,0,17402,16000,16000,0,0,1402,950,452,0,0,0,0,0,3660,240,50,400,160,140
2020,122900291,18780,1780,1780,1780,0,17000,17000,17000,0,0,0,0,0,0,10450,10450,9600,850,1190,240,240,100,60,36
2020,122900301,27086,3826,3826,3826,0,23260,23200,7000,16200,0,60,0,60,0,0,0,0,0,1428,200,500,30,30,16
2020,122900311,2780,2500,2500,2500,0,280,0,0,0,0,280,0,280,0,0,0,0,0,1150,300,30,30,100,89
2020,122900321,17796,336,336,336,0,17460,5500,5500,0,0,11960,1960,0,10000,1790,1790,0,0,3980,310,580,600,150,22
2020,122900331,24550,5750,5750,5450,0,18800,14500,14500,0,0,4300,3600,700,0,2400,2400,2400,0,1720,200,5,320,150,95
2020,122900341,2560,1380,1380,1380,0,1180,0,0,0,0,1180,1180,0,0,0,0,0,0,1604,380,100,95,84,5
2020,122900361,29205,6605,6605,6605,0,22600,20000,20000,0,0,2600,1600,0,1000,8490,8490,5000,3100,3171,300,400,480,180,127
2020,123000202,37400,12400,900,900,11500,25000,25000,0,25000,0,0,0,0,0,0,0,0,0,1031,360,50,60,36,24
2020,123000212,104710,10410,10410,10410,0,94300,94000,32000,62000,0,300,300,0,0,2500,0,0,0,1282,180,132,96,24,208
2020,123000222,28942,6842,6842,5842,0,22100,16500,16500,0,0,5600,3500,2100,0,6700,6700,6700,0,3060,300,700,360,240,89
2020,123000242,41050,20010,18010,18010,2000,21040,19440,0,0,19440,1600,1600,0,0,4860,4860,0,4860,2055,516,5,400,54,509
2020,123600201,40223,26478,26478,26478,0,13745,13200,13200,0,0,545,545,0,0,0,0,0,0,3411,375,303,437,229,83
2020,123600211,59150,28980,28980,28980,0,30170,27000,27000,0,0,3170,3000,170,0,0,0,0,0,3384,300,360,360,324,6153
2020,123600221,62400,8150,8150,8150,0,54250,42000,42000,0,0,12250,2000,5250,5000,150,150,0,0,3780,600,50,300,260,675
2020,123600231,223500,24800,24800,24800,0,198700,198000,34000,164000,0,700,0,700,0,1500,0,0,0,2360,350,120,120,120,315
2020,123600241,1527,1342,1142,1142,200,185,0,0,0,0,185,150,35,0,0,0,0,0,1486,410,20,180,36,17
2020,123700211,75790,790,790,790,0,75000,75000,75000,0,0,0,0,0,0,30550,18550,17000,1550,3840,800,1000,50,30,85
2020,123700231,5078,4578,4578,4578,0,500,0,0,0,0,500,500,0,0,0,0,0,0,2420,120,20,50,80,47
2020,123700241,22265,9245,9245,9245,0,13020,12000,12000,0,0,1020,900,120,0,1950,1950,1000,950,2454,140,300,224,180,48
2020,123700251,150,150,150,150,0,0,0,0,0,0,0,0,0,0,0,0,0,0,359,86,60,19,8,1
2020,123800201,12230,230,230,230,0,12000,12000,12000,0,0,0,0,0,0,0,0,0,0,1292,150,50,80,60,14
2020,123800231,25600,650,650,650,0,24950,22000,22000,0,0,2950,2950,0,0,13939,13939,11339,1000,4210,330,300,750,300,45
2020,123800241,24028,3028,3028,3028,0,21000,20000,20000,0,0,1000,1000,0,0,730,730,0,0,1878,378,70,150,180,240
2020,123800251,36176,7206,7206,7206,0,28970,28500,20000,8500,0,470,420,50,0,2400,2400,0,0,2120,280,300,150,180,119
2020,123900201,66742,19492,19492,17492,0,47250,25000,23000,0,2000,22250,7750,14500,0,45200,45200,20000,25000,5850,300,50,1000,40,1502
2020,123900211,57125,15625,15625,15625,0,41500,38000,38000,0,0,3500,3000,500,0,920,920,0,920,2190,300,30,150,60,148
2020,123900221,3330,2730,2530,2530,200,600,0,0,0,0,600,600,0,0,1985,1985,1645,300,1821,500,100,240,110,100
2020,123900241,23040,2000,2000,2000,0,21040,21000,21000,0,0,40,0,40,0,0,0,0,0,838,240,10,30,48,27
2020,130000202,15002,15002,2,2,15000,0,0,0,0,0,0,0,0,0,0,0,0,0,732,72,300,10,36,1
2020,130000212,74310,60,60,60,0,74250,73500,18000,55500,0,750,750,0,0,3000,3000,0,0,2102,361,1080,240,60,212
2020,130000232,37399,12319,12319,12219,0,25080,25000,25000,0,0,80,0,80,0,29,29,0,0,1675,248,60,294,199,568
2020,130000252,720,550,50,50,500,170,0,0,0,0,170,170,0,0,33,33,0,0,1368,575,5,180,120,4
2020,130000272,1750,1450,450,450,1000,300,0,0,0,0,300,300,0,0,0,0,0,0,2420,250,100,700,200,30
2020,130000282,30950,9750,9750,9750,0,21200,21000,21000,0,0,200,200,0,0,1600,1600,0,1600,3950,144,200,356,258,1069
2020,130000292,136441,63610,13610,13610,50000,72831,70000,0,70000,0,2831,2831,0,0,37500,35000,35000,0,6400,1800,800,400,200,394
2020,130000302,3280,280,280,280,0,3000,3000,3000,0,0,0,0,0,0,0,0,0,0,220,52,12,10,6,1
2020,130000312,56510,43010,43010,43010,0,13500,12300,4500,7800,0,1200,0,1200,0,0,0,0,0,891,216,278,20,80,106
2020,130000332,222,222,22,22,200,0,0,0,0,0,0,0,0,0,450,450,0,0,2113,328,35,50,154,0
2020,130000342,22735,12685,12685,12685,0,10050,10000,10000,0,0,50,0,50,0,0,0,0,0,1812,146,300,24,60,45
2020,130000352,8757,7687,4687,1687,3000,1070,0,0,0,0,1070,70,1000,0,1720,1720,0,1720,3792,826,12,74,86,122
2020,130000362,510,310,10,10,300,200,0,0,0,0,200,200,0,0,900,900,0,0,1560,480,30,150,60,11
2020,130000382,20552,3552,3552,3552,0,17000,15000,15000,0,0,2000,2000,0,0,9800,9800,9800,0,2724,360,180,240,144,179
2020,130000392,22802,4452,4452,4452,0,18350,17000,17000,0,0,1350,1350,0,0,0,0,0,0,1038,204,20,180,96,90
2020,130600231,42601,8475,8475,8475,0,34126,32000,32000,0,0,2126,1900,226,0,0,0,0,0,2760,240,150,70,240,195
2020,130600271,41874,4190,4190,4190,0,37684,36500,22500,0,14000,1184,500,684,0,12792,12792,12792,0,2188,200,50,360,120,47
2020,130600281,13810,5410,5410,5410,0,8400,8000,8000,0,0,400,400,0,0,2725,2725,2725,0,2385,106,10,81,250,218
2020,130600341,8608,2108,2108,2108,0,6500,5000,5000,0,0,1500,1500,0,0,0,0,0,0,1856,276,350,300,90,267
2020,130600351,35385,8760,8760,6260,0,26625,26500,17000,9500,0,125,80,45,0,0,0,0,0,2789,240,1000,100,84,96
2020,130600371,16942,16642,4642,4642,12000,300,0,0,0,0,300,300,0,0,7118,7118,7118,0,2284,192,230,240,72,167
2020,130600391,64089,3489,3489,3489,0,60600,58200,29000,29200,0,2400,2400,0,0,15734,9834,9834,0,4190,410,250,370,260,440
2020,130700211,22299,1086,1086,1086,0,21213,21000,12000,9000,0,213,0,213,0,0,0,0,0,3037,600,805,36,108,74
2020,130700221,30291,3470,3470,3470,0,26821,25000,25000,0,0,1821,1821,0,0,0,0,0,0,1325,180,120,50,180,271
2020,130700231,10140,9060,2060,2060,7000,1080,0,0,0,0,1080,1080,0,0,0,0,0,0,2332,312,300,120,120,168
2020,130700251,68950,440,440,440,0,68510,68000,28000,40000,0,510,510,0,0,3000,3000,0,0,4519,180,300,840,204,822
2020,130700271,49715,13415,6915,6915,6500,36300,32500,0,32500,0,3800,3300,500,0,1532,1532,500,0,4968,600,120,420,420,1936
2020,130700311,69500,29050,29050,29050,0,40450,40000,10000,30000,0,450,450,0,0,0,0,0,0,2519,365,186,260,88,88
2020,130700321,11820,10020,10020,10020,0,1800,0,0,0,0,1800,1800,0,0,0,0,0,0,1949,60,5,240,84,301
2020,130700331,7706,6,6,6,0,7700,5000,5000,0,0,2700,2700,0,0,2600,2600,600,0,1754,147,253,372,96,35
2020,130700341,38578,21528,21528,21528,0,17050,15000,9000,6000,0,2050,2050,0,0,1416,1416,0,0,3860,318,48,480,300,87
2020,130700351,786,786,786,786,0,0,0,0,0,0,0,0,0,0,0,0,0,0,325,70,50,20,25,1
2020,130700371,240,240,40,40,200,0,0,0,0,0,0,0,0,0,0,0,0,0,864,420,36,60,60,8
2020,130700391,14750,5750,4750,2750,1000,9000,0,0,0,0,9000,0,3000,6000,5046,5046,5000,0,2521,564,5,72,180,1
2020,130800211,35540,35040,23040,23040,12000,500,0,0,0,0,500,500,0,0,11000,11000,0,11000,4753,372,50,100,204,678
2020,130800221,10480,1630,1630,1630,0,8850,8850,8850,0,0,0,0,0,0,0,0,0,0,1011,115,36,0,0,7
2020,130800231,15040,40,40,40,0,15000,15000,15000,0,0,0,0,0,0,950,950,212,0,1407,262,150,20,73,27
2020,130800271,160248,4960,4960,4960,0,155288,155000,55000,100000,0,288,0,288,0,4000,0,0,0,3862,1230,240,360,132,340
2020,130800281,119540,19540,19540,19540,0,100000,99500,40000,59500,0,500,500,0,0,19648,7398,7198,0,5220,480,720,720,360,171
2020,130800291,3730,3730,230,230,3500,0,0,0,0,0,0,0,0,0,0,0,0,0,846,120,400,70,36,1
2020,130800301,5090,90,90,90,0,5000,5000,5000,0,0,0,0,0,0,693,693,693,0,307,80,5,6,26,7
2020,130800311,38,38,38,38,0,0,0,0,0,0,0,0,0,0,0,0,0,0,381,126,100,10,20,1
2020,130800321,20730,11130,11130,11130,0,9600,9000,9000,0,0,600,600,0,0,80,80,0,0,2440,660,10,360,120,53
2020,130800331,11403,360,360,360,0,11043,11043,5743,5300,0,0,0,0,0,1000,0,0,0,1000,240,60,50,84,18
2020,130800341,250,250,250,250,0,0,0,0,0,0,0,0,0,0,0,0,0,0,1016,200,180,120,24,1
2020,130800351,22890,11240,11240,11240,0,11650,10000,10000,0,0,1650,1150,500,0,0,0,0,0,3510,450,800,270,96,72
2020,130800361,680,500,500,500,0,180,0,0,0,0,180,180,0,0,0,0,0,0,2146,150,680,240,96,37
2020,130800371,31306,9906,9906,8906,0,21400,12000,9000,3000,0,9400,1200,200,8000,1000,1000,1000,0,3014,324,35,380,240,68
2020,130800381,29712,16482,16482,16482,0,13230,9000,9000,0,0,4230,3380,150,700,0,0,0,0,3120,360,100,420,300,281
2020,130800391,51743,41190,9190,9190,32000,10553,6000,0,0,6000,4553,4500,53,0,6000,6000,6000,0,3858,450,48,240,120,354
2020,130900221,7262,422,422,422,0,6840,5800,5800,0,0,1040,1040,0,0,4000,4000,4000,0,1785,285,300,300,120,8
2020,130900231,4537,4277,3410,3410,867,260,0,0,0,0,260,150,110,0,7366,7366,1000,6366,1778,240,160,420,144,13
2020,130900241,4312,4288,3885,3885,403,24,0,0,0,0,24,0,24,0,50,50,0,0,2090,240,600,140,120,7
2020,130900251,43230,14830,14830,8830,0,28400,28000,28000,0,0,400,400,0,0,7300,7300,2300,5000,5470,360,100,200,310,482
2020,130900261,91755,41755,2755,2755,39000,50000,50000,0,50000,0,0,0,0,0,66800,61800,60000,1800,10820,600,500,720,300,658
2020,130900281,65823,8410,8410,8410,0,57413,57000,32000,0,25000,413,300,113,0,27500,27500,2500,25000,2643,170,110,276,126,77
2020,130900291,4409,3936,3936,3936,0,473,0,0,0,0,473,360,113,0,0,0,0,0,1281,180,155,120,98,30
2020,130900301,98756,29906,29906,29906,0,68850,64000,34000,30000,0,4850,3350,1500,0,0,0,0,0,4952,758,1805,520,175,632
2020,130900321,270,270,15,15,255,0,0,0,0,0,0,0,0,0,0,0,0,0,1098,175,12,80,76,1
2020,130900341,710,710,410,410,300,0,0,0,0,0,0,0,0,0,0,0,0,0,1937,512,10,60,85,1
2020,130900361,30889,7889,7889,5889,0,23000,17000,17000,0,0,6000,6000,0,0,25060,25060,16760,8300,6202,300,12,960,370,237
2020,130900371,15794,8244,8244,8244,0,7550,7000,7000,0,0,550,550,0,0,2816,2816,2816,0,2390,120,20,100,240,50
2020,130900381,2664,2364,2364,2364,0,300,0,0,0,0,300,300,0,0,0,0,0,0,930,120,120,60,60,9
2020,130900391,1050,1050,50,50,1000,0,0,0,0,0,0,0,0,0,0,0,0,0,1980,480,500,300,40,1
2020,131000212,654,654,154,154,500,0,0,0,0,0,0,0,0,0,0,0,0,0,1107,372,10,50,120,0
2020,131000242,6980,6980,980,980,6000,0,0,0,0,0,0,0,0,0,6300,6300,4100,2000,2544,344,276,180,300,1
2020,131000252,3171,3171,30,30,3141,0,0,0,0,0,0,0,0,0,0,0,0,0,933,444,220,24,12,1
2020,131000282,32002,2,2,2,0,32000,32000,32000,0,0,0,0,0,0,0,0,0,0,681,197,70,12,12,33
2020,131000292,93390,61700,61700,61700,0,31690,30000,30000,0,0,1690,550,1140,0,0,0,0,0,4776,240,40,360,228,489
2020,131000302,22600,6100,6100,6100,0,16500,15000,15000,0,0,1500,1500,0,0,0,0,0,0,5220,300,700,800,400,784
2020,131000312,46430,7430,7430,7430,0,39000,37000,18000,19000,0,2000,2000,0,0,3000,2000,0,2000,5850,500,1000,100,250,547
2020,131000332,33995,18201,18201,18201,0,15794,15000,15000,0,0,794,400,394,0,0,0,0,0,3400,200,600,240,156,881
2020,131000342,520,520,20,20,500,0,0,0,0,0,0,0,0,0,0,0,0,0,1376,180,10,134,180,1
2020,131000352,250,250,50,50,200,0,0,0,0,0,0,0,0,0,0,0,0,0,494,154,78,24,48,1
2020,131000362,22845,1550,1550,1550,0,21295,20000,20000,0,0,1295,730,565,0,50,50,0,0,6032,360,300,130,336,1017
2020,131000372,24716,1278,1278,1278,0,23438,23000,23000,0,0,438,300,138,0,3708,3708,3708,0,1099,168,36,144,16,24
2020,131600201,56125,13482,13482,12382,0,42643,38000,9000,29000,0,4643,212,2431,2000,10728,10728,9946,782,2175,120,36,380,120,97
2020,131600241,95760,21760,21760,21760,0,74000,73000,48000,25000,0,1000,1000,0,0,2000,0,0,0,6426,320,2000,400,320,1646
2020,131600261,5990,590,590,390,0,5400,5000,5000,0,0,400,400,0,0,0,0,0,0,1208,94,400,60,28,33
2020,131600281,8782,7180,3180,2180,4000,1602,0,0,0,0,1602,150,452,1000,0,0,0,0,4266,70,1400,240,424,257
2020,131600291,34410,1884,1884,1884,0,32526,28000,18000,10000,0,4526,4300,226,0,3800,3800,500,0,2679,308,45,768,288,254
2020,131600311,7630,7270,2270,2070,5000,360,0,0,0,0,360,0,60,300,2775,2775,0,200,2536,262,134,82,195,17
2020,131600341,6280,6250,6250,6250,0,30,0,0,0,0,30,0,30,0,0,0,0,0,1016,126,176,24,18,26
2020,131600361,2110,1960,600,600,1360,150,0,0,0,0,150,150,0,0,985,985,0,985,2042,440,12,240,240,185
2020,131600371,23684,3421,3421,3321,0,20263,17000,17000,0,0,3263,3150,113,0,5445,5445,5445,0,3080,560,20,360,240,194
2020,131600381,3820,200,200,200,0,3620,3500,2000,1500,0,120,0,120,0,0,0,0,0,580,156,120,80,24,3
2020,131700211,41650,5650,5650,5650,0,36000,34000,34000,0,0,2000,2000,0,0,7500,7500,7500,0,3350,300,100,400,150,132
2020,131700221,7214,7214,214,214,7000,0,0,0,0,0,0,0,0,0,500,500,0,0,569,75,260,13,26,1
2020,131700241,3471,3471,471,471,3000,0,0,0,0,0,0,0,0,0,370,370,50,0,1104,160,500,15,29,1
2020,131700261,44300,4500,4500,4500,0,39800,36500,15000,21500,0,3300,3300,0,0,32500,20000,0,20000,1945,84,130,603,336,85
2020,131700271,58675,16550,16550,16550,0,42125,40000,40000,0,0,2125,1786,339,0,2500,2500,2500,0,4996,960,30,740,310,121
2020,131700301,76406,34766,34766,34766,0,41640,37040,33000,4040,0,4600,4600,0,0,2514,2514,2316,0,5440,480,800,370,223,1599
2020,131700311,195839,128219,128219,113219,0,67620,47000,33000,14000,0,20620,5000,15620,0,250,250,0,0,5090,480,100,470,370,5080
2020,131700341,7010,7010,10,10,7000,0,0,0,0,0,0,0,0,0,0,0,0,0,903,144,360,96,48,1
2020,131700351,13632,12232,3232,3232,9000,1400,0,0,0,0,1400,1400,0,0,1000,1000,0,1000,1086,144,80,170,42,112
2020,131700361,105045,6245,6245,5745,0,98800,98000,60000,38000,0,800,800,0,0,18512,1012,0,1000,6936,1108,150,600,341,1129
2020,131700381,18652,5537,5537,5537,0,13115,13000,9000,4000,0,115,115,0,0,0,0,0,0,4890,240,3000,40,300,391
2020,131700391,24731,1931,1931,1931,0,22800,22000,13000,9000,0,800,800,0,0,3500,3000,3000,0,1690,120,120,400,180,262
2020,131800211,16828,16461,461,461,16000,367,0,0,0,0,367,367,0,0,1200,1200,1000,0,1661,216,240,200,150,53
2020,131800221,42620,7120,7120,7120,0,35500,33500,33500,0,0,2000,2000,0,0,2700,2700,2400,0,2033,264,15,254,30,372
2020,131800231,55550,26440,26440,25840,0,29110,20000,20000,0,0,9110,3000,6110,0,0,0,0,0,3190,160,200,840,120,217
2020,131800251,493,493,193,193,300,0,0,0,0,0,0,0,0,0,0,0,0,0,653,83,160,48,22,0
2020,131800281,27314,8784,8784,8784,0,18530,17500,17500,0,0,1030,30,1000,0,0,0,0,0,2886,288,100,260,228,115
2020,131800311,220553,53553,34553,34553,19000,167000,160000,0,160000,0,7000,4000,3000,0,73588,73588,73588,0,3430,390,340,460,270,103
2020,131800321,90000,14200,3200,3200,11000,75800,74000,0,74000,0,1800,1800,0,0,48780,4780,0,4780,3180,240,300,600,360,890
2020,131800331,66237,18037,18037,16937,0,48200,45000,35000,10000,0,3200,2700,500,0,5970,5970,0,5000,6550,1500,50,300,300,76
2020,131800341,22330,9600,9100,9100,500,12730,12000,0,12000,0,730,730,0,0,9000,0,0,0,6280,800,200,800,360,476
2020,131800351,16040,240,240,240,0,15800,15000,15000,0,0,800,800,0,0,2490,2490,2490,0,2800,260,200,200,150,59
2020,131800361,37120,5120,5120,5120,0,32000,32000,32000,0,0,0,0,0,0,12930,12930,12000,0,1723,300,50,20,253,920
2020,131800371,22380,8030,8030,8030,0,14350,14000,14000,0,0,350,350,0,0,4320,4320,4320,0,2310,150,200,480,200,97
2020,131800381,7300,300,300,300,0,7000,7000,7000,0,0,0,0,0,0,0,0,0,0,1044,390,40,24,0,3
2020,131900201,228558,7558,7558,7558,0,221000,221000,51000,170000,0,0,0,0,0,37350,28600,28600,0,6608,300,1000,600,200,627
2020,131900211,2818,2818,2618,2618,200,0,0,0,0,0,0,0,0,0,0,0,0,0,1552,500,140,90,172,21
2020,131900231,20267,3639,3639,3639,0,16628,16000,16000,0,0,628,400,228,0,9276,9276,9276,0,2362,138,82,400,180,39
2020,131900251,940,940,640,640,300,0,0,0,0,0,0,0,0,0,0,0,0,0,1260,96,10,84,120,19
2020,131900281,30035,2635,2635,2635,0,27400,23100,21000,2100,0,4300,4300,0,0,0,0,0,0,2634,272,150,168,214,309
2020,131900291,25198,2498,2498,2498,0,22700,22000,22000,0,0,700,700,0,0,12810,12810,12810,0,1339,276,30,140,132,88
2020,131900301,9700,100,100,100,0,9600,8000,8000,0,0,1600,1600,0,0,6000,6000,4000,2000,2320,116,375,580,80,206
2020,131900341,46497,13797,13797,13797,0,32700,29000,10000,19000,0,3700,3400,300,0,4518,4518,4518,0,3830,264,100,600,310,257
2020,131900351,36504,4304,4304,4304,0,32200,30000,22000,8000,0,2200,2200,0,0,4500,4000,0,0,3500,250,80,150,250,267
2020,131900361,17553,7303,7303,7303,0,10250,8000,8000,0,0,2250,2050,200,0,2494,2494,1200,250,4510,240,50,350,420,158
2020,131900371,99100,44500,44500,44500,0,54600,50900,23000,24900,3000,3700,3700,0,0,0,0,0,0,3180,300,180,240,240,119
2020,131900381,67899,11519,11519,11519,0,56380,55000,39000,16000,0,1380,1380,0,0,7156,6556,6556,0,8320,372,240,810,510,559
2020,131900391,390,380,380,380,0,10,0,0,0,0,10,0,10,0,0,0,0,0,1500,190,600,60,20,1
2020,132000202,17310,17310,1310,1310,16000,0,0,0,0,0,0,0,0,0,10000,10000,10000,0,3027,180,5,210,204,276
2020,132000222,20478,4878,4878,4878,0,15600,15000,15000,0,0,600,600,0,0,2296,2296,2146,0,1905,175,240,180,140,97
2020,132000232,13280,5280,5280,5280,0,8000,8000,8000,0,0,0,0,0,0,4150,4150,4000,0,1703,123,20,30,180,19
2020,132000242,61672,5672,5672,3672,0,56000,43000,35000,8000,0,13000,8000,5000,0,13120,8120,0,3800,2568,360,10,420,198,317
2020,132000252,37332,1732,1732,1732,0,35600,35000,35000,0,0,600,600,0,0,0,0,0,0,2510,360,30,240,120,92
2020,132000262,13466,12666,666,666,12000,800,0,0,0,0,800,800,0,0,825,825,600,0,2970,100,150,380,240,11
2020,132000272,13900,4168,4168,4168,0,9732,9400,9400,0,0,332,332,0,0,0,0,0,0,2338,120,380,600,158,40
2020,132000282,60707,3066,3066,3066,0,57641,55000,0,55000,0,2641,441,2200,0,23255,22255,18755,3000,2172,168,500,384,180,56
2020,132000302,10040,3400,3400,3400,0,6640,6330,4800,1530,0,310,310,0,0,480,480,0,0,1432,82,400,60,60,10
2020,132000312,9780,2080,2080,2080,0,7700,4000,4000,0,0,3700,3700,0,0,0,0,0,0,982,60,50,150,60,115
2020,132000322,9820,2610,2610,2610,0,7210,6910,6910,0,0,300,300,0,0,800,800,0,800,3419,264,1500,472,96,23
2020,132600221,8960,8960,3960,3960,5000,0,0,0,0,0,0,0,0,0,0,0,0,0,930,60,12,60,144,1
2020,132600231,18649,14812,7812,7812,7000,3837,2400,0,0,2400,1437,1300,137,0,0,0,0,0,2007,72,20,144,156,385
2020,132600241,3214,3114,714,714,2400,100,0,0,0,0,100,100,0,0,3500,3500,1000,2500,1834,480,12,84,126,41
2020,132600251,107000,25200,25200,25200,0,81800,71000,58000,13000,0,10800,10300,500,0,0,0,0,0,9080,960,350,1800,450,7578
2020,132600271,19016,2016,2016,1316,0,17000,14000,14000,0,0,3000,3000,0,0,4270,4270,2610,0,2059,108,710,341,90,66
2020,132600281,990,940,440,440,500,50,0,0,0,0,50,50,0,0,4000,4000,0,4000,2140,700,200,300,240,137
2020,132600321,38115,14265,14265,14265,0,23850,23000,23000,0,0,850,350,500,0,0,0,0,0,1480,200,200,200,80,56
2020,132600331,10,10,10,10,0,0,0,0,0,0,0,0,0,0,0,0,0,0,236,48,24,24,10,1
2020,132600341,38500,17500,13500,13300,4000,21000,20000,0,20000,0,1000,700,300,0,9100,6500,6500,0,1430,145,5,600,120,76
2020,132700201,87146,30100,30100,30100,0,57046,55000,55000,0,0,2046,1470,576,0,50,50,0,0,2796,204,10,120,120,1119
2020,132700221,85782,44382,44382,34382,0,41400,41000,21000,20000,0,400,400,0,0,1000,1000,1000,0,4060,264,40,540,156,1237
2020,132700251,10494,450,450,450,0,10044,10000,10000,0,0,44,0,44,0,0,0,0,0,1011,182,300,15,71,12
2020,132700261,5685,3357,1057,1057,2300,2328,0,0,0,0,2328,2100,228,0,4866,4866,1500,1600,2425,532,60,231,222,94
2020,132700271,8225,7075,4075,4075,3000,1150,850,0,850,0,300,300,0,0,0,0,0,0,1118,120,60,300,48,17
2020,132700301,63113,2993,2993,2993,0,60120,57600,8000,49600,0,2520,620,1900,0,2000,0,0,0,4220,240,550,500,60,38
2020,132700311,10792,8642,8642,5642,0,2150,2000,2000,0,0,150,150,0,0,3000,3000,0,0,1625,270,350,280,70,20
2020,132700321,12941,441,441,441,0,12500,12500,6500,6000,0,0,0,0,0,0,0,0,0,820,80,30,40,90,3
2020,132800221,40030,6030,6030,6030,0,34000,20000,20000,0,0,14000,4000,10000,0,13640,13640,13640,0,3680,120,80,190,288,115
2020,132800301,6250,250,250,250,0,6000,6000,6000,0,0,0,0,0,0,0,0,0,0,809,127,280,36,36,6
2020,132800321,22110,7360,7360,7360,0,14750,14200,1200,13000,0,550,200,350,0,190,190,0,190,1302,322,220,120,130,21
2020,132800331,8100,100,100,100,0,8000,8000,8000,0,0,0,0,0,0,0,0,0,0,943,168,50,150,15,8
2020,132900201,64888,35980,35980,35980,0,28908,27000,27000,0,0,1908,1808,100,0,0,0,0,0,3590,360,1000,360,180,306
2020,132900221,2090,2090,90,90,2000,0,0,0,0,0,0,0,0,0,0,0,0,0,779,396,24,36,24,1
2020,132900231,1828,1828,28,28,1800,0,0,0,0,0,0,0,0,0,1300,1300,1300,0,987,384,10,60,120,1
2020,132900241,11870,570,570,570,0,11300,11300,11300,0,0,0,0,0,0,1714,1714,1714,0,2100,150,10,150,240,9
2020,132900251,59010,10,10,10,0,59000,50000,50000,0,0,9000,3000,6000,0,16880,16880,10800,5000,2150,140,250,300,250,135
2020,132900261,75748,3800,3800,3800,0,71948,71948,40000,31948,0,0,0,0,0,0,0,0,0,939,240,464,15,30,91
2020,132900301,22054,10914,10914,10914,0,11140,10500,0,10500,0,640,300,340,0,0,0,0,0,1268,250,30,240,48,287
2020,132900311,7270,2270,2270,2270,0,5000,4600,2000,2600,0,400,0,400,0,0,0,0,0,1404,300,360,70,24,8
2020,132900321,6165,3175,3175,3175,0,2990,2980,680,2300,0,10,0,10,0,0,0,0,0,623,50,100,40,20,5
2020,132900331,34430,3430,2930,2930,500,31000,31000,0,31000,0,0,0,0,0,31180,4180,0,680,1318,386,30,320,228,98
2020,133600201,68170,23170,23170,23170,0,45000,44500,44500,0,0,500,500,0,0,0,0,0,0,5860,600,1000,360,300,1182
2020,133600221,30,30,30,30,0,0,0,0,0,0,0,0,0,0,0,0,0,0,505,120,60,10,15,3
2020,133700201,28190,4590,4590,4590,0,23600,22000,22000,0,0,1600,1600,0,0,3300,3300,3300,0,1806,156,0,180,180,65
2020,133700211,65572,7422,7422,4422,0,58150,50000,50000,0,0,8150,150,5000,3000,30080,30080,28080,0,7442,388,46,385,260,88
2020,133700221,57944,10222,10222,9222,0,47722,46000,46000,0,0,1722,1608,114,0,24324,24324,23624,0,5560,280,60,360,240,1692
2020,133800201,25560,1160,1160,1160,0,24400,21000,21000,0,0,3400,1900,1500,0,19800,19800,19800,0,6024,312,72,1200,720,407
2020,133900201,129460,23160,23160,23160,0,106300,106000,15000,91000,0,300,300,0,0,0,0,0,0,1220,180,100,120,60,47
2020,133900211,450,450,450,450,0,0,0,0,0,0,0,0,0,0,0,0,0,0,670,140,60,30,30,1
2020,140000202,17031,2431,2431,2431,0,14600,14600,14600,0,0,0,0,0,0,5200,5200,5200,0,2127,240,160,220,72,35
2020,140000212,50268,5750,5750,5590,0,44518,40000,14500,25500,0,4518,4310,208,0,365,365,0,280,4124,504,220,696,144,1020
2020,140000222,157495,50972,50972,50972,0,106523,105000,70000,35000,0,1523,600,923,0,500,0,0,0,3504,367,183,249,312,195
2020,140000232,43627,333,333,333,0,43294,19700,19700,0,0,23594,23000,0,594,30910,30910,30910,0,3256,282,101,361,168,325
2020,140000242,37735,17260,17260,17260,0,20475,18200,17200,1000,0,2275,2000,275,0,6000,6000,6000,0,2713,191,96,336,192,163
2020,140000252,208,208,8,8,200,0,0,0,0,0,0,0,0,0,0,0,0,0,1418,144,24,96,142,0
2020,140000262,225,225,25,25,200,0,0,0,0,0,0,0,0,0,12,12,0,0,444,121,5,24,36,0
2020,140000282,25135,3905,3905,3905,0,21230,21000,21000,0,0,230,230,0,0,15000,15000,12000,0,2824,275,800,456,242,52
2020,140000292,14157,11577,2577,2577,9000,2580,1800,0,1800,0,780,780,0,0,0,0,0,0,1006,78,266,203,55,10
2020,140000302,33036,836,836,836,0,32200,29000,29000,0,0,3200,3200,0,0,15330,15330,14700,0,8200,1000,200,800,500,1797
2020,140000312,27330,3575,3575,3575,0,23755,20000,20000,0,0,3755,3755,0,0,15250,15250,12000,250,1938,360,200,150,216,337
2020,140000322,27662,9362,9362,9362,0,18300,18000,18000,0,0,300,300,0,0,0,0,0,0,1894,360,1000,160,144,88
2020,140000332,2040,2040,1740,1740,300,0,0,0,0,0,0,0,0,0,0,0,0,0,1394,540,60,60,84,1
2020,140000352,17740,11240,1740,1740,9500,6500,5000,0,5000,0,1500,1500,0,0,3000,3000,3000,0,3210,240,350,600,240,259
2020,140000362,9200,9200,3700,3700,5500,0,0,0,0,0,0,0,0,0,4000,4000,0,4000,1527,120,5,50,120,332
2020,140000382,35055,2455,2455,2455,0,32600,32000,32000,0,0,600,600,0,0,14600,14600,12200,2400,2035,300,200,300,300,73
2020,140000392,906,906,706,706,200,0,0,0,0,0,0,0,0,0,0,0,0,0,1494,540,20,20,144,4
2020,140600221,104340,19835,19835,17835,0,84505,64000,64000,0,0,20505,2130,15375,3000,17000,10000,10000,0,4520,800,100,800,220,391
2020,140600231,38985,18957,5957,5957,13000,20028,19000,0,0,19000,1028,350,678,0,18000,18000,2000,16000,3579,224,120,120,240,21
2020,140600241,58663,11730,11730,11730,0,46933,45000,37000,8000,0,1933,1730,203,0,0,0,0,0,5760,460,110,900,600,409
2020,140600251,3060,3030,30,30,3000,30,0,0,0,0,30,30,0,0,500,500,500,0,539,83,48,81,16,27
2020,140600271,37933,5988,5988,5988,0,31945,31000,31000,0,0,945,200,745,0,0,0,0,0,3009,252,60,320,120,105
2020,140600291,49189,4363,4363,4363,0,44826,30000,15000,15000,0,14826,1600,13226,0,200,0,0,0,4134,662,95,529,144,299
2020,140600311,4100,200,200,200,0,3900,3000,3000,0,0,900,900,0,0,0,0,0,0,5790,200,5000,150,40,123
2020,140600321,8700,700,700,700,0,8000,8000,8000,0,0,0,0,0,0,0,0,0,0,599,204,150,10,40,11
2020,140600331,5572,5572,72,72,5500,0,0,0,0,0,0,0,0,0,0,0,0,0,1322,250,70,90,72,6
2020,140600351,10,10,10,10,0,0,0,0,0,0,0,0,0,0,0,0,0,0,917,230,380,10,40,1
2020,140600361,3255,3255,255,255,3000,0,0,0,0,0,0,0,0,0,0,0,0,0,1220,120,30,90,70,76
2020,140600381,46000,30650,30650,30650,0,15350,15000,15000,0,0,350,350,0,0,0,0,0,0,4232,460,150,300,132,687
2020,140700201,31933,13933,13933,13933,0,18000,18000,18000,0,0,0,0,0,0,0,0,0,0,1106,204,233,177,78,51
2020,140700241,493,493,493,493,0,0,0,0,0,0,0,0,0,0,0,0,0,0,853,72,72,28,36,1
2020,140700251,17273,908,908,908,0,16365,14000,14000,0,0,2365,2160,205,0,7246,7246,7246,0,1927,180,115,324,156,125
2020,140700271,87630,38577,38577,38577,0,49053,43500,30500,13000,0,5553,5450,103,0,0,0,0,0,5732,405,125,1005,307,991
2020,140700281,40773,400,400,400,0,40373,36900,22900,14000,0,3473,3450,23,0,0,0,0,0,3076,1250,270,240,48,100
2020,140700311,26286,9186,9186,9186,0,17100,15000,15000,0,0,2100,2100,0,0,16200,16200,10000,5000,3075,1015,40,240,280,894
2020,140700321,170,170,70,70,100,0,0,0,0,0,0,0,0,0,174,174,0,0,2245,655,280,70,270,2
2020,140700361,29330,7004,7004,7004,0,22326,21000,21000,0,0,1326,1100,226,0,6000,6000,6000,0,3860,240,250,400,360,580
2020,140800251,20169,2864,2864,2864,0,17305,16000,10000,6000,0,1305,1150,155,0,60,60,0,0,3305,350,55,500,220,49
2020,140800261,33860,3286,3286,3286,0,30574,18000,18000,0,0,12574,2400,174,10000,257,257,0,0,1966,188,80,320,120,20
2020,140800271,18554,505,505,505,0,18049,18000,18000,0,0,49,0,49,0,0,0,0,0,1108,228,240,190,36,22
2020,140800281,40948,19180,14180,14180,5000,21768,19000,0,7000,12000,2768,2690,78,0,12500,12500,0,12500,5148,780,62,530,216,564
2020,140800321,12720,12720,8920,8920,3800,0,0,0,0,0,0,0,0,0,2000,2000,2000,0,1765,725,100,90,90,37
2020,140800341,23623,22823,6823,6823,16000,800,0,0,0,0,800,800,0,0,6000,6000,6000,0,3110,380,40,490,200,80
2020,140800351,27503,3503,3503,3503,0,24000,24000,24000,0,0,0,0,0,0,600,600,0,0,4100,500,300,300,300,407
2020,140800381,39700,23000,23000,23000,0,16700,15000,15000,0,0,1700,1700,0,0,6900,6900,6900,0,5500,400,100,1000,280,97
2020,140800391,22288,3112,3112,3112,0,19176,18000,15000,3000,0,1176,850,326,0,0,0,0,0,2990,230,700,250,90,22
2020,140900201,6543,5093,5093,4233,0,1450,0,0,0,0,1450,850,600,0,202,202,0,202,1945,245,90,154,145,42
2020,140900231,3716,3516,2516,2516,1000,200,0,0,0,0,200,0,200,0,0,0,0,0,665,124,60,36,60,1
2020,140900241,41627,24464,24464,24464,0,17163,17000,0,17000,0,163,0,163,0,1000,0,0,0,1751,132,30,601,24,33
2020,140900251,24527,977,977,977,0,23550,22000,20000,2000,0,1550,1550,0,0,5000,0,0,0,2490,210,120,260,140,63
2020,140900261,17006,11126,11126,11126,0,5880,5000,5000,0,0,880,550,330,0,0,0,0,0,8714,1400,210,1344,720,423
2020,140900271,47876,9699,9699,9699,0,38177,36000,36000,0,0,2177,1950,227,0,20000,20000,20000,0,4173,397,150,476,324,632
2020,140900281,23069,5139,5139,5139,0,17930,17500,17500,0,0,430,430,0,0,0,0,0,0,1158,185,23,360,84,183
2020,140900301,13330,330,330,330,0,13000,13000,10000,3000,0,0,0,0,0,0,0,0,0,585,80,120,60,55,23
2020,140900311,21600,950,950,950,0,20650,18000,8000,10000,0,2650,2500,150,0,0,0,0,0,920,80,150,50,60,80
2020,140900351,4650,300,300,300,0,4350,4000,4000,0,0,350,250,100,0,2455,2455,2455,0,1462,175,33,200,104,13
2020,140900371,3050,1050,50,50,1000,2000,0,0,0,0,2000,2000,0,0,5650,5650,0,2000,2710,830,50,160,100,90
2020,141000202,10105,105,105,105,0,10000,10000,10000,0,0,0,0,0,0,0,0,0,0,683,135,368,12,24,11
2020,141000212,27410,5210,5210,5210,0,22200,21700,21700,0,0,500,500,0,0,600,0,0,0,1763,482,72,81,61,103
2020,141000222,14273,273,273,273,0,14000,14000,14000,0,0,0,0,0,0,0,0,0,0,1107,120,404,10,35,16
2020,141000232,378,378,78,78,300,0,0,0,0,0,0,0,0,0,0,0,0,0,959,485,8,15,34,3
2020,141000242,9776,7921,921,921,7000,1855,0,0,0,0,1855,1790,65,0,0,0,0,0,1833,82,107,274,120,384
2020,141000252,8139,1071,1071,1071,0,7068,7000,7000,0,0,68,0,68,0,0,0,0,0,737,89,194,24,35,28
2020,141000262,45748,5344,5344,5344,0,40404,38000,38000,0,0,2404,1500,904,0,21070,21070,21070,0,4035,301,50,600,242,800
2020,141000272,73140,28995,28995,28995,0,44145,41400,34200,7200,0,2745,2745,0,0,0,0,0,0,3214,348,42,886,72,242
2020,141000282,99218,21466,21466,21466,0,77752,75500,38000,37500,0,2252,1800,452,0,26900,15900,15900,0,7350,376,219,824,420,3691
2020,141000292,327,115,15,15,100,212,0,0,0,0,212,0,212,0,0,0,0,0,1827,360,60,120,24,6
2020,141000312,122174,1574,1574,1574,0,120600,115000,15000,100000,0,5600,600,5000,0,10000,10000,10000,0,2358,740,100,120,228,98
2020,141000322,14057,57,57,57,0,14000,14000,6000,8000,0,0,0,0,0,0,0,0,0,647,320,130,15,30,11
2020,141000342,44220,38420,38420,37420,0,5800,5000,0,5000,0,800,800,0,0,200,0,0,0,5600,280,4200,120,60,181
2020,141000352,5080,80,80,80,0,5000,5000,5000,0,0,0,0,0,0,0,0,0,0,753,52,0,23,24,2
2020,141000362,10,10,10,10,0,0,0,0,0,0,0,0,0,0,0,0,0,0,282,60,180,0,24,1
2020,141000382,54200,3000,3000,3000,0,51200,51000,6000,45000,0,200,0,200,0,0,0,0,0,194,0,60,0,0,10
2020,141000392,10120,2400,2400,2400,0,7720,7700,2700,5000,0,20,0,20,0,0,0,0,0,535,90,70,30,15,5
2020,141600211,17434,1866,1866,1866,0,15568,15500,15500,0,0,68,0,68,0,100,0,0,0,1670,188,232,241,75,17
2020,141600251,24586,586,586,586,0,24000,24000,24000,0,0,0,0,0,0,0,0,0,0,3105,288,1562,123,72,33
2020,141600281,119878,12378,12378,12378,0,107500,95000,45000,50000,0,12500,200,12300,0,15515,15515,15000,500,3655,275,23,396,245,227
2020,141600291,10570,7570,6370,2970,1200,3000,0,0,0,0,3000,0,1000,2000,2519,2519,0,1657,3032,352,168,457,263,11
2020,141600311,13428,4102,4102,4102,0,9326,8800,8800,0,0,526,300,226,0,100,0,0,0,1328,186,127,274,54,23
2020,141600321,105688,25988,25988,23988,0,79700,76000,50000,26000,0,3700,3700,0,0,24200,17200,5800,0,7886,556,1200,650,550,438
2020,141600351,6030,6030,30,30,6000,0,0,0,0,0,0,0,0,0,5000,5000,5000,0,734,318,50,20,66,1
2020,141600361,14020,450,450,450,0,13570,13380,180,13200,0,190,0,190,0,0,0,0,0,972,230,500,30,50,35
2020,141600371,18175,400,400,400,0,17775,17730,180,17550,0,45,0,45,0,0,0,0,0,383,72,55,35,7,12
2020,141600381,52945,30675,30675,30675,0,22270,21000,15000,6000,0,1270,1270,0,0,0,0,0,0,2687,360,300,480,120,227
2020,141600391,77468,57076,57076,57076,0,20392,20000,20000,0,0,392,121,271,0,0,0,0,0,6171,360,300,180,180,1705
2020,141700201,13238,38,38,38,0,13200,12500,12500,0,0,700,700,0,0,2675,2675,1875,0,1132,168,62,125,41,28
2020,141700211,274,274,31,31,243,0,0,0,0,0,0,0,0,0,35,35,0,0,806,146,20,40,62,0
2020,141700221,5811,5712,2312,2312,3400,99,0,0,0,0,99,50,49,0,4160,4160,2260,700,960,221,21,101,85,38
2020,141700231,33334,14720,14720,11220,0,18614,18000,12000,6000,0,614,500,114,0,0,0,0,0,2946,137,70,240,156,46
2020,141700261,10923,1123,1123,1123,0,9800,8600,8600,0,0,1200,1200,0,0,100,100,0,0,3610,180,324,374,144,73
2020,141700301,10,10,10,10,0,0,0,0,0,0,0,0,0,0,0,0,0,0,736,120,36,40,15,1
2020,141700311,6520,2020,2020,2020,0,4500,3800,0,3800,0,700,700,0,0,4500,4500,0,4500,1798,60,20,700,130,57
2020,141700321,55488,5688,5688,5688,0,49800,48000,48000,0,0,1800,1800,0,0,0,0,0,0,3880,600,100,80,300,3045
2020,141700341,35855,20605,8605,4605,12000,15250,13050,0,11550,1500,2200,2000,200,0,1650,1650,0,0,3053,168,900,240,300,34
2020,141700361,26324,5574,5574,5374,0,20750,14000,14000,0,0,6750,750,3000,3000,5900,5900,3900,2000,3620,510,120,240,360,70
2020,141700371,980,980,980,980,0,0,0,0,0,0,0,0,0,0,0,0,0,0,1100,100,60,100,60,1
2020,141700381,16080,380,380,380,0,15700,15500,10000,5500,0,200,0,200,0,0,0,0,0,1210,520,180,80,90,24
2020,141700391,161246,13036,13036,8036,0,148210,112000,32000,80000,0,36210,9450,26760,0,19000,19000,12000,7000,8926,960,300,600,420,297
2020,141800221,186,186,186,186,0,0,0,0,0,0,0,0,0,0,0,0,0,0,1211,216,46,68,48,16
2020,141800241,18107,107,107,107,0,18000,18000,13000,5000,0,0,0,0,0,0,0,0,0,654,120,50,60,96,21
2020,141800251,3456,3456,2956,2956,500,0,0,0,0,0,0,0,0,0,0,0,0,0,1580,627,30,240,72,67
2020,141800261,9162,32,32,32,0,9130,9000,9000,0,0,130,0,130,0,0,0,0,0,626,96,175,78,24,12
2020,141800271,20718,8038,8038,8038,0,12680,10000,10000,0,0,2680,2680,0,0,292,292,0,0,3402,204,200,557,192,74
2020,141800291,189,135,135,135,0,54,0,0,0,0,54,0,54,0,0,0,0,0,765,132,240,50,50,7
2020,141800301,168725,50745,50745,39245,0,117980,115000,70000,45000,0,2980,980,2000,0,5000,0,0,0,5360,1080,50,840,330,2994
2020,141800321,21131,1581,1581,1581,0,19550,13000,3000,10000,0,6550,1650,4900,0,7000,7000,5000,2000,4700,400,300,600,500,158
2020,141800331,28743,19623,4123,4123,15500,9120,0,0,0,0,9120,4600,4520,0,100,100,0,100,5480,420,60,1050,300,176
2020,141900201,86277,2892,2892,1892,0,83385,80000,70000,10000,0,3385,3300,85,0,15767,15767,10767,5000,3657,384,245,362,156,1465
2020,141900221,36697,2129,2129,2129,0,34568,30000,30000,0,0,4568,3990,578,0,0,0,0,0,4434,144,1040,480,120,1284
2020,141900231,38643,3553,3553,3553,0,35090,28790,27000,0,1790,6300,6300,0,0,4286,4286,0,4286,5034,624,160,600,300,1670
2020,141900251,1019,1019,19,19,1000,0,0,0,0,0,0,0,0,0,10000,10000,0,10000,702,191,10,48,15,0
2020,141900261,31030,12106,12106,12106,0,18924,17500,14000,3500,0,1424,1329,95,0,110,110,0,0,2446,282,33,720,180,531
2020,141900281,38421,8521,8521,8521,0,29900,28000,28000,0,0,1900,1900,0,0,12000,12000,0,12000,4212,307,61,422,276,1116
2020,141900291,15608,14208,12646,12646,1562,1400,0,0,0,0,1400,1400,0,0,0,0,0,0,1051,192,115,130,48,47
2020,141900331,8024,1532,1532,1532,0,6492,6492,3060,3432,0,0,0,0,0,0,0,0,0,674,120,91,36,42,4
2020,141900341,12163,2263,2263,2263,0,9900,9300,9300,0,0,600,200,400,0,0,0,0,0,2037,132,856,362,96,59
2020,141900351,27104,26404,14404,14404,12000,700,0,0,0,0,700,700,0,0,10600,10600,9600,0,4898,360,500,150,240,45
2020,141900361,67428,1478,1478,1478,0,65950,62000,32000,30000,0,3950,3150,800,0,36360,30360,17360,13000,5370,400,110,480,180,992
2020,141900371,8260,60,60,60,0,8200,8200,8200,0,0,0,0,0,0,0,0,0,0,1080,200,300,130,40,14
2020,141900381,26116,11766,11766,11766,0,14350,14000,14000,0,0,350,350,0,0,1880,1880,1880,0,2040,180,70,160,370,142
2020,141900391,4614,1466,1466,1466,0,3148,3000,3000,0,0,148,128,20,0,0,0,0,0,2206,216,80,400,160,43
2020,142000202,32651,1217,1217,1217,0,31434,29800,29800,0,0,1634,1520,114,0,19333,19333,19333,0,1746,216,156,120,296,118
2020,142000212,7535,6885,6885,6885,0,650,0,0,0,0,650,650,0,0,0,0,0,0,2597,0,5,230,108,590
2020,142000222,31038,9958,3958,3958,6000,21080,20000,0,20000,0,1080,900,180,0,18000,18000,10000,8000,3305,276,290,365,240,196
2020,142000232,986,986,986,986,0,0,0,0,0,0,0,0,0,0,0,0,0,0,1055,541,0,61,24,1
2020,142000242,2950,2950,2750,2750,200,0,0,0,0,0,0,0,0,0,0,0,0,0,1794,396,15,60,120,0
2020,142000312,2580,2580,2480,2480,100,0,0,0,0,0,0,0,0,0,0,0,0,0,1112,408,10,10,144,1
2020,142000322,87590,16400,16400,6400,0,71190,67500,5000,62500,0,3690,3690,0,0,0,0,0,0,7680,450,900,820,170,1555
2020,142000332,3763,3763,3763,3763,0,0,0,0,0,0,0,0,0,0,0,0,0,0,855,82,70,15,108,0
2020,142000342,3340,1650,1650,1650,0,1690,1690,1690,0,0,0,0,0,0,0,0,0,0,756,122,118,25,36,3
2020,142000352,33290,7690,7690,7690,0,25600,23000,23000,0,0,2600,2600,0,0,8500,8500,8500,0,3320,240,120,720,240,603
2020,142000382,12646,9076,6986,5986,2090,3570,0,0,0,0,3570,0,570,3000,1200,1200,0,1200,5144,360,600,840,324,7
2020,142600211,114099,37554,12554,12554,25000,76545,70000,0,40000,30000,6545,6350,195,0,41467,11467,1000,7000,6578,1750,123,357,360,1105
2020,142600221,40247,10534,10534,7284,0,29713,28700,28700,0,0,1013,350,663,0,5628,5628,5128,0,3153,503,126,396,301,72
2020,142600231,28990,5365,5365,5365,0,23625,22800,16800,6000,0,825,700,125,0,12652,12152,12152,0,2750,390,30,300,160,37
2020,142600311,3550,650,650,650,0,2900,2800,2800,0,0,100,0,100,0,0,0,0,0,1345,800,100,15,50,13
2020,142600321,28626,12896,12896,12896,0,15730,15500,3000,12500,0,230,150,80,0,0,0,0,0,1604,306,120,240,100,53
2020,142600331,2514,54,54,54,0,2460,2460,2460,0,0,0,0,0,0,0,0,0,0,490,159,120,24,14,11
2020,142600341,23050,100,100,100,0,22950,17750,5000,12750,0,5200,4700,500,0,19650,19650,15000,3000,1676,150,100,120,144,69
2020,142600351,8604,804,804,804,0,7800,7800,6000,1800,0,0,0,0,0,0,0,0,0,1430,240,600,120,50,21
2020,142700211,17077,61,61,61,0,17016,17000,17000,0,0,16,0,16,0,0,0,0,0,1070,168,100,20,56,17
2020,142700231,48808,10498,10498,9498,0,38310,38000,38000,0,0,310,160,150,0,7300,7300,5000,2000,4395,300,100,245,170,104
2020,142700301,13347,4542,4542,4542,0,8805,8780,3680,5100,0,25,0,25,0,0,0,0,0,1587,147,1090,35,50,12
2020,142700311,12250,470,470,470,0,11780,11530,5530,6000,0,250,250,0,0,0,0,0,0,1635,213,420,156,26,16
2020,142700321,27240,5240,5240,4940,0,22000,21600,6000,15600,0,400,400,0,0,2535,2535,0,2500,847,114,10,120,65,92
2020,142700341,6819,6819,6819,6819,0,0,0,0,0,0,0,0,0,0,0,0,0,0,786,92,300,20,35,1
2020,142800201,52664,20344,20344,20344,0,32320,30000,28000,2000,0,2320,2000,320,0,0,0,0,0,4349,230,70,530,232,97
2020,142800221,98482,25985,25985,25985,0,72497,70000,40000,30000,0,2497,2200,297,0,22720,22720,22720,0,4350,375,210,350,120,160
2020,142800231,4590,4570,1570,1570,3000,20,0,0,0,0,20,0,20,0,0,0,0,0,1853,350,128,250,205,1
2020,142800301,1084,1084,84,84,1000,0,0,0,0,0,0,0,0,0,0,0,0,0,845,204,200,96,90,1
2020,142800321,48405,6005,6005,6005,0,42400,42000,9500,32500,0,400,300,100,0,5200,200,0,0,1612,230,120,360,162,57
2020,142800341,21962,1122,1122,1122,0,20840,19520,4320,15200,0,1320,200,1120,0,3000,3000,3000,0,3754,374,600,360,120,7
2020,142800351,4100,100,100,100,0,4000,3300,2100,1200,0,700,700,0,0,1500,1500,0,1500,1833,120,710,360,60,23
2020,142800361,245,245,245,245,0,0,0,0,0,0,0,0,0,0,0,0,0,0,260,54,3,70,0,2
2020,142800371,13431,681,681,681,0,12750,12700,4000,8700,0,50,0,50,0,0,0,0,0,924,50,200,10,66,19
2020,142800381,10854,6834,6834,6834,0,4020,4000,4000,0,0,20,0,20,0,150,150,0,0,942,150,120,60,72,5
2020,142800391,60260,11060,11060,11060,0,49200,47000,25000,22000,0,2200,2200,0,0,19000,0,0,0,4126,330,120,240,216,1078
2020,142900201,211,211,11,11,200,0,0,0,0,0,0,0,0,0,170,170,0,0,590,181,61,61,24,0
2020,142900211,315,315,15,15,300,0,0,0,0,0,0,0,0,0,0,0,0,0,693,168,6,64,6,0
2020,142900221,9496,496,496,496,0,9000,9000,9000,0,0,0,0,0,0,744,744,744,0,810,161,120,24,36,15
2020,142900241,24312,8886,8886,8886,0,15426,13700,13000,700,0,1726,1500,226,0,3160,3160,1700,0,2670,180,30,420,180,99
2020,142900301,1302,1302,302,302,1000,0,0,0,0,0,0,0,0,0,0,0,0,0,545,72,100,48,30,0
2020,142900321,64740,2940,2940,2940,0,61800,60000,20000,40000,0,1800,1800,0,0,0,0,0,0,1980,152,260,384,84,278
2020,142900331,39650,10900,10900,10900,0,28750,28500,4500,24000,0,250,0,250,0,0,0,0,0,1267,120,130,120,72,32
2020,142900351,20681,20281,8281,8281,12000,400,0,0,0,0,400,400,0,0,0,0,0,0,2030,200,350,320,100,222
2020,142900361,18594,94,94,94,0,18500,18500,2500,16000,0,0,0,0,0,300,300,300,0,1523,156,120,120,77,3
2020,142900371,24597,8847,8847,8847,0,15750,9700,5900,3800,0,6050,6050,0,0,7500,7500,2000,0,3204,324,60,720,180,126
2020,142900381,40918,26068,26068,21068,0,14850,14700,2500,12200,0,150,150,0,0,0,0,0,0,1474,300,30,340,108,120
2020,142900391,240,240,240,240,0,0,0,0,0,0,0,0,0,0,0,0,0,0,590,180,8,15,12,1
2020,143000302,14228,6160,6160,6160,0,8068,8000,8000,0,0,68,0,68,0,0,0,0,0,954,198,136,30,30,43
2020,143000312,30830,13015,13015,6215,0,17815,15000,15000,0,0,2815,1900,915,0,4400,4400,0,4400,3053,305,144,240,204,192
2020,143000322,26800,4000,4000,4000,0,22800,22800,3000,19800,0,0,0,0,0,0,0,0,0,380,198,72,0,0,9
2020,150000202,1351,1351,51,51,1300,0,0,0,0,0,0,0,0,0,0,0,0,0,608,120,10,10,15,0
2020,150000212,22400,2500,2500,2500,0,19900,19900,13900,6000,0,0,0,0,0,0,0,0,0,1096,240,20,16,60,14
2020,150000222,10661,2561,2561,2561,0,8100,7500,7500,0,0,600,400,200,0,105,105,0,0,3340,240,60,420,300,24
2020,150000242,7100,500,500,500,0,6600,5000,5000,0,0,1600,900,0,700,2300,2000,2000,0,2430,100,150,300,180,71
2020,150000252,187,187,12,12,175,0,0,0,0,0,0,0,0,0,25000,25000,0,0,938,148,0,50,60,7
2020,150000262,11870,370,370,370,0,11500,11500,11500,0,0,0,0,0,0,0,0,0,0,690,190,48,10,12,10
2020,150000272,1250,1250,1250,1250,0,0,0,0,0,0,0,0,0,0,0,0,0,0,990,240,10,0,120,4
2020,150000282,17997,2147,2147,2147,0,15850,15000,15000,0,0,850,850,0,0,8000,8000,8000,0,1134,176,80,324,144,20
2020,150000302,19491,15891,6891,6891,9000,3600,0,0,0,0,3600,3600,0,0,0,0,0,0,2544,240,24,600,240,160
2020,150000312,50,50,50,50,0,0,0,0,0,0,0,0,0,0,0,0,0,0,650,180,30,60,24,1
2020,150000322,21716,19216,4216,4216,15000,2500,0,0,0,0,2500,2500,0,0,350,350,0,350,4042,789,57,186,276,457
2020,150000332,19470,470,470,470,0,19000,19000,19000,0,0,0,0,0,0,6700,3000,3000,0,646,84,6,120,60,26
2020,150000362,8540,8540,1540,1540,7000,0,0,0,0,0,0,0,0,0,5600,5600,0,5600,2069,328,5,96,192,21
2020,150000372,29509,11759,11759,11759,0,17750,17400,17000,400,0,350,350,0,0,150,150,0,150,3429,384,180,300,120,429
2020,150000382,36000,20000,20000,20000,0,16000,16000,16000,0,0,0,0,0,0,0,0,0,0,1383,216,150,0,12,18
2020,150600211,4680,4680,3680,3680,1000,0,0,0,0,0,0,0,0,0,3186,3186,0,306,3303,645,70,120,420,1
2020,150600221,230,230,10,10,220,0,0,0,0,0,0,0,0,0,80,80,0,0,654,144,60,10,15,0
2020,150600231,44280,734,734,734,0,43546,32000,32000,0,0,11546,2546,0,9000,40259,40259,27870,1080,3408,360,240,720,408,340
2020,150600251,92990,16790,16790,16790,0,76200,73500,73500,0,0,2700,2200,500,0,13600,13600,13600,0,4560,360,200,120,100,197
2020,150600281,13400,400,400,400,0,13000,13000,13000,0,0,0,0,0,0,1000,0,0,0,283,65,30,12,16,31
2020,150600311,16664,484,484,484,0,16180,16000,10000,6000,0,180,180,0,0,0,0,0,0,1685,230,80,150,180,44
2020,150600321,24086,6686,6686,6686,0,17400,16000,16000,0,0,1400,1400,0,0,1820,1820,820,1000,2710,350,120,300,240,73
2020,150600331,30232,16932,16932,16932,0,13300,13000,8000,5000,0,300,300,0,0,0,0,0,0,1720,208,400,150,60,25
2020,150600341,70,70,70,70,0,0,0,0,0,0,0,0,0,0,0,0,0,0,730,150,20,10,30,2
2020,150600351,20,20,20,20,0,0,0,0,0,0,0,0,0,0,0,0,0,0,430,100,50,20,20,1
2020,150600361,18132,3632,3632,3632,0,14500,12000,12000,0,0,2500,2500,0,0,4466,4466,4466,0,1636,200,100,230,120,67
2020,150600371,2670,490,490,490,0,2180,2000,2000,0,0,180,0,180,0,0,0,0,0,998,150,290,34,54,5
2020,150600391,24100,3700,3700,3700,0,20400,19500,13000,6500,0,900,400,500,0,0,0,0,0,2317,300,120,180,144,41
2020,150700231,10490,10030,7030,7030,3000,460,0,0,0,0,460,460,0,0,1300,1300,0,0,2470,500,50,150,150,22
2020,150700241,1670,1670,670,670,1000,0,0,0,0,0,0,0,0,0,0,0,0,0,2802,240,420,110,252,57
2020,150700251,7480,80,80,80,0,7400,7000,7000,0,0,400,400,0,0,0,0,0,0,1830,100,50,200,150,89
2020,150700261,9451,3361,3361,3361,0,6090,6000,6000,0,0,90,0,90,0,900,900,500,0,1306,270,100,50,36,6
2020,150700281,7048,248,248,248,0,6800,5000,5000,0,0,1800,1400,400,0,0,0,0,0,2786,434,10,600,132,159
2020,150700291,20180,680,680,680,0,19500,19000,19000,0,0,500,500,0,0,8826,8826,8826,0,1738,300,20,120,48,61
2020,150700311,21780,6930,6930,6930,0,14850,12000,12000,0,0,2850,1550,0,1300,0,0,0,0,5661,420,144,348,499,228
2020,150700331,30620,16870,16870,3870,0,13750,13000,13000,0,0,750,750,0,0,1200,1200,1200,0,3127,170,305,420,156,221
2020,150700341,29106,10506,10506,10506,0,18600,14500,14500,0,0,4100,2100,0,2000,6499,6499,6480,0,3009,228,165,237,240,47
2020,150700351,1500,1250,750,750,500,250,0,0,0,0,250,250,0,0,0,0,0,0,1310,300,200,150,60,50
2020,150700381,47016,16616,16616,16616,0,30400,27000,12000,15000,0,3400,3400,0,0,0,0,0,0,4500,300,150,510,240,1127
2020,150800201,8135,8135,2635,2635,5500,0,0,0,0,0,0,0,0,0,1513,1513,600,0,1664,360,10,84,110,0
2020,150800231,290,250,10,10,240,40,0,0,0,0,40,0,40,0,0,0,0,0,840,120,150,80,50,0
2020,150800241,30565,3265,3265,3265,0,27300,17500,16000,1500,0,9800,1800,0,8000,0,0,0,0,1311,190,72,84,41,18
2020,150800251,22260,3260,3260,3260,0,19000,19000,19000,0,0,0,0,0,0,31160,24160,2390,4270,1236,150,84,120,192,98
2020,150800271,400,400,100,100,300,0,0,0,0,0,0,0,0,0,2500,2500,0,2000,1476,600,60,0,96,100
2020,150800281,46440,1440,1440,1440,0,45000,45000,23000,22000,0,0,0,0,0,3550,550,0,500,1472,280,72,60,30,45
2020,150800321,33329,7077,7077,7077,0,26252,24000,12000,0,12000,2252,1800,452,0,1700,1700,1700,0,3140,400,150,350,300,214
2020,150800331,33138,21438,4438,4438,17000,11700,10000,0,0,10000,1700,1400,300,0,6000,6000,6000,0,3070,250,150,480,200,227
2020,150800341,28680,8180,8180,8180,0,20500,19000,16000,3000,0,1500,1500,0,0,5630,5630,4510,1120,8780,450,290,840,350,786
2020,150800361,72050,16150,8150,8150,8000,55900,55000,0,55000,0,900,400,500,0,0,0,0,0,3335,840,240,360,180,1513
2020,150900201,29282,6782,6782,6782,0,22500,21000,21000,0,0,1500,1500,0,0,0,0,0,0,3716,252,550,370,204,361
2020,150900211,134000,22500,22500,22500,0,111500,109000,26000,83000,0,2500,2500,0,0,15000,14000,14000,0,3396,408,360,480,108,194
2020,150900221,20930,230,230,230,0,20700,20000,20000,0,0,700,700,0,0,0,0,0,0,1283,174,240,180,72,23
2020,150900231,16566,16466,1466,1466,15000,100,0,0,0,0,100,100,0,0,5000,5000,5000,0,2340,150,100,200,100,25
2020,150900251,49810,11810,11810,11810,0,38000,35000,35000,0,0,3000,2600,400,0,9500,9500,9500,0,2890,320,50,300,120,574
2020,150900271,36895,295,295,295,0,36600,36000,36000,0,0,600,600,0,0,4000,4000,4000,0,1883,276,100,10,72,60
2020,150900301,152394,11764,11764,11764,0,140630,140000,100000,35000,5000,630,630,0,0,20000,17000,17000,0,2980,330,600,240,200,278
2020,150900321,85750,42600,42600,42600,0,43150,41000,21000,20000,0,2150,2150,0,0,0,0,0,0,2409,240,450,480,106,1000
2020,150900331,2292,2292,92,92,2200,0,0,0,0,0,0,0,0,0,0,0,0,0,1820,680,250,100,150,3
2020,150900341,185921,10521,10521,10521,0,175400,172500,28000,140500,4000,2900,2900,0,0,26600,14000,14000,0,3499,470,570,394,110,249
2020,150900351,2150,2150,1850,1850,300,0,0,0,0,0,0,0,0,0,0,0,0,0,1245,460,5,20,120,8
2020,150900361,27460,8410,8410,8410,0,19050,7250,7250,0,0,11800,800,0,11000,211,211,0,0,3210,264,20,400,120,55
2020,150900371,7300,50,50,50,0,7250,7250,7250,0,0,0,0,0,0,0,0,0,0,1082,172,100,30,120,8
2020,150900391,66600,8700,8700,8700,0,57900,52000,22000,30000,0,5900,2900,3000,0,15000,14000,14000,0,3760,360,100,800,200,1155
2020,151000202,27550,3050,3050,3050,0,24500,23000,23000,0,0,1500,1500,0,0,0,0,0,0,2296,300,100,360,60,69
2020,151000212,2100,1600,1100,1100,500,500,0,0,0,0,500,500,0,0,450,450,0,450,3764,588,276,570,300,83
2020,151000222,6750,5550,2550,2550,3000,1200,0,0,0,0,1200,1200,0,0,0,0,0,0,1574,144,120,360,102,61
2020,151000232,17121,15528,5528,4528,10000,1593,0,0,0,0,1593,1450,143,0,0,0,0,0,2620,300,60,600,180,69
2020,151000262,19235,7155,7155,7155,0,12080,12000,12000,0,0,80,80,0,0,2000,2000,2000,0,3388,324,28,276,120,229
2020,151000272,66477,8277,8277,8277,0,58200,48000,32000,16000,0,10200,900,0,9300,540,540,540,0,2400,210,120,60,150,66
2020,151000282,32320,1320,1320,1320,0,31000,30000,30000,0,0,1000,1000,0,0,0,0,0,0,2570,240,30,120,120,104
2020,151000302,3074,1074,574,574,500,2000,0,0,0,0,2000,2000,0,0,1300,1300,0,0,1694,528,5,120,96,49
2020,151000332,13048,12798,1798,1798,11000,250,0,0,0,0,250,250,0,0,9000,9000,9000,0,2515,329,120,270,320,245
2020,151000362,18918,4718,4718,4718,0,14200,10000,4000,6000,0,4200,1200,3000,0,5000,5000,5000,0,2200,150,70,290,130,87
2020,151000392,61190,47990,47990,47990,0,13200,10000,10000,0,0,3200,3200,0,0,0,0,0,0,3444,252,50,300,192,1149
2020,151600201,510,510,10,10,500,0,0,0,0,0,0,0,0,0,0,0,0,0,585,160,20,15,15,0
2020,151600221,2785,2785,1785,1785,1000,0,0,0,0,0,0,0,0,0,2500,2500,0,0,678,84,40,50,60,1
2020,151600231,234480,52880,52880,49880,0,181600,172000,90000,80000,2000,9600,1600,8000,0,5000,0,0,0,6754,500,300,500,50,1522
2020,151600261,767,757,257,257,500,10,0,0,0,0,10,0,10,0,25,25,0,0,2970,720,40,480,180,99
2020,151600271,12010,10,10,10,0,12000,12000,12000,0,0,0,0,0,0,1210,1210,1210,0,412,160,72,20,15,21
2020,151600291,196,196,2,2,194,0,0,0,0,0,0,0,0,0,0,0,0,0,632,168,30,30,24,1
2020,151600301,3530,1860,1260,1260,600,1670,0,0,0,0,1670,1670,0,0,0,0,0,0,3350,750,100,350,250,105
2020,151600311,79016,13116,13116,13116,0,65900,64500,26500,38000,0,1400,1400,0,0,41400,12900,12900,0,2670,210,30,120,216,342
2020,151600321,15272,5052,5052,5052,0,10220,10000,10000,0,0,220,220,0,0,8020,8020,5720,2300,1424,188,340,220,96,61
2020,151600331,26084,3304,3304,3304,0,22780,21000,21000,0,0,1780,1600,180,0,9934,9934,9664,270,3304,360,50,350,300,55
2020,151600371,23148,3248,3248,3248,0,19900,19000,19000,0,0,900,900,0,0,5880,5880,5880,0,2930,320,50,420,280,762
2020,151600381,29390,3690,3690,1190,0,25700,22500,20000,0,2500,3200,1000,200,2000,3000,3000,3000,0,2753,420,147,280,136,213
2020,151700241,17143,2543,2543,2543,0,14600,14500,14500,0,0,100,100,0,0,0,0,0,0,1261,225,80,190,63,61
2020,151700281,4285,4205,205,205,4000,80,0,0,0,0,80,80,0,0,4000,4000,4000,0,1502,144,24,300,120,35
2020,151700301,15350,350,350,350,0,15000,15000,5000,10000,0,0,0,0,0,0,0,0,0,845,160,100,30,30,9
2020,151700311,35623,9723,9723,9723,0,25900,11000,11000,0,0,14900,3900,0,11000,5550,5550,4550,0,2606,360,90,564,240,56
2020,151700321,60,60,60,60,0,0,0,0,0,0,0,0,0,0,0,0,0,0,726,160,50,60,36,1
2020,151700331,1570,1430,930,930,500,140,0,0,0,0,140,140,0,0,231,231,0,0,2278,288,120,180,60,20
2020,151700341,17620,17520,12520,2520,5000,100,0,0,0,0,100,100,0,0,4090,4090,3640,450,930,100,10,200,100,29
2020,151700351,43140,2590,2590,2590,0,40550,29000,29000,0,0,11550,1500,550,9500,0,0,0,0,1550,150,60,100,80,44
2020,151700361,2933,1733,733,733,1000,1200,0,0,0,0,1200,1200,0,0,1590,1590,0,0,3618,648,10,240,180,1
2020,151700371,393260,24520,24520,24520,0,368740,146000,10000,136000,0,222740,8700,214040,0,100000,100000,80000,20000,2125,240,5,280,100,250
2020,151700391,248900,90500,90500,90500,0,158400,141000,20000,121000,0,17400,2400,15000,0,2700,0,0,0,7510,360,1200,550,240,3453
2020,151800201,12610,2610,2610,2610,0,10000,10000,10000,0,0,0,0,0,0,0,0,0,0,2400,300,1000,36,24,23
2020,151800211,20310,2760,2760,2760,0,17550,17000,17000,0,0,550,550,0,0,5800,5800,3800,0,1940,200,50,200,110,86
2020,151800231,120473,310,310,310,0,120163,120000,100000,20000,0,163,50,113,0,49000,24000,20000,4000,1053,120,360,120,48,148
2020,151800241,4002,4002,3502,3502,500,0,0,0,0,0,0,0,0,0,0,0,0,0,551,240,0,10,12,1
2020,151800291,40252,17852,17852,17852,0,22400,20000,20000,0,0,2400,1800,600,0,1700,1700,1700,0,4720,480,50,400,240,110
2020,151800301,35763,6263,6263,6263,0,29500,26000,26000,0,0,3500,3500,0,0,16550,16550,12850,3700,3278,240,120,120,108,665
2020,151800321,16380,1980,1980,1980,0,14400,14400,6400,8000,0,0,0,0,0,500,0,0,0,3012,1206,60,60,36,15
2020,151800331,5980,4980,4980,4980,0,1000,0,0,0,0,1000,1000,0,0,0,0,0,0,1554,180,60,480,84,12
2020,151800341,5850,50,50,50,0,5800,5000,5000,0,0,800,800,0,0,500,500,0,0,718,120,20,240,48,46
2020,151800351,32620,3000,3000,3000,0,29620,29500,5500,24000,0,120,0,120,0,0,0,0,0,1200,240,360,50,120,19
2020,151800361,1230,1230,30,30,1200,0,0,0,0,0,0,0,0,0,0,0,0,0,581,260,80,10,18,1
2020,151900201,6050,6050,50,50,6000,0,0,0,0,0,0,0,0,0,0,0,0,0,358,72,24,24,26,1
2020,151900211,12650,12050,3950,3950,8100,600,0,0,0,0,600,600,0,0,6100,6100,6100,0,2278,480,24,360,180,43
2020,151900221,24130,130,130,130,0,24000,24000,24000,0,0,0,0,0,0,700,0,0,0,659,80,44,60,40,18
2020,151900241,28700,11900,11900,11400,0,16800,10000,10000,0,0,6800,1800,5000,0,0,0,0,0,1754,240,30,400,144,100
2020,151900261,32422,7622,7622,7622,0,24800,24000,24000,0,0,800,800,0,0,0,0,0,0,2070,240,180,340,150,163
2020,151900271,107778,10650,10650,10650,0,97128,96000,90000,6000,0,1128,450,678,0,0,0,0,0,4518,432,120,120,96,130
2020,151900281,19490,9040,9040,9040,0,10450,10000,10000,0,0,450,450,0,0,0,0,0,0,1450,143,10,162,116,42
2020,151900291,99170,34895,16895,16895,18000,64275,60000,0,60000,0,4275,2700,1575,0,5000,0,0,0,7995,360,1200,396,120,1126
2020,151900311,31870,570,570,570,0,31300,30600,5000,25600,0,700,700,0,0,2500,2500,0,2500,2270,180,30,300,170,353
2020,151900321,11200,200,200,200,0,11000,11000,4000,7000,0,0,0,0,0,0,0,0,0,655,100,200,50,30,3
2020,151900341,1186,1186,1186,1186,0,0,0,0,0,0,0,0,0,0,1890,1890,490,1400,1708,150,126,240,192,15
2020,151900371,15220,40,40,40,0,15180,15000,15000,0,0,180,0,180,0,10000,10000,10000,0,2230,240,40,60,300,12
2020,151900391,54024,3024,3024,3024,0,51000,50000,5000,45000,0,1000,1000,0,0,1200,1200,0,1000,1994,279,96,480,84,67
2020,152000202,123240,3550,3550,3550,0,119690,119500,59500,60000,0,190,190,0,0,43000,22000,22000,0,4843,420,12,180,218,707
2020,152000232,83205,12625,12625,12625,0,70580,65000,65000,0,0,5580,2580,3000,0,28137,28137,26937,0,7328,360,260,408,360,536
2020,152000242,82560,22160,22160,22160,0,60400,59400,25000,34400,0,1000,1000,0,0,3400,3400,0,3400,8000,1400,300,500,400,1412
2020,152000252,68246,37156,18156,13156,19000,31090,30640,0,10000,20640,450,250,200,0,28282,28282,7642,20640,6300,350,300,600,250,1411
2020,152000262,6920,2720,2220,2220,500,4200,0,0,0,0,4200,4200,0,0,0,0,0,0,2172,456,120,240,96,139
2020,152000272,210100,27300,27300,25800,0,182800,174500,50500,100000,24000,8300,8300,0,0,42000,24000,0,24000,3527,276,120,1200,96,375
2020,152000302,5602,4102,2,2,4100,1500,0,0,0,0,1500,1500,0,0,0,0,0,0,1770,500,5,360,120,25
2020,152000312,4710,4410,210,210,4200,300,100,0,100,0,200,200,0,0,3200,3200,0,1600,1236,160,360,240,96,90
2020,152000322,4600,3700,1700,1700,2000,900,0,0,0,0,900,800,100,0,0,0,0,0,2824,960,200,360,144,165
2020,152000342,31085,4750,4750,4630,0,26335,23000,3000,20000,0,3335,1300,2035,0,0,0,0,0,3136,214,320,420,168,96
2020,152000352,16697,3352,3352,3352,0,13345,12000,12000,0,0,1345,1230,115,0,10800,10800,9000,300,1995,190,20,180,220,65
2020,152000372,8900,2350,2350,2350,0,6550,6000,6000,0,0,550,550,0,0,250,250,0,250,9774,104,8000,300,240,39
2020,152000382,11676,350,350,350,0,11326,10800,800,10000,0,526,300,226,0,3050,50,0,0,1134,220,150,120,54,34
2020,152000392,20305,1505,1505,1205,0,18800,9000,2000,7000,0,9800,6800,3000,0,2400,2400,0,0,3483,776,207,480,240,225
2020,152600211,950,450,150,150,300,500,0,0,0,0,500,500,0,0,380,380,0,380,1816,200,20,360,156,32
2020,152600231,96896,25696,25696,25696,0,71200,70000,60000,10000,0,1200,400,800,0,0,0,0,0,1948,480,180,240,108,320
2020,152600271,17050,8650,8650,8650,0,8400,8000,8000,0,0,400,400,0,0,0,0,0,0,1646,240,120,180,120,37
2020,152600281,562,562,2,2,560,0,0,0,0,0,0,0,0,0,0,0,0,0,569,88,132,72,24,1
2020,152600291,20490,7340,7340,7340,0,13150,12800,12800,0,0,350,350,0,0,0,0,0,0,3020,24,2500,20,72,126
2020,152600301,8740,7590,5090,5090,2500,1150,1000,0,1000,0,150,0,150,0,700,700,0,700,2220,280,70,300,250,244
2020,152600311,15879,3764,3764,3764,0,12115,12000,12000,0,0,115,0,115,0,0,0,0,0,1559,516,10,15,48,11
2020,152600321,6790,170,170,170,0,6620,6600,1600,5000,0,20,0,20,0,0,0,0,0,1142,200,360,20,72,6
2020,152600331,26730,2880,2880,2880,0,23850,12000,7000,5000,0,11850,550,11300,0,0,0,0,0,2550,480,360,300,60,36
2020,152600361,23,23,23,23,0,0,0,0,0,0,0,0,0,0,0,0,0,0,378,110,66,10,32,1
2020,152600371,4500,500,500,500,0,4000,4000,4000,0,0,0,0,0,0,0,0,0,0,320,100,40,10,20,19
2020,152700231,113270,7570,7570,7570,0,105700,100000,85000,15000,0,5700,5700,0,0,4550,4550,2450,1000,3548,264,150,250,120,1097
2020,152700251,9761,7261,5261,5261,2000,2500,0,0,0,0,2500,2500,0,0,1010,1010,0,0,4350,600,50,500,250,107
2020,152700261,49290,14790,14790,12790,0,34500,29000,29000,0,0,5500,2500,3000,0,12900,12900,10400,2500,3400,400,200,300,100,844
2020,152700271,18266,16766,4266,4266,12500,1500,0,0,0,0,1500,1500,0,0,7455,7455,6100,1355,3572,528,96,300,91,373
2020,152700281,1380,1280,1280,1280,0,100,0,0,0,0,100,100,0,0,0,0,0,0,1040,300,30,50,48,788
2020,152700301,8202,4202,4202,4202,0,4000,4000,4000,0,0,0,0,0,0,0,0,0,0,1030,108,36,70,126,2
2020,152700311,63510,3510,3510,3510,0,60000,45000,10000,35000,0,15000,500,14500,0,42900,42900,30000,2000,2080,360,40,300,300,56
2020,152700321,250,250,250,250,0,0,0,0,0,0,0,0,0,0,0,0,0,0,327,50,15,36,12,0
2020,152700331,28504,24224,4224,4224,20000,4280,0,0,0,0,4280,4280,0,0,2000,2000,0,2000,4630,216,150,1000,144,194
2020,152700341,29340,5240,5240,5240,0,24100,21500,21500,0,0,2600,2200,400,0,11748,11748,11748,0,2998,200,30,300,108,111
2020,152700371,6520,700,700,700,0,5820,5000,1000,4000,0,820,800,20,0,0,0,0,0,1948,118,1320,180,60,19
2020,152800221,23574,1574,1574,1574,0,22000,22000,22000,0,0,0,0,0,0,0,0,0,0,1358,180,10,120,48,259
2020,152800241,107636,48846,48846,48846,0,58790,56400,46000,10400,0,2390,2090,300,0,0,0,0,0,4890,360,80,550,100,356
2020,152800301,83190,13470,13470,13470,0,69720,67000,15000,52000,0,2720,2100,620,0,15000,8000,8000,0,4470,360,100,640,360,569
2020,152800331,150,150,150,150,0,0,0,0,0,0,0,0,0,0,0,0,0,0,647,176,120,96,24,1
2020,152800341,100,100,100,100,0,0,0,0,0,0,0,0,0,0,0,0,0,0,510,170,120,20,20,1
2020,152800351,15720,1120,1120,1120,0,14600,14600,1600,13000,0,0,0,0,0,0,0,0,0,489,102,120,24,41,60
2020,152800361,7132,470,470,470,0,6662,6662,662,6000,0,0,0,0,0,0,0,0,0,516,108,160,24,44,6
2020,152800371,1850,1550,550,550,1000,300,0,0,0,0,300,300,0,0,0,0,0,0,950,96,36,240,96,26
2020,152900201,68216,37116,12116,12116,25000,31100,30400,0,0,30400,700,700,0,0,26600,26600,0,26600,4408,300,130,360,150,189
2020,152900221,21860,14460,7460,7460,7000,7400,6500,0,6500,0,900,900,0,0,0,0,0,0,3350,600,30,130,140,186
2020,152900231,43314,3214,3214,3214,0,40100,40000,40000,0,0,100,100,0,0,0,0,0,0,2544,300,60,240,144,88
2020,152900271,27125,15350,5850,5850,9500,11775,11600,0,3000,8600,175,0,175,0,9916,9916,3750,6166,2380,220,320,110,200,91
2020,152900291,10490,8660,3660,1660,5000,1830,0,0,0,0,1830,230,1600,0,2050,2050,1500,0,1690,180,200,130,120,467
2020,152900301,118,118,118,118,0,0,0,0,0,0,0,0,0,0,50,50,0,0,648,98,20,28,34,1
2020,152900311,19010,10,10,10,0,19000,19000,7000,12000,0,0,0,0,0,0,0,0,0,368,120,60,24,24,5
2020,152900321,340,340,40,40,300,0,0,0,0,0,0,0,0,0,0,0,0,0,1456,120,30,50,36,1
2020,152900341,4,4,4,4,0,0,0,0,0,0,0,0,0,0,1500,1500,0,0,898,334,180,29,57,0
2020,152900371,27380,5600,5600,5600,0,21780,18700,10000,8700,0,3080,2000,1080,0,0,0,0,0,2070,180,180,380,180,58
2020,153000222,28200,300,300,300,0,27900,27000,15000,12000,0,900,900,0,0,1000,0,0,0,856,114,132,84,54,53
2020,153000232,12380,4030,4030,4030,0,8350,8000,8000,0,0,350,150,200,0,0,0,0,0,1252,240,150,180,72,118
2020,153700221,53964,2364,2364,2364,0,51600,50000,50000,0,0,1600,1600,0,0,20100,20100,19700,0,2144,360,200,240,144,237
2020,153800201,30550,1550,1550,1550,0,29000,26000,26000,0,0,3000,3000,0,0,0,0,0,0,2328,300,100,200,100,30
2020,160000202,14960,14300,1300,1300,13000,660,0,0,0,0,660,600,60,0,0,0,0,0,2812,240,600,156,360,23
2020,160000222,3765,3465,1465,1465,2000,300,0,0,0,0,300,300,0,0,2276,2276,0,2126,3710,540,100,860,300,26
2020,160000232,76970,13970,13970,13970,0,63000,61000,36000,25000,0,2000,2000,0,0,11260,11260,11000,0,3356,456,120,480,240,275
2020,160000242,5244,2244,1244,1244,1000,3000,2000,0,2000,0,1000,1000,0,0,0,0,0,0,2422,660,30,120,192,14
2020,160000262,21984,1984,1984,1984,0,20000,19000,19000,0,0,1000,1000,0,0,0,0,0,0,1092,168,10,120,240,57
2020,160000272,36440,35140,5140,5140,30000,1300,0,0,0,0,1300,1300,0,0,80,80,0,0,3350,360,500,300,250,324
2020,160000282,115400,1700,1700,1700,0,113700,111000,41000,70000,0,2700,2700,0,0,65750,63750,58750,5000,2030,480,120,480,240,491
2020,160000292,23240,1640,1640,1640,0,21600,20000,20000,0,0,1600,1600,0,0,10000,10000,10000,0,2134,264,100,240,240,163
2020,160000312,52915,10615,10615,8115,0,42300,42000,12000,30000,0,300,300,0,0,0,0,0,0,1538,240,52,65,204,44
2020,160000322,1,1,1,1,0,0,0,0,0,0,0,0,0,0,0,0,0,0,605,240,0,60,5,1
2020,160000332,145223,77737,77737,77737,0,67486,63000,20000,43000,0,4486,2000,2486,0,200,200,0,200,7545,420,160,50,312,2345
2020,160000342,4100,100,100,100,0,4000,4000,4000,0,0,0,0,0,0,0,0,0,0,621,80,102,6,60,5
2020,160000352,23614,7914,7914,6914,0,15700,13500,10000,3500,0,2200,2200,0,0,0,0,0,0,1000,204,40,300,80,44
2020,160000362,54160,11910,5510,5510,6400,42250,35000,0,35000,0,7250,1250,3000,3000,1000,0,0,0,2554,144,500,352,108,139
2020,160000372,16118,4118,4118,4118,0,12000,11000,11000,0,0,1000,1000,0,0,0,0,0,0,1868,192,100,220,96,89
2020,160000382,3210,3210,1210,1210,2000,0,0,0,0,0,0,0,0,0,0,0,0,0,2492,1092,120,120,120,1
2020,160000392,90276,3976,3976,3976,0,86300,75000,45000,30000,0,11300,5300,6000,0,18500,18000,15000,0,5820,720,120,720,480,213
2020,160600211,3025,2925,1825,1825,1100,100,0,0,0,0,100,0,100,0,500,500,0,0,1339,336,240,84,42,1
2020,160600221,44250,33040,16040,15040,17000,11210,3500,0,0,3500,7710,7500,210,0,0,0,0,0,3360,240,500,360,140,62
2020,160600231,56930,36230,9230,8230,27000,20700,8000,0,8000,0,12700,1500,1200,10000,7300,6600,5000,1600,2900,450,200,250,300,66
2020,160600241,1610,1310,310,310,1000,300,0,0,0,0,300,300,0,0,0,0,0,0,2784,660,120,240,360,65
2020,160600261,112196,7628,7628,7628,0,104568,100000,80000,20000,0,4568,4500,68,0,6876,4876,1296,0,5714,480,1024,360,240,516
2020,160600271,10552,10472,8472,8472,2000,80,0,0,0,0,80,80,0,0,0,0,0,0,4058,840,360,120,144,35
2020,160600281,40580,10380,10380,6380,0,30200,30000,30000,0,0,200,200,0,0,20000,20000,20000,0,2530,360,50,180,240,152
2020,160600311,37100,1000,1000,0,0,36100,33000,10000,23000,0,3100,2100,1000,0,7000,6000,0,6000,2410,240,1500,200,130,97
2020,160600321,2588,2588,2588,2588,0,0,0,0,0,0,0,0,0,0,0,0,0,0,1208,137,100,120,42,36
2020,160600331,87344,36844,36844,36844,0,50500,45000,0,45000,0,5500,5500,0,0,40330,40330,20000,17950,7174,300,480,600,600,437
2020,160600351,7942,442,442,442,0,7500,7500,7500,0,0,0,0,0,0,0,0,0,0,753,250,100,45,18,3
2020,160600371,7289,6739,4239,4239,2500,550,0,0,0,0,550,0,550,0,0,0,0,0,1872,906,55,36,75,228
2020,160600391,46452,12202,12202,12202,0,34250,33000,0,33000,0,1250,1250,0,0,16000,0,0,0,4353,440,32,291,184,415
2020,160700211,19330,5250,5250,5250,0,14080,14000,14000,0,0,80,80,0,0,0,0,0,0,852,70,90,100,32,32
2020,160700221,440,440,440,440,0,0,0,0,0,0,0,0,0,0,0,0,0,0,1266,150,240,120,36,2
2020,160700231,44355,3355,3355,3355,0,41000,36000,36000,0,0,5000,2000,3000,0,34520,34520,24000,4940,4790,300,240,600,400,649
2020,160700241,198411,11011,11011,11011,0,187400,182000,45000,137000,0,5400,5400,0,0,110802,56802,46802,10000,4090,620,310,430,200,1381
2020,160700281,75601,12401,12401,12401,0,63200,60000,60000,0,0,3200,3200,0,0,0,0,0,0,5230,300,50,360,180,473
2020,160700291,73752,16252,16252,16252,0,57500,57000,22000,35000,0,500,200,300,0,22000,0,0,0,2580,180,150,300,120,894
2020,160700331,67920,12770,12770,12770,0,55150,51800,19000,29000,3800,3350,3350,0,0,17800,17800,17400,0,2272,150,100,500,72,276
2020,160700341,9720,420,420,420,0,9300,9000,9000,0,0,300,0,300,0,0,0,0,0,940,164,278,42,48,7
2020,160700351,810,810,810,810,0,0,0,0,0,0,0,0,0,0,0,0,0,0,854,76,100,42,36,3
2020,160700371,454,254,254,254,0,200,0,0,0,0,200,0,200,0,0,0,0,0,582,78,141,30,18,1
2020,160800201,7581,7581,81,81,7500,0,0,0,0,0,0,0,0,0,0,0,0,0,1030,100,100,12,18,1
2020,160800211,25138,238,238,238,0,24900,24900,24900,0,0,0,0,0,0,6000,2500,2500,0,1020,200,50,40,60,27
2020,160800221,10070,9090,90,90,9000,980,0,0,0,0,980,980,0,0,40,40,0,0,1512,144,30,240,98,21
2020,160800231,117229,15929,15929,15929,0,101300,100000,50000,50000,0,1300,1300,0,0,2000,0,0,0,5160,480,120,360,120,2220
2020,160800251,44358,2608,2608,608,0,41750,40000,40000,0,0,1750,1500,250,0,1000,0,0,0,1400,240,50,120,60,46
2020,160800261,77086,23186,23186,23186,0,53900,53000,53000,0,0,900,750,150,0,0,0,0,0,8010,400,1800,500,300,3520
2020,160800271,32100,300,300,300,0,31800,30000,30000,0,0,1800,1800,0,0,1000,1000,1000,0,1930,150,10,200,120,97
2020,160800281,76340,14040,14040,14040,0,62300,62000,25000,37000,0,300,100,200,0,9000,9000,9000,0,1310,200,130,140,90,62
2020,160800291,50800,10300,10300,8300,0,40500,39500,30000,9500,0,1000,900,100,0,11500,7500,7500,0,3975,300,30,360,300,2171
2020,160800301,3512,2712,1712,1712,1000,800,0,0,0,0,800,800,0,0,0,0,0,0,920,100,100,260,40,33
2020,160800311,15151,7151,7151,7151,0,8000,8000,3000,5000,0,0,0,0,0,0,0,0,0,943,153,32,120,158,66
2020,160800341,202516,45016,45016,45016,0,157500,120000,120000,0,0,37500,5000,32500,0,52000,48000,48000,0,6560,600,300,200,300,938
2020,160800351,15817,6712,6712,6712,0,9105,5000,5000,0,0,4105,3135,970,0,0,0,0,0,3350,250,380,440,240,451
2020,160800361,19296,8846,8846,2546,0,10450,10000,7000,3000,0,450,450,0,0,0,0,0,0,3855,290,360,640,180,107
2020,160800371,630,630,630,630,0,0,0,0,0,0,0,0,0,0,0,0,0,0,1443,120,690,60,23,1
2020,160800381,15540,3590,3590,3590,0,11950,11000,11000,0,0,950,950,0,0,1800,1800,1800,0,2244,144,560,240,120,65
2020,160800391,11150,150,150,150,0,11000,11000,11000,0,0,0,0,0,0,100,0,0,0,773,180,150,42,36,10
2020,160900201,12050,2050,2050,2050,0,10000,10000,10000,0,0,0,0,0,0,0,0,0,0,432,60,12,12,18,31
2020,160900211,31703,1703,1703,1703,0,30000,30000,0,30000,0,0,0,0,0,3500,2500,2500,0,1408,250,250,60,48,888
2020,160900221,73660,6360,6360,6360,0,67300,67000,16000,51000,0,300,200,100,0,44900,35000,35000,0,2020,240,20,480,180,1772
2020,160900231,138164,25064,25064,16064,0,113100,42000,42000,0,0,71100,7100,25000,39000,26840,26840,21000,0,6330,430,170,470,620,3745
2020,160900241,18100,100,100,100,0,18000,18000,18000,0,0,0,0,0,0,4550,4550,4550,0,913,180,120,15,48,28
2020,160900251,100141,16721,16721,16721,0,83420,78000,28000,50000,0,5420,4900,520,0,6000,6000,6000,0,3900,300,120,360,600,5153
2020,160900271,385,385,155,55,230,0,0,0,0,0,0,0,0,0,0,0,0,0,1619,550,5,54,170,2
2020,160900291,4717,4717,217,217,4500,0,0,0,0,0,0,0,0,0,0,0,0,0,1252,528,120,72,72,1
2020,160900301,18399,8399,8399,8399,0,10000,10000,10000,0,0,0,0,0,0,20,20,0,0,734,270,120,10,30,35
2020,160900341,27510,7260,7260,7260,0,20250,17000,17000,0,0,3250,3250,0,0,2712,2712,0,0,3488,260,24,480,360,204
2020,160900361,100976,30100,30100,30100,0,70876,70000,35000,35000,0,876,650,226,0,0,0,0,0,3210,180,360,360,240,47
2020,160900381,18938,3088,3088,3088,0,15850,15000,15000,0,0,850,850,0,0,7210,7210,7100,100,3152,216,20,480,252,96
2020,160900391,54366,22510,22510,22510,0,31856,26000,14000,12000,0,5856,4500,1356,0,890,890,0,0,3825,252,600,672,262,525
2020,161000202,35332,3832,3832,3832,0,31500,30000,30000,0,0,1500,1500,0,0,20560,20560,19560,1000,2230,300,100,240,240,137
2020,161000212,40318,1068,1068,1068,0,39250,35000,30000,5000,0,4250,2150,2100,0,10300,10300,10000,0,3740,300,120,240,240,659
2020,161000222,38500,18500,500,500,18000,20000,0,0,0,0,20000,0,20000,0,16000,16000,0,0,3275,51,100,100,204,27
2020,161000232,20660,1160,1160,1160,0,19500,18000,18000,0,0,1500,1500,0,0,0,0,0,0,1750,180,300,200,30,51
2020,161000252,1690,1690,1490,1490,200,0,0,0,0,0,0,0,0,0,0,0,0,0,790,228,5,10,42,2
2020,161000262,10943,3743,3743,3743,0,7200,7000,7000,0,0,200,200,0,0,6200,6200,6200,0,2180,180,50,150,170,32
2020,161000272,5660,1160,160,160,1000,4500,0,0,0,0,4500,4500,0,0,3700,3700,0,0,2788,504,1000,180,120,73
2020,161000282,121260,3160,3160,3160,0,118100,97000,40000,57000,0,21100,0,21100,0,32000,32000,25000,7000,2715,240,150,55,300,188
2020,161000302,13315,3200,3200,3200,0,10115,9700,200,9500,0,415,300,115,0,0,0,0,0,1287,60,32,380,108,47
2020,161000312,16464,3864,3864,3864,0,12600,10000,7000,0,3000,2600,2600,0,0,500,500,0,500,4364,480,300,780,120,1068
2020,161000322,3307,3007,3007,3007,0,300,0,0,0,0,300,300,0,0,4700,4700,2400,1000,3775,270,300,680,400,16
2020,161000332,2216,216,216,216,0,2000,2000,2000,0,0,0,0,0,0,400,400,0,0,601,96,10,12,3,1
2020,161000342,14401,12808,808,808,12000,1593,0,0,0,0,1593,1495,98,0,1100,1100,0,0,2852,228,72,288,156,73
2020,161000352,22322,17722,2772,2772,14950,4600,3000,0,0,3000,1600,1600,0,0,9900,9900,9900,0,1827,240,120,180,120,56
2020,161000362,27217,18861,18861,18861,0,8356,7000,7000,0,0,1356,960,396,0,0,0,0,0,3897,207,684,956,174,265
2020,161000372,25983,1633,1633,1633,0,24350,0,0,0,0,24350,4300,20050,0,7700,7700,7700,0,2356,184,50,480,162,87
2020,161000382,3030,30,30,30,0,3000,3000,3000,0,0,0,0,0,0,0,0,0,0,320,76,40,10,24,3
2020,161600211,52334,29564,29564,27364,0,22770,22500,7500,15000,0,270,120,150,0,2000,2000,2000,0,1594,250,24,200,120,317
2020,161600231,12206,4006,4006,4006,0,8200,8000,8000,0,0,200,200,0,0,4400,4400,0,0,1350,230,50,120,100,275
2020,161600251,50585,4785,4785,4785,0,45800,43000,43000,0,0,2800,2550,250,0,0,0,0,0,4990,800,30,340,320,330
2020,161600261,17032,2882,2882,2882,0,14150,14000,14000,0,0,150,150,0,0,0,0,0,0,1353,85,50,180,168,43
2020,161600271,12770,8770,770,770,8000,4000,2000,0,2000,0,2000,2000,0,0,670,670,0,0,3580,152,350,250,270,485
2020,161600281,47148,2448,2448,2448,0,44700,43500,38000,5500,0,1200,200,1000,0,1465,465,0,465,1973,336,60,230,168,112
2020,161600301,59518,21878,21878,21878,0,37640,37000,32000,5000,0,640,400,240,0,30,30,0,0,2164,216,105,240,120,70
2020,161600311,69225,8265,8265,8065,0,60960,60500,32000,28500,0,460,460,0,0,1200,0,0,0,7626,1360,25,392,168,1400
2020,161600331,36350,1500,1500,500,0,34850,23000,23000,0,0,11850,2400,8450,1000,24722,24722,13232,8490,3088,252,120,240,144,217
2020,161600341,21824,21124,4624,4624,16500,700,0,0,0,0,700,700,0,0,5469,5469,0,0,2132,240,10,242,138,27
2020,161600351,23084,20645,5645,5645,15000,2439,0,0,0,0,2439,2050,389,0,7300,7300,7000,0,3281,240,25,600,312,148
2020,161600381,30951,1281,1281,1281,0,29670,29600,2100,27500,0,70,0,70,0,0,0,0,0,367,59,60,38,18,9
2020,161600391,19995,2129,2129,1829,0,17866,17000,17000,0,0,866,700,166,0,1700,1500,0,0,1721,168,150,330,156,49
2020,161700201,47322,10422,10422,10422,0,36900,32000,32000,0,0,4900,4400,500,0,10000,10000,0,10000,2510,160,30,300,120,550
2020,161700231,108538,23038,23038,23038,0,85500,78000,78000,0,0,7500,0,7500,0,23600,23600,23600,0,4280,270,100,130,400,6051
2020,161700241,610,610,110,110,500,0,0,0,0,0,0,0,0,0,0,0,0,0,720,240,100,100,70,1
2020,161700261,2483,2483,1533,1533,950,0,0,0,0,0,0,0,0,0,130,130,0,130,561,140,40,15,36,2
2020,161700281,13140,12890,2890,2890,10000,250,0,0,0,0,250,250,0,0,7000,7000,7000,0,2800,240,120,360,480,41
2020,161700291,8990,130,130,130,0,8860,8000,8000,0,0,860,750,110,0,800,800,800,0,1820,240,100,240,120,177
2020,161700301,252,252,252,252,0,0,0,0,0,0,0,0,0,0,0,0,0,0,872,136,60,48,48,1
2020,161700311,15975,4825,4825,3825,0,11150,10000,10000,0,0,1150,150,1000,0,0,0,0,0,1524,204,20,260,120,41
2020,161700321,23415,22945,6445,6445,16500,470,0,0,0,0,470,470,0,0,0,0,0,0,2776,180,10,386,200,116
2020,161700331,22161,7170,7170,7170,0,14991,14000,14000,0,0,991,591,400,0,1852,1852,1852,0,2099,216,24,300,204,43
2020,161700341,12342,12042,7942,7942,4100,300,0,0,0,0,300,300,0,0,20,20,0,0,2961,156,15,360,300,78
2020,161700351,47458,9665,9665,9665,0,37793,28200,15000,10100,3100,9593,9293,300,0,4700,4700,4700,0,2296,156,240,360,120,63
2020,161700361,6203,3823,3823,3823,0,2380,2000,2000,0,0,380,0,380,0,0,0,0,0,734,94,50,120,24,3
2020,161700371,16368,5920,5920,5920,0,10448,10000,8000,2000,0,448,300,148,0,3400,3400,2800,600,1459,254,38,250,162,34
2020,161700381,29405,7120,7120,7120,0,22285,10275,5000,5275,0,12010,1300,10710,0,0,0,0,0,1065,120,100,300,130,51
2020,161700391,2200,2200,2200,2200,0,0,0,0,0,0,0,0,0,0,0,0,0,0,530,100,100,15,20,1
2020,161800201,12885,11770,9770,5770,2000,1115,0,0,0,0,1115,0,115,1000,60,60,0,0,3125,780,100,50,360,111
2020,161800231,15494,4094,4094,4094,0,11400,10000,10000,0,0,1400,800,600,0,6801,6801,6401,300,2230,240,120,350,480,105
2020,161800241,16710,15310,7310,6310,8000,1400,0,0,0,0,1400,400,0,1000,0,0,0,0,1688,360,66,180,102,51
2020,161800251,71784,6154,6154,6154,0,65630,65000,15000,50000,0,630,630,0,0,0,0,0,0,3110,320,400,360,180,184
2020,161800271,81323,37423,37423,37423,0,43900,41000,21000,20000,0,2900,2700,200,0,0,0,0,0,2920,240,100,400,160,2321
2020,161800291,26910,10570,10570,7570,0,16340,16000,16000,0,0,340,300,40,0,7050,7050,5600,1450,4580,720,100,150,220,219
2020,161800301,71738,20058,20058,18058,0,51680,46000,38000,8000,0,5680,3680,1000,1000,1700,1700,0,0,6502,450,200,700,480,452
2020,161800311,5942,4842,1842,1842,3000,1100,0,0,0,0,1100,1100,0,0,3000,3000,0,3000,1854,180,60,180,120,286
2020,161800331,5928,5898,4398,4098,1500,30,0,0,0,0,30,0,30,0,0,0,0,0,654,204,1,72,72,2
2020,161800341,30515,5265,5265,5265,0,25250,24500,11000,13500,0,750,750,0,0,70,70,0,0,3846,550,200,340,240,136
2020,161800351,17298,4818,4818,4818,0,12480,11000,11000,0,0,1480,1300,180,0,1967,1967,1917,0,1915,420,150,210,168,43
2020,161800361,10680,1100,1100,1100,0,9580,9500,3500,6000,0,80,0,80,0,0,0,0,0,996,120,180,240,60,5
2020,161800381,40833,10007,10007,10007,0,30826,30000,9000,0,21000,826,600,226,0,13150,13150,1150,12000,2408,328,50,180,120,69
2020,161900201,5190,5190,2790,2790,2400,0,0,0,0,0,0,0,0,0,0,0,0,0,950,150,200,180,80,1
2020,161900211,7050,6950,5300,5300,1650,100,0,0,0,0,100,0,100,0,0,0,0,0,1240,200,400,100,50,1
2020,161900221,480,250,150,150,100,230,0,0,0,0,230,230,0,0,2785,2785,0,2245,1709,360,22,300,52,42
2020,161900231,4300,4050,1050,1050,3000,250,0,0,0,0,250,150,100,0,0,0,0,0,1190,336,38,156,120,40
2020,161900251,25280,280,280,280,0,25000,25000,25000,0,0,0,0,0,0,0,0,0,0,615,60,120,50,15,53
2020,161900271,5673,873,373,373,500,4800,4800,0,4800,0,0,0,0,0,40,40,0,0,1085,540,100,20,80,68
2020,161900281,37074,10274,10274,10274,0,26800,26000,26000,0,0,800,800,0,0,0,0,0,0,5020,360,3000,300,200,234
2020,161900291,58653,20903,20903,11403,0,37750,37000,34000,0,3000,750,550,200,0,11925,11925,10925,1000,7858,312,700,1100,456,1723
2020,161900311,1378,1332,1032,1032,300,46,0,0,0,0,46,0,46,0,100,100,0,0,1301,354,7,10,60,1
2020,161900321,23443,3424,3424,3424,0,20019,15600,1600,14000,0,4419,80,4339,0,1700,1700,0,1700,2520,546,900,360,32,20
2020,161900351,22275,2865,2865,2865,0,19410,18000,18000,0,0,1410,1300,110,0,820,820,700,0,4074,294,100,200,230,761
2020,161900361,77512,11102,11102,10634,0,66410,52800,2850,49950,0,13610,2570,11040,0,10160,10160,10160,0,2370,250,300,480,130,252
2020,161900371,4580,80,80,80,0,4500,4500,4500,0,0,0,0,0,0,180,180,0,180,665,145,88,14,58,6
2020,161900381,5250,1400,1400,1400,0,3850,3600,2000,1600,0,250,0,250,0,0,0,0,0,783,139,120,72,42,3
2020,161900391,6240,1090,1090,1090,0,5150,5000,5000,0,0,150,0,150,0,0,0,0,0,812,60,260,10,60,4
2020,162000302,15982,4240,4240,4240,0,11742,3000,3000,0,0,8742,1500,7242,0,1000,1000,1000,0,3864,384,2240,306,144,32
2020,162000322,38169,15969,15969,10969,0,22200,18500,18500,0,0,3700,700,3000,0,0,0,0,0,2020,300,10,130,180,752
2020,162000342,12114,5024,5024,5024,0,7090,6440,2000,4440,0,650,600,50,0,0,0,0,0,1046,84,120,240,72,47
2020,162000352,10701,301,301,301,0,10400,10400,2000,8400,0,0,0,0,0,0,0,0,0,1208,123,58,27,19,4
2020,162000362,9740,1290,1290,1290,0,8450,8400,900,7500,0,50,0,50,0,0,0,0,0,371,60,132,24,5,4
2020,162000372,1,1,1,1,0,0,0,0,0,0,0,0,0,0,0,0,0,0,465,134,36,40,0,1
2020,162600301,33264,6132,6132,6132,0,27132,27000,10000,17000,0,132,0,132,0,0,0,0,0,826,50,100,120,36,52
2020,162600311,6891,223,223,223,0,6668,6600,1700,4900,0,68,0,68,0,1000,1000,1000,0,591,75,120,40,68,3
2020,162600351,29860,1360,1360,1360,0,28500,22500,2000,20500,0,6000,200,5800,0,0,0,0,0,1681,100,240,500,76,24
2020,162600361,113664,10544,10544,10544,0,103120,97200,20000,77200,0,5920,2070,3850,0,10850,3150,3150,0,2884,438,200,200,240,96
2020,162600371,58120,18879,18879,18879,0,39241,36300,28300,0,8000,2941,2715,226,0,19555,19555,19320,0,3695,276,120,240,152,159
2020,162700321,36203,14523,14523,14523,0,21680,21000,4000,17000,0,680,680,0,0,0,0,0,0,3210,375,50,330,280,96
2020,162700331,106730,37480,37480,37480,0,69250,69000,15000,54000,0,250,250,0,0,20100,10100,10000,0,5728,864,40,840,400,704
2020,162700341,1200,1200,1200,1200,0,0,0,0,0,0,0,0,0,0,0,0,0,0,411,120,36,3,0,1
2020,162700351,46928,3978,3978,3978,0,42950,35450,5450,30000,0,7500,3000,4500,0,0,0,0,0,1884,178,60,350,120,106
2020,162700371,44046,3246,3246,3246,0,40800,40000,8000,32000,0,800,0,800,0,3500,3500,3000,500,918,120,62,36,10,11
2020,162800311,14083,3500,3500,3500,0,10583,10200,3200,7000,0,383,250,133,0,0,0,0,0,1460,150,180,280,80,37
2020,162800321,22483,6040,6040,6040,0,16443,15890,10800,5090,0,553,0,553,0,4332,4332,4332,0,1216,166,180,70,180,20
2020,162800341,18369,13869,4269,4269,9600,4500,3000,0,0,3000,1500,1500,0,0,360,360,0,0,2500,684,120,370,120,1773
2020,162800351,4418,1092,1092,1092,0,3326,1800,1800,0,0,1526,1300,226,0,3000,3000,0,2400,1470,200,200,300,150,23
2020,162800361,5118,618,618,618,0,4500,4500,0,4500,0,0,0,0,0,0,0,0,0,1759,120,25,360,180,6
2020,162800371,30019,5109,5109,5109,0,24910,24000,15000,9000,0,910,700,210,0,5700,5700,5700,0,2010,164,60,270,84,65
2020,162900301,40650,200,200,200,0,40450,39300,2000,37300,0,1150,500,650,0,0,0,0,0,1363,148,200,200,80,30
2020,162900311,25330,9330,9330,9330,0,16000,15800,4000,11800,0,200,0,200,0,0,0,0,0,486,105,103,40,30,7
2020,162900321,5014,2014,2014,2014,0,3000,3000,3000,0,0,0,0,0,0,0,0,0,0,583,86,180,24,24,3
2020,162900331,29372,4472,4472,1472,0,24900,17800,17800,0,0,7100,2100,3000,2000,9000,9000,9000,0,2113,193,24,471,236,108
2020,162900341,68384,5634,5634,5634,0,62750,60000,10000,50000,0,2750,1300,1450,0,18950,18950,18950,0,1810,120,240,360,120,49
2020,162900351,860,40,40,40,0,820,700,700,0,0,120,0,120,0,0,0,0,0,452,60,150,78,4,2
2020,162900361,32500,1645,1645,1645,0,30855,17250,17250,0,0,13605,1500,12105,0,7000,7000,3000,4000,2711,442,550,450,60,21
2020,162900371,16921,921,921,921,0,16000,16000,2000,14000,0,0,0,0,0,0,0,0,0,905,160,220,36,24,16
2020,170000302,350,200,200,200,0,150,0,0,0,0,150,100,50,0,0,0,0,0,800,120,84,100,16,14
2020,170000312,25750,4200,4200,3200,0,21550,21250,3000,3250,15000,300,300,0,0,4800,4800,2800,2000,1760,200,20,420,120,49
2020,170000322,49,49,49,49,0,0,0,0,0,0,0,0,0,0,0,0,0,0,1210,372,120,120,24,1
2020,170000332,4050,50,50,50,0,4000,4000,4000,0,0,0,0,0,0,0,0,0,0,407,70,90,12,24,2
2020,170000342,33050,5500,5500,5500,0,27550,24000,24000,0,0,3550,3550,0,0,0,0,0,0,5320,300,100,300,420,988
2020,170000352,64126,7126,7126,7126,0,57000,55000,25000,30000,0,2000,1800,200,0,1000,0,0,0,4426,300,300,600,276,917
2020,170000362,2890,2890,2890,2890,0,0,0,0,0,0,0,0,0,0,0,0,0,0,500,100,10,15,50,12
2020,170000372,3110,1110,110,110,1000,2000,0,0,0,0,2000,2000,0,0,6878,6878,0,5058,4800,520,50,620,240,156
2020,170000382,13068,1000,1000,1000,0,12068,12000,12000,0,0,68,0,68,0,0,0,0,0,1360,280,36,72,72,224
2020,170000392,6620,200,200,200,0,6420,6420,6420,0,0,0,0,0,0,0,0,0,0,506,120,120,0,12,4
2020,170600321,55700,31200,31200,31200,0,24500,22000,17000,5000,0,2500,2300,200,0,0,0,0,0,5420,240,120,300,110,2344
2020,170600331,81239,63879,63879,62379,0,17360,17000,17000,0,0,360,300,60,0,0,0,0,0,5850,200,50,600,200,2314
2020,170600341,130,130,30,30,100,0,0,0,0,0,0,0,0,0,0,0,0,0,1060,310,60,100,60,1
2020,170600351,19037,8611,8611,8611,0,10426,9000,5000,4000,0,1426,1200,226,0,5412,1112,0,1112,3402,240,48,240,144,39
2020,170600361,42576,8176,8176,8176,0,34400,19000,7000,12000,0,15400,1400,14000,0,19166,7166,0,4400,3482,350,50,360,132,79
2020,170600371,3070,70,70,70,0,3000,3000,3000,0,0,0,0,0,0,0,0,0,0,478,108,180,12,13,5
2020,170600381,1100,1100,1100,1100,0,0,0,0,0,0,0,0,0,0,0,0,0,0,267,80,15,15,12,2
2020,170600391,19200,2550,2550,2550,0,16650,16000,16000,0,0,650,650,0,0,3370,3370,3250,0,3692,252,180,420,180,189
2020,170700311,10,10,10,10,0,0,0,0,0,0,0,0,0,0,0,0,0,0,519,90,48,0,0,1
2020,170700321,11607,3807,3507,3507,300,7800,0,0,0,0,7800,800,0,7000,2520,2520,0,2520,2805,280,1000,800,65,11
2020,170700331,15300,5300,5300,5300,0,10000,10000,10000,0,0,0,0,0,0,0,0,0,0,1591,264,100,60,17,22
2020,170700341,26502,4802,4802,4802,0,21700,20000,20000,0,0,1700,1700,0,0,14000,14000,14000,0,2865,720,270,210,180,81
2020,170700351,27680,6680,6680,6680,0,21000,19000,19000,0,0,2000,2000,0,0,5770,5770,5270,500,5920,360,100,700,480,1359
2020,170700371,3308,3308,3308,3308,0,0,0,0,0,0,0,0,0,0,0,0,0,0,1852,260,360,150,140,309
2020,170700381,37220,18370,18370,18370,0,18850,18000,18000,0,0,850,850,0,0,11700,11700,10700,1000,4948,480,100,500,180,237
2020,170700391,11070,2070,2070,2070,0,9000,8500,4500,4000,0,500,0,500,0,0,0,0,0,568,240,10,5,24,7
2020,170800301,8020,320,320,320,0,7700,5500,5500,0,0,2200,2200,0,0,7210,7210,4790,0,2730,300,40,300,240,41
2020,170800311,1660,1360,860,860,500,300,0,0,0,0,300,300,0,0,6380,6380,6380,0,1730,600,5,300,120,91
2020,170800321,30698,5888,5888,5888,0,24810,22000,22000,0,0,2810,2150,660,0,0,0,0,0,2076,312,100,400,120,89
2020,170800351,29610,1010,1010,1010,0,28600,17000,11000,6000,0,11600,7600,4000,0,6000,6000,2000,0,3230,480,120,420,300,97
2020,170800361,16320,1020,1020,1020,0,15300,15000,10000,5000,0,300,300,0,0,0,0,0,0,1128,360,60,60,48,46
2020,170800371,15260,110,110,110,0,15150,15000,15000,0,0,150,150,0,0,4914,4914,4914,0,2130,120,10,240,240,45
2020,170800381,1520,1520,20,20,1500,0,0,0,0,0,0,0,0,0,0,0,0,0,473,110,80,10,13,1
2020,170900301,1450,1100,1100,1100,0,350,0,0,0,0,350,250,100,0,3000,3000,3000,0,1504,100,400,300,84,30
2020,170900311,14490,3570,3570,3570,0,10920,10670,4000,6670,0,250,0,250,0,0,0,0,0,950,150,50,100,140,53
2020,170900321,9324,8124,8124,8124,0,1200,0,0,0,0,1200,1200,0,0,0,0,0,0,1258,180,60,144,180,64
2020,170900361,19040,4040,540,540,3500,15000,12000,0,12000,0,3000,0,3000,0,0,0,0,0,1680,120,20,90,60,13
2020,170900371,14504,9704,9704,9704,0,4800,4000,4000,0,0,800,800,0,0,0,0,0,0,547,120,12,96,60,43
2020,170900381,61950,41920,41920,41920,0,20030,18500,2500,16000,0,1530,1100,430,0,0,0,0,0,839,60,10,120,72,59
2020,170900391,9880,9180,5880,5880,3300,700,0,0,0,0,700,700,0,0,0,0,0,0,1540,100,10,150,100,57
2020,171000302,266412,31212,31212,31212,0,235200,212000,26000,186000,0,23200,3950,19250,0,20000,0,0,0,9220,360,100,1200,360,1967
2020,171000322,50932,7632,7632,7632,0,43300,38000,18000,20000,0,5300,5300,0,0,14500,500,0,0,5700,220,100,80,300,441
2020,171000332,1462,1462,962,962,500,0,0,0,0,0,0,0,0,0,1615,1615,0,1615,3010,960,100,180,200,1
2020,171000362,14850,150,150,150,0,14700,14000,2000,12000,0,700,300,400,0,1800,1800,1800,0,2268,98,800,200,70,15
2020,171000372,19207,707,707,707,0,18500,13000,13000,0,0,5500,5500,0,0,15568,15568,5900,6168,7850,900,100,700,450,844
2020,171000382,1150,850,650,650,200,300,0,0,0,0,300,300,0,0,900,900,0,900,1940,358,700,122,120,67
2020,171000392,15230,200,200,200,0,15030,15000,5000,10000,0,30,30,0,0,0,0,0,0,1604,880,120,240,84,27
2020,171600301,11300,300,300,300,0,11000,11000,4000,7000,0,0,0,0,0,0,0,0,0,614,50,10,30,24,18
2020,171600311,19340,10750,10750,9570,0,8590,8000,8000,0,0,590,590,0,0,0,0,0,0,6660,960,360,120,220,133
2020,171600321,124134,42384,42384,42384,0,81750,81000,10000,71000,0,750,750,0,0,0,0,0,0,4600,400,200,600,200,289
2020,171600331,239300,10300,10300,10300,0,229000,224000,39000,185000,0,5000,1500,3500,0,115000,40000,40000,0,2860,530,200,170,180,527
2020,171600371,50488,12663,12663,12663,0,37825,35000,23000,12000,0,2825,2825,0,0,23600,12300,12300,0,5840,700,120,400,300,714
2020,171600391,5030,30,30,30,0,5000,5000,5000,0,0,0,0,0,0,0,0,0,0,760,150,120,20,20,4
2020,171700301,190588,2588,2588,2588,0,188000,165000,75000,90000,0,23000,3000,20000,0,62200,61200,60000,1000,3865,470,30,400,250,134
2020,171700311,33896,2896,2896,1896,0,31000,26500,25000,1500,0,4500,2500,1000,1000,7000,7000,7000,0,1470,360,0,360,180,711
2020,171700321,62066,27266,27266,14266,0,34800,34000,19000,15000,0,800,800,0,0,1000,1000,0,0,3865,340,1000,165,160,867
2020,171700341,12432,5932,5932,5932,0,6500,5000,5000,0,0,1500,1500,0,0,0,0,0,0,1487,156,250,240,126,78
2020,171700351,13424,2324,2324,2324,0,11100,10000,10000,0,0,1100,1100,0,0,8260,8260,6160,2000,3280,170,30,360,240,137
2020,171700361,5040,4340,3840,3840,500,700,0,0,0,0,700,700,0,0,350,350,0,0,2040,500,30,300,60,206
2020,171700371,347,267,267,267,0,80,0,0,0,0,80,0,80,0,0,0,0,0,920,107,28,16,23,1
2020,171700381,70146,12396,12396,12396,0,57750,40000,10000,30000,0,17750,750,17000,0,7900,7900,0,7900,1870,200,40,300,70,30
2020,171700391,16600,6500,6500,6500,0,10100,8800,3000,5800,0,1300,300,0,1000,0,0,0,0,1960,300,100,180,100,75
2020,171800311,23480,1100,1100,1100,0,22380,5700,4500,1200,0,16680,180,16500,0,0,0,0,0,4407,200,3000,30,42,33
2020,171800341,100,100,100,100,0,0,0,0,0,0,0,0,0,0,0,0,0,0,854,60,630,20,0,1
2020,171800351,51790,32940,32940,32940,0,18850,16000,0,16000,0,2850,550,2300,0,300,0,0,0,2942,170,50,800,50,411
2020,171900301,248620,155120,155120,135120,0,93500,69000,46000,23000,0,24500,8500,16000,0,13880,11880,5880,0,9974,680,246,960,480,5687
2020,171900311,44122,5222,5222,4622,0,38900,38000,14000,24000,0,900,350,550,0,12000,12000,9000,3000,4300,300,500,360,120,410
2020,171900321,22140,20240,2240,2240,18000,1900,0,0,0,0,1900,1900,0,0,6410,6410,0,6350,2232,300,96,240,240,155
2020,171900331,13130,6080,2080,2080,4000,7050,6000,0,6000,0,1050,1050,0,0,0,0,0,0,2820,300,120,600,240,50
2020,171900341,1800,1800,1800,1800,0,0,0,0,0,0,0,0,0,0,0,0,0,0,466,136,100,60,30,1
2020,171900351,9518,218,218,218,0,9300,8500,8500,0,0,800,800,0,0,3000,3000,3000,0,1730,120,630,300,120,104
2020,171900361,1410,410,410,410,0,1000,1000,1000,0,0,0,0,0,0,15,15,0,0,1464,67,800,60,144,3
2020,171900371,21141,4491,4491,4491,0,16650,16000,6000,10000,0,650,600,50,0,0,0,0,0,3558,500,240,600,168,39
2020,171900381,48648,4292,4292,4292,0,44356,43000,40000,3000,0,1356,1130,226,0,7700,7700,4500,3200,4622,1300,260,384,480,168
2020,172000302,105200,50,50,50,0,105150,105000,20000,85000,0,150,150,0,0,57000,57000,57000,0,2222,410,0,120,72,167
2020,172000312,40017,18482,18482,18482,0,21535,20832,12000,8832,0,703,251,452,0,0,0,0,0,2480,344,240,234,120,63
2020,172000342,75400,6050,6050,6050,0,69350,67000,12000,55000,0,2350,750,1600,0,3200,1700,1700,0,3950,400,50,700,400,121
2020,172000352,6400,1300,1300,1300,0,5100,5000,5000,0,0,100,0,100,0,0,0,0,0,510,200,50,30,20,2
2020,172000362,11956,4876,4876,4876,0,7080,4280,4280,0,0,2800,2800,0,0,2500,2500,2500,0,1185,120,25,280,120,190
2020,172000382,23000,500,500,500,0,22500,22500,12500,10000,0,0,0,0,0,2500,0,0,0,868,170,120,60,48,199
2020,172600301,23422,13192,13192,13192,0,10230,10000,10000,0,0,230,0,230,0,400,0,0,0,1132,108,420,24,36,19
2020,172600311,9550,1250,1250,1250,0,8300,8000,8000,0,0,300,300,0,0,0,0,0,0,1210,200,150,300,120,113
2020,172600321,19030,1750,1750,1750,0,17280,17000,17000,0,0,280,280,0,0,0,0,0,0,1952,240,460,240,72,30
2020,172600331,113950,52450,52450,44450,0,61500,17000,17000,0,0,44500,4500,4000,36000,10000,10000,10000,0,6180,240,120,600,400,50
2020,172600341,1620,1420,920,920,500,200,0,0,0,0,200,200,0,0,0,0,0,0,2388,696,36,300,120,28
2020,172600351,47880,4980,4980,4980,0,42900,40000,10000,30000,0,2900,1550,1350,0,2000,2000,2000,0,2360,200,200,700,50,92
2020,172600371,15464,5264,3964,3964,1300,10200,10000,0,10000,0,200,200,0,0,3300,3300,0,3300,1148,200,120,120,48,15
2020,172700301,17,17,17,17,0,0,0,0,0,0,0,0,0,0,0,0,0,0,369,70,45,10,24,1
2020,172700331,33380,7380,7380,7380,0,26000,26000,14000,12000,0,0,0,0,0,60,0,0,0,816,180,30,36,40,11
2020,172700341,3020,20,20,20,0,3000,3000,3000,0,0,0,0,0,0,0,0,0,0,444,34,10,10,30,6
2020,172700351,47270,2540,2540,2540,0,44730,43500,10500,33000,0,1230,30,1200,0,0,0,0,0,1200,120,120,120,60,16
2020,172700361,43640,3490,3490,3490,0,40150,39850,12000,27850,0,300,0,300,0,0,0,0,0,873,120,360,15,60,17
2020,172700371,28350,50,50,50,0,28300,26500,24000,2500,0,1800,1800,0,0,0,0,0,0,2599,200,200,620,99,76
2020,172800311,18950,11650,5350,5350,6300,7300,6000,0,6000,0,1300,1000,300,0,670,670,0,600,2428,180,100,300,108,120
2020,172800331,25602,6840,6840,6840,0,18762,18000,5000,13000,0,762,380,382,0,2800,2800,1500,0,3390,160,300,560,180,59
2020,172800341,5200,200,200,200,0,5000,5000,5000,0,0,0,0,0,0,0,0,0,0,562,200,40,24,18,5
2020,172800351,36442,6442,6442,6442,0,30000,30000,30000,0,0,0,0,0,0,0,0,0,0,888,120,132,16,70,58
2020,172800361,2,2,2,2,0,0,0,0,0,0,0,0,0,0,0,0,0,0,736,108,140,72,36,1
2020,172900301,18130,130,130,130,0,18000,18000,18000,0,0,0,0,0,0,3200,3200,3200,0,760,240,30,30,60,22
2020,172900311,42356,2956,2956,2956,0,39400,39000,18000,21000,0,400,300,100,0,1000,0,0,0,3226,336,720,240,180,128
2020,172900331,1351,901,401,401,500,450,0,0,0,0,450,450,0,0,0,0,0,0,2404,720,10,84,120,11
2020,172900341,8300,5800,5800,5800,0,2500,2500,2500,0,0,0,0,0,0,0,0,0,0,590,200,30,50,60,4
2020,172900351,9880,1130,1130,1130,0,8750,8000,0,8000,0,750,750,0,0,2796,2796,1000,796,1710,150,60,400,100,19
2020,172900361,11080,80,80,80,0,11000,11000,6000,5000,0,0,0,0,0,0,0,0,0,510,120,50,10,30,11
2020,172900371,74450,36850,36850,36850,0,37600,36000,33000,3000,0,1600,1600,0,0,0,0,0,0,1810,240,30,240,90,95
2020,180000302,22404,4704,4704,4704,0,17700,16000,11000,5000,0,1700,1700,0,0,4796,4796,4796,0,2993,320,290,480,243,247
2020,180000312,10317,5517,4017,1017,1500,4800,0,0,0,0,4800,800,1000,3000,0,0,0,0,2682,632,20,340,180,25
2020,180000322,5205,4205,3305,2305,900,1000,0,0,0,0,1000,0,1000,0,0,0,0,0,1027,187,10,15,90,9
2020,180000332,24197,16097,4097,2097,12000,8100,0,0,0,0,8100,1100,2000,5000,3180,3180,0,3000,2383,120,85,252,267,24
2020,180000342,24554,12054,12054,12054,0,12500,12000,12000,0,0,500,500,0,0,1030,30,0,0,3931,240,120,540,300,65
2020,180000352,31424,2534,2534,2534,0,28890,24000,17000,7000,0,4890,4890,0,0,12100,11800,11800,0,2431,180,20,204,186,81
2020,180000392,77511,30696,30696,30696,0,46815,46400,22000,24400,0,415,415,0,0,7300,5300,0,5300,10221,540,240,800,360,920
2020,180600311,1384,1184,984,984,200,200,0,0,0,0,200,200,0,0,0,0,0,0,907,360,129,30,120,14
2020,180600331,9000,8550,50,50,8500,450,0,0,0,0,450,450,0,0,3120,3120,0,3120,1332,336,36,24,60,21
2020,180600361,24162,900,900,900,0,23262,22000,8000,14000,0,1262,1100,162,0,2800,1800,0,1800,1427,120,36,240,120,34
2020,180600371,18855,822,822,822,0,18033,18000,18000,0,0,33,0,33,0,11393,11393,11363,0,3308,408,360,360,192,56
2020,180600391,100,100,100,100,0,0,0,0,0,0,0,0,0,0,0,0,0,0,703,86,150,0,46,1
2020,180700301,40172,22582,22582,22582,0,17590,17000,17000,0,0,590,590,0,0,0,0,0,0,1693,300,50,240,90,25
2020,180700321,108,108,108,108,0,0,0,0,0,0,0,0,0,0,0,0,0,0,617,132,80,48,24,5
2020,180700331,94,64,64,64,0,30,0,0,0,0,30,0,30,0,0,0,0,0,724,132,200,24,25,1
2020,180700341,14799,5129,2929,1929,2200,9670,7500,0,3500,4000,2170,700,1470,0,2452,2452,1500,512,3628,378,500,360,300,35
2020,180700361,36379,15629,15629,15129,0,20750,18000,18000,0,0,2750,2250,500,0,1800,1800,1800,0,2396,184,100,480,150,116
2020,180700371,3682,2122,2072,2072,50,1560,1500,0,1500,0,60,0,60,0,0,0,0,0,1037,144,120,60,48,8
2020,180700381,39200,660,660,660,0,38540,37000,14000,23000,0,1540,1100,440,0,15000,0,0,0,3176,180,150,350,276,149
2020,180700391,30872,24672,7672,4672,17000,6200,0,0,0,0,6200,2500,700,3000,7500,7500,7500,0,5620,216,600,360,144,195
2020,180800321,63286,3146,3146,3146,0,60140,59250,30000,29250,0,890,800,90,0,16000,16000,16000,0,2363,172,180,300,340,51
2020,180800341,10338,3638,3638,2638,0,6700,6500,6500,0,0,200,200,0,0,15,15,0,0,1640,190,50,228,126,46
2020,180800371,26813,2833,2833,2833,0,23980,22800,22800,0,0,1180,1100,80,0,25,25,0,0,1479,204,63,240,132,141
2020,180800381,1788,1508,1008,1008,500,280,280,0,280,0,0,0,0,0,1800,1800,0,1800,2105,540,70,24,168,1
2020,180800391,243600,146490,146490,145490,0,97110,96900,45900,51000,0,210,0,210,0,180,180,0,0,3630,620,350,10,300,2296
2020,180900301,12532,2132,2132,2132,0,10400,10000,10000,0,0,400,400,0,0,60,60,0,0,3036,216,20,360,300,17
2020,180900331,9212,2196,2196,2196,0,7016,7000,7000,0,0,16,0,16,0,0,0,0,0,1887,142,20,120,300,49
2020,180900341,12966,766,766,766,0,12200,11200,4500,6700,0,1000,100,900,0,4000,4000,500,3500,1557,130,120,205,43,34
2020,180900351,16870,6020,6020,6020,0,10850,9050,1800,7250,0,1800,0,1800,0,0,0,0,0,774,108,120,40,36,111
2020,180900361,51173,12023,12023,5023,0,39150,39000,9000,30000,0,150,150,0,0,29600,1600,0,1600,5444,636,500,360,288,554
2020,180900371,15842,1842,1842,1842,0,14000,14000,14000,0,0,0,0,0,0,0,0,0,0,1316,270,300,10,96,22
2020,181000302,106994,7718,7718,7718,0,99276,95000,22000,73000,0,4276,1300,2976,0,26100,21600,21600,0,8824,420,150,680,324,569
2020,181000312,1000,1000,1000,1000,0,0,0,0,0,0,0,0,0,0,0,0,0,0,648,110,10,10,40,1
2020,181000322,118360,56190,56190,56190,0,62170,62000,35000,27000,0,170,0,170,0,2000,0,0,0,1743,240,160,60,48,221
2020,181000362,3952,3452,2952,2752,500,500,0,0,0,0,500,500,0,0,3393,3393,0,3393,2816,492,50,160,114,67
2020,181000372,25400,1900,1900,1900,0,23500,21500,15000,6500,0,2000,2000,0,0,0,0,0,0,1060,140,10,80,20,99
2020,181000392,6600,500,500,500,0,6100,6000,6000,0,0,100,100,0,0,0,0,0,0,1641,170,120,150,198,83
2020,181600301,30449,8299,8299,8299,0,22150,22000,14000,8000,0,150,150,0,0,13380,13380,13280,0,2848,308,100,200,240,80
2020,181600331,41320,10170,10170,10170,0,31150,30000,30000,0,0,1150,1150,0,0,7260,7260,7200,0,4808,336,1500,230,252,158
2020,181600341,14760,14760,10760,10760,4000,0,0,0,0,0,0,0,0,0,5200,5200,0,5200,4392,480,120,72,360,949
2020,181600371,44294,6500,6500,6500,0,37794,30000,30000,0,0,7794,7794,0,0,4000,4000,0,4000,5330,300,800,480,250,1592
2020,181600381,22800,21050,5050,4250,16000,1750,0,0,0,0,1750,1450,300,0,0,0,0,0,3825,219,800,200,288,388
2020,181600391,15100,100,100,100,0,15000,15000,15000,0,0,0,0,0,0,100,0,0,0,1645,120,1200,10,25,45
2020,181700301,35426,11026,11026,11026,0,24400,24000,15000,9000,0,400,300,100,0,6813,6313,6300,0,4734,288,120,300,216,144
2020,181700311,55,55,5,5,50,0,0,0,0,0,0,0,0,0,0,0,0,0,719,300,6,15,36,40
2020,181700321,10459,6230,4430,4430,1800,4229,0,0,0,0,4229,4000,229,0,4760,4760,0,4700,3721,180,99,444,288,106
2020,181700331,62652,5924,5924,3924,0,56728,55200,40000,15200,0,1528,1370,158,0,21030,14030,14000,0,3075,776,10,420,240,293
2020,181700341,24020,20,20,20,0,24000,24000,24000,0,0,0,0,0,0,0,0,0,0,520,180,40,50,30,25
2020,181700361,37418,11380,11380,5380,0,26038,24800,16800,8000,0,1238,380,858,0,120,120,0,0,1430,258,110,90,78,58
2020,181700371,36463,6335,6335,6335,0,30128,30000,14000,16000,0,128,60,68,0,15094,15094,15074,0,1851,158,20,210,174,70
2020,181800321,13402,13402,402,402,13000,0,0,0,0,0,0,0,0,0,0,0,0,0,504,200,10,10,24,1
2020,181800331,20928,6487,6487,6487,0,14441,12000,12000,0,0,2441,2170,271,0,9290,9290,6890,800,2976,260,100,520,216,71
2020,181800341,27528,2048,2048,2048,0,25480,25000,15000,10000,0,480,350,130,0,0,0,0,0,2440,180,100,250,180,63
2020,181800361,11935,875,875,375,0,11060,8500,8500,0,0,2560,2500,60,0,9500,9500,4900,0,2940,240,800,150,120,20
2020,181800371,51630,3742,3742,3742,0,47888,46000,23000,23000,0,1888,1680,208,0,0,0,0,0,3331,350,380,345,204,204
2020,181800381,47216,36204,36204,36204,0,11012,10000,10000,0,0,1012,500,512,0,0,0,0,0,2254,204,120,170,240,1740
2020,181800391,30672,30472,5472,5472,25000,200,0,0,0,0,200,200,0,0,50,50,0,0,3490,240,30,180,120,144
2020,181900311,9583,5423,5423,5423,0,4160,4000,0,4000,0,160,0,160,0,0,0,0,0,3118,240,18,180,228,178
2020,181900321,9375,4130,4130,3530,0,5245,5000,5000,0,0,245,200,45,0,5985,5985,1185,1200,2039,140,30,300,204,44
2020,181900341,19528,4328,4328,4328,0,15200,13000,13000,0,0,2200,2200,0,0,1440,1440,1300,0,2710,60,130,240,240,78
2020,181900351,16780,780,780,780,0,16000,16000,15000,1000,0,0,0,0,0,12630,12630,12600,0,1147,240,150,15,72,21
2020,181900381,14185,1025,1025,1025,0,13160,13000,13000,0,0,160,0,160,0,0,0,0,0,715,156,17,21,20,16
2020,182000302,84498,7250,7250,7100,0,77248,75000,65000,10000,0,2248,1570,678,0,13300,13000,13000,0,5710,600,500,1400,480,683
2020,182000312,40188,1988,1988,1988,0,38200,38000,23000,15000,0,200,200,0,0,13000,9000,9000,0,1773,256,100,120,48,115
2020,182000322,17995,6895,6895,6895,0,11100,11000,11000,0,0,100,100,0,0,4000,4000,3000,0,3770,240,360,560,360,255
2020,182000332,32098,12600,12600,12600,0,19498,0,0,0,0,19498,19272,226,0,20100,20100,3500,0,4590,150,30,360,600,40
2020,182000342,84612,17312,17312,17312,0,67300,66000,38000,28000,0,1300,1300,0,0,2000,0,0,0,2742,360,200,480,120,190
2020,182000352,3650,1650,1650,1650,0,2000,0,0,0,0,2000,2000,0,0,0,0,0,0,4404,504,18,240,144,53
2020,182000382,10410,810,810,810,0,9600,7000,0,7000,0,2600,2300,300,0,4000,0,0,0,1488,162,10,120,276,179
2020,182600301,1058,718,218,218,500,340,0,0,0,0,340,300,40,0,20,20,0,0,881,50,70,120,72,12
2020,182600321,29561,4191,4191,4191,0,25370,25000,21000,4000,0,370,370,0,0,15000,15000,15000,0,2880,300,70,280,240,680
2020,182600341,13645,3175,3175,3175,0,10470,10000,10000,0,0,470,470,0,0,3207,3207,3207,0,3920,240,800,300,130,201
2020,182600351,28994,3994,3994,3994,0,25000,25000,25000,0,0,0,0,0,0,2500,0,0,0,732,145,120,10,17,11
2020,182600371,68965,18965,18965,16165,0,50000,48000,13000,35000,0,2000,2000,0,0,3050,3050,0,3000,4440,600,100,300,40,595
2020,182600381,3680,180,180,180,0,3500,3500,3500,0,0,0,0,0,0,0,0,0,0,752,60,180,50,30,5
2020,182600391,10356,1270,1270,1270,0,9086,8350,8350,0,0,736,650,86,0,4300,4300,4300,0,1342,264,140,330,66,35
2020,182700351,35467,2865,2865,2865,0,32602,32000,11000,21000,0,602,150,452,0,25000,12000,12000,0,2244,264,60,180,300,1209
2020,182700361,29828,4428,4428,4428,0,25400,16000,8000,8000,0,9400,1400,0,8000,1000,0,0,0,2488,168,50,80,198,27
2020,182700371,31182,1062,1062,1062,0,30120,30000,30000,0,0,120,120,0,0,11600,11600,5600,6000,3189,187,1500,360,156,61
2020,182700381,22988,1658,1658,1658,0,21330,20000,9000,11000,0,1330,980,350,0,7050,7050,5000,2000,1418,105,68,180,112,72
2020,182700391,3369,1750,1750,1750,0,1619,1200,0,1200,0,419,0,419,0,0,0,0,0,643,120,50,20,28,1
2020,182800311,8710,10,10,10,0,8700,8600,8600,0,0,100,0,100,0,0,0,0,0,780,240,120,20,60,13
2020,182800321,4660,4260,2260,2260,2000,400,0,0,0,0,400,300,0,100,860,860,0,600,1640,480,20,180,180,15
2020,182800331,29953,1613,1613,1613,0,28340,25000,25000,0,0,3340,740,2600,0,9000,9000,9000,0,3308,216,240,220,180,43
2020,182800341,46164,2864,2864,2864,0,43300,43000,19000,24000,0,300,300,0,0,5100,5100,5100,0,1952,103,60,300,151,63
2020,182800351,119652,540,540,540,0,119112,118000,43000,75000,0,1112,1112,0,0,0,0,0,0,2696,180,144,720,122,804
2020,182800381,10290,840,840,840,0,9450,9000,5000,4000,0,450,450,0,0,0,0,0,0,1424,144,120,130,36,18
2020,182800391,12778,978,978,978,0,11800,9000,9000,0,0,2800,2300,500,0,0,0,0,0,1385,140,40,250,95,86
2020,182900301,15490,13190,7190,4690,6000,2300,0,0,0,0,2300,0,300,2000,0,0,0,0,3170,860,140,100,130,38
2020,182900311,48796,18173,18173,18173,0,30623,29000,29000,0,0,1623,1390,233,0,1000,0,0,0,4447,847,110,300,270,233
2020,182900331,51232,20012,20012,17012,0,31220,28000,23000,5000,0,3220,3220,0,0,12870,12370,9340,0,4560,520,50,540,264,807
2020,182900351,5990,5990,990,990,5000,0,0,0,0,0,0,0,0,0,3000,3000,0,0,1778,330,12,36,120,1
2020,182900371,21795,3295,795,795,2500,18500,18500,0,18500,0,0,0,0,0,3500,3500,1500,2000,1396,300,60,36,36,41
2020,182900381,4688,4088,2588,2588,1500,600,0,0,0,0,600,600,0,0,3520,3520,0,3520,1607,300,5,300,120,122
2020,182900391,23370,5000,5000,5000,0,18370,18300,3000,15300,0,70,0,70,0,0,0,0,0,1243,124,170,84,36,11
2020,183000302,2734,2174,374,374,1800,560,400,0,400,0,160,160,0,0,1000,1000,0,0,2018,120,200,140,76,24
2020,183000312,1120,1120,1120,1120,0,0,0,0,0,0,0,0,0,0,0,0,0,0,843,93,350,40,60,1
2020,183000322,12125,2725,2725,2725,0,9400,9100,3500,5600,0,300,300,0,0,0,0,0,0,880,100,70,100,80,55
2020,183600301,4622,622,622,622,0,4000,4000,4000,0,0,0,0,0,0,950,950,0,950,912,96,350,120,36,2
2020,183700301,34382,6082,6082,6082,0,28300,25500,8000,17500,0,2800,1200,1600,0,60,60,0,0,3061,355,30,240,96,66
2020,183800301,30740,9740,9740,9740,0,21000,20000,20000,0,0,1000,1000,0,0,4300,4300,4300,0,1576,200,50,310,60,327
2020,183800311,10600,3200,3200,3200,0,7400,7000,7000,0,0,400,0,400,0,0,0,0,0,1015,150,320,60,30,4
2020,183900301,35408,3608,3608,3608,0,31800,25000,25000,0,0,6800,800,6000,0,10900,10900,0,8400,3423,220,30,300,83,76
2020,183900311,14890,2390,2390,2390,0,12500,12500,6000,6500,0,0,0,0,0,0,0,0,0,543,152,110,35,36,6
2020,190000202,56526,6926,6926,6926,0,49600,39000,15000,24000,0,10600,2600,8000,0,24000,24000,24000,0,3224,204,10,360,240,242
2020,190000212,43358,15858,15858,15858,0,27500,20000,20000,0,0,7500,500,7000,0,0,0,0,0,4850,660,10,600,300,177
2020,190000222,53800,900,900,900,0,52900,52200,42000,10200,0,700,700,0,0,0,0,0,0,1310,278,120,300,72,99
2020,190000232,45032,42,42,42,0,44990,44600,9600,35000,0,390,0,390,0,19366,17866,17866,0,1942,606,180,72,120,68
2020,190000262,71390,1510,1510,1510,0,69880,69800,15000,54800,0,80,30,50,0,0,0,0,0,1958,36,920,360,12,83
2020,190000272,18396,11396,8396,8396,3000,7000,0,0,0,0,7000,4000,3000,0,1000,1000,0,1000,3876,306,200,1000,150,223
2020,190000292,17823,16473,4973,4673,11500,1350,0,0,0,0,1350,1350,0,0,13500,13500,0,13500,5532,300,12,360,180,965
2020,190000302,7758,5658,2658,2658,3000,2100,0,0,0,0,2100,2100,0,0,30,30,0,0,3450,1150,60,500,180,196
2020,190000312,50,50,50,50,0,0,0,0,0,0,0,0,0,0,0,0,0,0,454,50,40,0,24,8
2020,190000322,450,450,450,450,0,0,0,0,0,0,0,0,0,0,0,0,0,0,1490,360,65,60,45,353
2020,190000352,23080,580,580,580,0,22500,20000,20000,0,0,2500,2500,0,0,1500,1500,0,0,1706,300,20,240,96,138
2020,190000362,100450,24800,24800,24800,0,75650,75000,39000,36000,0,650,500,150,0,0,0,0,0,2667,570,50,360,27,116
2020,190000372,260,260,260,260,0,0,0,0,0,0,0,0,0,0,0,0,0,0,1609,68,600,36,120,13
2020,190000382,986,866,866,866,0,120,0,0,0,0,120,120,0,0,145,145,0,0,3080,350,240,570,240,143
2020,190000392,20720,3720,3720,3720,0,17000,16000,0,16000,0,1000,1000,0,0,3050,3050,3000,50,4360,210,100,400,260,570
2020,190600221,128088,4788,4788,4788,0,123300,120000,100000,20000,0,3300,3300,0,0,21080,20180,18380,0,2954,300,70,240,144,211
2020,190600231,58859,3989,3989,3989,0,54870,54000,15000,39000,0,870,800,70,0,1000,1000,0,1000,1317,162,50,288,114,498
2020,190600321,16589,1029,1029,1029,0,15560,13000,13000,0,0,2560,2560,0,0,7190,7190,4270,1500,1630,228,10,137,180,32
2020,190600351,33640,6140,6140,6140,0,27500,16000,15000,1000,0,11500,500,0,11000,0,0,0,0,1772,72,30,30,40,51
2020,190600361,27908,4808,4808,4808,0,23100,20000,20000,0,0,3100,3100,0,0,5884,5884,5884,0,1650,60,5,120,120,265
2020,190600391,156202,14502,14502,14502,0,141700,138000,28000,110000,0,3700,2000,1700,0,25000,25000,23000,2000,5300,340,200,720,180,988
2020,190700211,36484,4284,4284,4284,0,32200,30000,30000,0,0,2200,600,1600,0,1000,1000,0,1000,1452,240,120,240,84,72
2020,190700221,191200,50700,50700,50700,0,140500,140000,80000,60000,0,500,0,500,0,300,300,0,0,4900,400,200,500,300,1965
2020,190700311,2240,1940,1940,1940,0,300,0,0,0,0,300,300,0,0,11240,11240,740,0,3250,860,70,600,480,41
2020,190700321,18262,5662,4662,4662,1000,12600,12000,0,12000,0,600,600,0,0,7800,7200,7000,0,4852,1092,120,240,240,54
2020,190700341,13589,3589,3589,3589,0,10000,10000,10000,0,0,0,0,0,0,0,0,0,0,2626,240,336,60,120,1
2020,190700351,5910,4610,4010,4010,600,1300,0,0,0,0,1300,1300,0,0,9850,9850,3650,6200,3340,120,100,300,300,381
2020,190700361,31940,14240,14240,14240,0,17700,17000,11000,6000,0,700,700,0,0,0,0,0,0,2532,86,20,432,108,625
2020,190700371,36854,1854,1854,1854,0,35000,35000,35000,0,0,0,0,0,0,0,0,0,0,959,324,140,0,20,42
2020,190800201,80,80,80,80,0,0,0,0,0,0,0,0,0,0,0,0,0,0,1684,300,500,84,120,1
2020,190800251,39815,6985,6985,6985,0,32830,32000,12000,20000,0,830,800,30,0,0,0,0,0,1510,300,120,240,100,128
2020,190800261,34058,33358,33358,33358,0,700,0,0,0,0,700,700,0,0,0,0,0,0,3146,216,15,247,253,1008
2020,190800281,31220,1920,1920,420,0,29300,27800,20000,7800,0,1500,900,600,0,11700,11700,10000,0,2924,240,24,200,240,106
2020,190800311,88992,1492,1492,1492,0,87500,85000,25000,60000,0,2500,2500,0,0,17400,17400,3600,13800,2664,120,120,84,180,125
2020,190800321,150,150,150,150,0,0,0,0,0,0,0,0,0,0,0,0,0,0,787,52,120,70,60,1
2020,190800331,16200,6200,6200,6200,0,10000,10000,10000,0,0,0,0,0,0,0,0,0,0,510,60,60,10,40,19
2020,190800341,29560,17160,17160,17160,0,12400,10000,0,10000,0,2400,2400,0,0,2000,2000,0,2000,2290,300,200,200,240,183
2020,190900201,58920,5120,5120,5120,0,53800,53500,18500,35000,0,300,300,0,0,28000,0,0,0,1170,180,30,120,240,93
2020,190900231,132750,3430,3430,3430,0,129320,125000,35000,90000,0,4320,200,4120,0,0,0,0,0,2004,624,100,50,80,202
2020,190900241,53768,2168,2168,2168,0,51600,50000,40000,10000,0,1600,1200,400,0,8175,8175,5400,2775,3252,372,300,360,180,200
2020,190900251,15020,4020,4020,4020,0,11000,11000,11000,0,0,0,0,0,0,0,0,0,0,696,192,120,60,24,34
2020,190900261,1036028,61028,61028,61028,0,975000,910000,60000,850000,0,65000,5000,60000,0,40000,0,0,0,6628,280,720,336,132,1938
2020,190900271,78374,14174,14174,14174,0,64200,60000,40000,20000,0,4200,4200,0,0,16363,16363,15000,0,3639,244,100,480,150,1994
2020,190900281,52870,2070,2070,2070,0,50800,48000,48000,0,0,2800,2800,0,0,23040,23040,17800,5040,4864,264,300,300,200,417
2020,190900311,23370,6170,6170,6170,0,17200,17000,10000,7000,0,200,200,0,0,0,0,0,0,1923,262,300,300,48,56
2020,190900331,150404,7136,7136,7136,0,143268,142000,17000,125000,0,1268,308,960,0,2300,2300,0,2300,3106,216,100,300,240,175
2020,190900351,36220,8020,8020,8020,0,28200,28000,20000,8000,0,200,200,0,0,0,0,0,0,2143,83,200,216,204,89
2020,190900371,38220,5220,3220,2920,2000,33000,30000,0,30000,0,3000,1000,1000,1000,1650,1650,1000,150,2894,348,10,240,144,80
2020,190900381,94443,4443,4443,4443,0,90000,88500,58000,30500,0,1500,1500,0,0,41300,41000,38000,3000,5059,420,60,790,252,1017
2020,191000202,17453,12053,7053,53,5000,5400,0,0,0,0,5400,1400,4000,0,65140,65140,4800,15100,2377,780,1,200,120,617
2020,191000212,86070,4620,4620,4620,0,81450,80000,60000,20000,0,1450,1450,0,0,2700,700,0,0,4530,800,100,900,200,1464
2020,191000232,86800,16000,16000,16000,0,70800,70000,70000,0,0,800,800,0,0,0,0,0,0,1920,360,60,240,120,652
2020,191000312,240160,3440,3440,3440,0,236720,236000,16000,220000,0,720,700,20,0,4600,4600,4600,0,1675,580,100,150,48,96
2020,191000322,1300,1300,800,800,500,0,0,0,0,0,0,0,0,0,0,0,0,0,596,84,0,0,12,1
2020,191000332,360,360,110,10,250,0,0,0,0,0,0,0,0,0,0,0,0,0,658,57,10,20,15,1
2020,191000352,15416,13752,1890,1890,11862,1664,0,0,0,0,1664,1664,0,0,8200,8200,8000,200,2769,204,25,120,240,121
2020,191600311,12020,1020,1020,1020,0,11000,10000,0,10000,0,1000,0,1000,0,0,0,0,0,792,120,60,60,72,11
2020,191600331,57712,6112,6112,6112,0,51600,50000,12000,38000,0,1600,1200,400,0,0,0,0,0,630,70,10,120,50,50
2020,191600341,52688,11288,11288,11288,0,41400,28000,28000,0,0,13400,3400,0,10000,0,0,0,0,1206,120,156,120,120,41
2020,191600351,2672,2522,2122,2122,400,150,0,0,0,0,150,150,0,0,853,853,0,853,820,0,0,120,120,15
2020,191700301,13455,2390,2190,2190,200,11065,0,0,0,0,11065,1015,50,10000,0,0,0,0,2550,800,100,120,100,176
2020,191800201,12020,1020,1020,1020,0,11000,11000,11000,0,0,0,0,0,0,0,0,0,0,1180,180,500,12,48,16
2020,191800211,81540,7640,640,640,7000,73900,73000,0,73000,0,900,900,0,0,37000,37000,25000,12000,3110,340,300,200,250,51
2020,191800221,19680,3580,3580,3580,0,16100,16000,16000,0,0,100,100,0,0,0,0,0,0,1920,250,150,180,150,27
2020,191800241,10518,18,18,18,0,10500,10500,5500,5000,0,0,0,0,0,0,0,0,0,849,80,20,84,70,9
2020,191800291,322100,83800,83800,83800,0,238300,185000,25000,160000,0,53300,300,53000,0,5000,0,0,0,1408,186,544,108,120,1709
2020,191800301,56458,16258,16258,16258,0,40200,40000,40000,0,0,200,200,0,0,50,50,0,0,5610,180,50,600,240,1697
2020,191800321,180090,1000,1000,1000,0,179090,160000,20000,140000,0,19090,1990,7100,10000,10000,10000,10000,0,4170,100,3000,500,100,121
2020,191800331,38540,2040,2040,2040,0,36500,35000,20000,15000,0,1500,500,1000,0,0,0,0,0,1585,412,49,28,134,29
2020,191900201,77780,10920,10920,10920,0,66860,66000,46000,20000,0,860,860,0,0,17500,2500,0,0,4123,300,120,195,240,582
2020,191900231,47636,8936,8936,2936,0,38700,28000,24000,4000,0,10700,2200,5000,3500,7510,7510,5510,2000,3004,300,60,160,300,246
2020,191900311,12140,12140,12140,12140,0,0,0,0,0,0,0,0,0,0,0,0,0,0,1200,100,30,60,60,11
2020,191900321,9098,8178,8178,8178,0,920,0,0,0,0,920,800,120,0,250,250,0,0,2094,120,120,420,140,57
2020,191900341,276740,11240,11240,11240,0,265500,260000,40000,220000,0,5500,4200,1300,0,20700,19700,19700,0,4674,240,360,360,360,277
2020,192800211,145961,11205,11205,11205,0,134756,134000,30000,104000,0,756,0,756,0,0,0,0,0,1897,100,1000,360,72,63
2020,192800221,28604,20784,20784,20784,0,7820,7500,7500,0,0,320,320,0,0,400,400,0,400,3204,142,1029,530,110,124
2020,192800291,132910,14910,14910,14910,0,118000,110000,10000,100000,0,8000,8000,0,0,0,0,0,0,3520,600,120,360,240,295
2020,193800201,65830,180,180,180,0,65650,65500,8500,57000,0,150,150,0,0,0,0,0,0,1436,288,480,150,48,61
2020,193800261,16938,16338,4038,3038,12300,600,0,0,0,0,600,600,0,0,4300,4300,4300,0,3262,720,100,100,432,270
2020,193800281,60989,5089,5089,5089,0,55900,50000,50000,0,0,5900,5900,0,0,18102,18102,14040,0,3776,192,100,240,180,338
2020,193800291,84323,22983,22983,22983,0,61340,60000,60000,0,0,1340,1340,0,0,4940,4940,4890,0,4255,60,100,300,240,156
2020,194800221,24360,19060,2060,2060,17000,5300,0,0,0,0,5300,4300,1000,0,0,0,0,0,4694,360,200,600,144,495
2020,194800241,142368,12208,12208,12208,0,130160,128260,49000,68000,11260,1900,1900,0,0,85870,80870,56000,21000,9989,369,208,921,361,1535
2020,194800261,115900,10400,10400,10400,0,105500,103000,85000,18000,0,2500,2200,300,0,0,0,0,0,3640,300,500,480,100,272
2020,195800201,110828,29628,29628,29628,0,81200,80000,43000,37000,0,1200,1200,0,0,17000,0,0,0,3740,300,100,600,240,292
2020,195800231,85760,12060,12060,12060,0,73700,73300,45000,0,28300,400,400,0,0,42980,42980,22000,19980,3500,250,50,100,100,394
2020,195800271,74098,12516,12516,12516,0,61582,60000,60000,0,0,1582,1500,82,0,8000,8000,8000,0,7796,360,30,888,208,668
2020,210000122,44510,44460,6460,6460,38000,50,0,0,0,0,50,50,0,0,22000,22000,22000,0,3430,270,100,80,100,784
2020,210000132,20450,20050,50,50,20000,400,0,0,0,0,400,400,0,0,9300,9300,6600,1000,1810,360,10,150,180,8
2020,210000142,5407,5407,407,407,5000,0,0,0,0,0,0,0,0,0,4850,4850,4850,0,1818,60,10,192,216,11
2020,210000152,27236,9236,1236,1236,8000,18000,18000,0,18000,0,0,0,0,0,9000,0,0,0,1408,144,420,48,120,43
2020,210000162,51520,1520,1520,1520,0,50000,50000,50000,0,0,0,0,0,0,11000,6000,6000,0,1545,60,120,115,115,323
2020,210000172,133376,376,376,376,0,133000,130000,130000,0,0,3000,3000,0,0,25000,25000,25000,0,1844,312,300,86,156,657
2020,210000182,65600,3600,3600,3600,0,62000,62000,50000,12000,0,0,0,0,0,0,0,0,0,922,100,120,24,48,50
2020,210000192,7017,6717,3217,3217,3500,300,0,0,0,0,300,300,0,0,0,0,0,0,1681,100,1,100,60,1
2020,210000202,940,940,640,640,300,0,0,0,0,0,0,0,0,0,0,0,0,0,1259,360,5,60,120,1
2020,210000212,1680,1680,80,80,1600,0,0,0,0,0,0,0,0,0,0,0,0,0,1210,306,110,24,36,1
2020,210000222,2103,1053,53,53,1000,1050,0,0,0,0,1050,1050,0,0,372,372,0,0,961,374,56,60,36,41
2020,210000232,2934,2934,1934,1934,1000,0,0,0,0,0,0,0,0,0,26,26,0,0,1302,180,80,60,126,20
2020,210000252,8222,5622,4522,4222,1100,2600,0,0,0,0,2600,2300,300,0,4376,4376,0,2380,1765,420,12,192,240,122
2020,210000262,37800,1300,1300,1300,0,36500,36500,36500,0,0,0,0,0,0,0,0,0,0,977,264,290,10,22,50
2020,210000272,49386,936,936,836,0,48450,23000,23000,0,0,25450,25450,0,0,21180,21180,19440,0,2588,240,20,600,336,28
2020,210000282,23800,21300,300,300,21000,2500,0,0,0,0,2500,2500,0,0,0,0,0,0,2340,360,120,240,180,74
2020,210000292,52951,8420,8420,8420,0,44531,41800,29800,12000,0,2731,1000,1731,0,28320,26320,18400,3500,2500,300,200,400,150,171
2020,210000302,11030,10730,2730,2730,8000,300,0,0,0,0,300,300,0,0,0,0,0,0,3070,720,150,500,200,57
2020,210000312,25980,25980,980,980,25000,0,0,0,0,0,0,0,0,0,0,0,0,0,1576,430,150,120,36,10
2020,210000332,5500,3300,300,300,3000,2200,0,0,0,0,2200,2200,0,0,2100,2100,0,2100,1560,90,10,300,100,51
2020,210000342,1200,300,100,100,200,900,0,0,0,0,900,900,0,0,0,0,0,0,1910,420,10,250,240,48
2020,210000372,33508,3508,3508,3508,0,30000,27000,27000,0,0,3000,3000,0,0,7816,7816,7816,0,2104,300,100,12,180,55
2020,210000382,319,319,19,19,300,0,0,0,0,0,0,0,0,0,0,0,0,0,960,430,360,0,30,1
2020,210000392,47040,5040,5040,5040,0,42000,39000,39000,0,0,3000,3000,0,0,1020,1020,1020,0,6390,360,60,720,240,561
2020,210001102,5300,5300,5000,5000,300,0,0,0,0,0,0,0,0,0,0,0,0,0,1080,276,25,180,60,20
2020,210600181,6700,6700,2700,2700,4000,0,0,0,0,0,0,0,0,0,0,0,0,0,810,100,50,60,100,16
2020,210600191,3060,3060,60,60,3000,0,0,0,0,0,0,0,0,0,1380,1380,1380,0,520,120,120,0,36,1
2020,210600211,11108,108,108,108,0,11000,11000,6000,5000,0,0,0,0,0,5000,5000,5000,0,910,132,132,52,120,25
2020,210600231,2762,2762,762,762,2000,0,0,0,0,0,0,0,0,0,0,0,0,0,3246,576,120,180,210,1
2020,210600251,15286,4200,4200,4200,0,11086,11000,11000,0,0,86,0,86,0,0,0,0,0,816,156,54,30,36,14
2020,210600271,111790,5810,5810,5810,0,105980,90000,26000,24000,40000,15980,12400,3580,0,31850,31850,26000,0,7146,372,1072,1200,600,218
2020,210600281,45118,15818,15818,15818,0,29300,28000,15000,13000,0,1300,1300,0,0,2706,1706,1126,580,3471,123,400,650,510,67
2020,210600361,214782,16962,16962,16962,0,197820,193000,73000,120000,0,4820,4700,120,0,81000,0,0,0,6850,400,700,350,200,3994
2020,210600381,124630,72630,54630,54630,18000,52000,52000,0,52000,0,0,0,0,0,72000,70000,0,70000,3042,648,480,144,120,100
2020,210600391,14806,1806,1806,1806,0,13000,13000,13000,0,0,0,0,0,0,8000,8000,8000,0,2520,240,20,250,240,31
2020,210700121,25450,10250,10250,10250,0,15200,15000,15000,0,0,200,0,200,0,0,0,0,0,1370,85,20,85,70,37
2020,210700131,25500,5300,5300,5300,0,20200,20000,20000,0,0,200,200,0,0,80,80,0,0,1650,150,250,250,40,36
2020,210700141,91000,11000,11000,11000,0,80000,80000,80000,0,0,0,0,0,0,0,0,0,0,800,100,80,30,60,97
2020,210700161,11980,10080,80,80,10000,1900,0,0,0,0,1900,1800,100,0,3700,3700,2700,0,2562,264,24,120,144,67
2020,210700191,63800,13100,13100,13100,0,50700,50000,50000,0,0,700,0,700,0,0,0,0,0,1814,300,600,10,24,130
2020,210700211,39400,4400,4400,4400,0,35000,35000,35000,0,0,0,0,0,0,4000,0,0,0,1430,180,120,32,36,31
2020,210700221,2030,30,30,30,0,2000,2000,2000,0,0,0,0,0,0,0,0,0,0,1213,174,210,120,60,2
2020,210700231,51472,472,472,472,0,51000,50000,20000,30000,0,1000,1000,0,0,13853,13853,13000,700,2220,156,280,240,84,516
2020,210700251,4075,575,575,575,0,3500,3500,3500,0,0,0,0,0,0,500,500,500,0,400,60,20,24,24,5
2020,210700291,102290,1990,1990,1990,0,100300,100000,50000,50000,0,300,100,200,0,75011,70011,70000,0,6046,960,200,350,156,31
2020,210700351,3244,2664,1164,1164,1500,580,0,0,0,0,580,580,0,0,900,900,0,0,2174,744,30,150,120,112
2020,210700361,68900,2100,2100,2100,0,66800,65000,55000,10000,0,1800,1800,0,0,10000,0,0,0,2066,260,400,180,96,158
2020,210700381,75553,5353,5353,5353,0,70200,70000,62000,8000,0,200,0,200,0,2000,0,0,0,990,200,100,50,0,92
2020,210700391,30550,3550,3550,3550,0,27000,27000,27000,0,0,0,0,0,0,5700,5700,5700,0,1228,300,120,120,48,31
2020,210701121,120,120,20,20,100,0,0,0,0,0,0,0,0,0,0,0,0,0,708,336,24,10,18,1
2020,210701161,14300,2300,1800,800,500,12000,0,0,0,0,12000,0,8000,4000,800,800,0,800,4510,1200,50,20,100,117
2020,210800111,137378,16878,16878,16878,0,120500,120000,100000,20000,0,500,500,0,0,5000,0,0,0,3262,600,400,200,200,365
2020,210800151,13294,13294,3294,1294,10000,0,0,0,0,0,0,0,0,0,0,0,0,0,577,72,120,15,30,1
2020,210800201,22236,3286,3286,2986,0,18950,17000,14000,3000,0,1950,550,1400,0,590,90,0,0,1452,198,40,120,132,34
2020,210800231,2065,1565,565,565,1000,500,0,0,0,0,500,500,0,0,20,20,0,0,3119,314,100,420,320,104
2020,210800241,4190,190,190,190,0,4000,4000,4000,0,0,0,0,0,0,0,0,0,0,765,100,150,60,15,9
2020,210800251,11120,4120,4120,4120,0,7000,7000,6000,1000,0,0,0,0,0,0,0,0,0,1086,120,120,60,36,18
2020,210800261,6203,3203,2203,203,1000,3000,0,0,0,0,3000,0,1500,1500,3146,3146,0,696,2812,622,53,480,260,1
2020,210800271,607500,223000,223000,223000,0,384500,357000,85000,272000,0,27500,7500,20000,0,4000,0,0,0,9480,1200,40,600,240,25050
2020,210800301,40055,37055,10055,10055,27000,3000,0,0,0,0,3000,3000,0,0,8000,8000,0,8000,6456,360,20,720,240,1033
2020,210800321,11983,10770,870,870,9900,1213,0,0,0,0,1213,1100,113,0,3000,3000,3000,0,3154,856,36,468,192,223
2020,210800341,15150,14400,400,400,14000,750,0,0,0,0,750,750,0,0,5400,5400,5400,0,2510,500,100,70,140,21
2020,210800351,25036,5036,5036,5036,0,20000,20000,20000,0,0,0,0,0,0,1200,200,0,0,2000,132,240,120,60,88
2020,210800361,6672,6672,5672,5672,1000,0,0,0,0,0,0,0,0,0,1000,1000,1000,0,1675,631,0,72,84,13
2020,210800371,7015,7015,15,15,7000,0,0,0,0,0,0,0,0,0,8650,8650,6650,0,219,20,10,10,19,1
2020,210800381,2150,2150,50,50,2100,0,0,0,0,0,0,0,0,0,740,740,0,0,471,205,0,12,36,1
2020,210801101,51732,49232,4232,4232,45000,2500,0,0,0,0,2500,2500,0,0,30,30,0,0,2850,183,50,180,252,57
2020,210900131,1228,1228,728,728,500,0,0,0,0,0,0,0,0,0,300,300,0,0,1789,660,12,150,72,29
2020,210900161,98024,7524,7524,7524,0,90500,90000,90000,0,0,500,500,0,0,0,0,0,0,4050,360,100,150,300,551
2020,210900191,77290,1840,1840,1840,0,75450,75000,75000,0,0,450,450,0,0,45600,9600,2500,7100,4200,1380,120,480,120,325
2020,210900211,10840,2440,2440,2440,0,8400,6000,6000,0,0,2400,2400,0,0,1500,1500,0,0,3812,600,144,480,360,87
2020,210900221,19511,2511,2511,2511,0,17000,17000,17000,0,0,0,0,0,0,10800,10800,10800,0,1551,240,84,120,84,14
2020,210900231,148894,2894,2894,2894,0,146000,142000,50000,92000,0,4000,4000,0,0,42000,40000,40000,0,4220,390,210,960,240,474
2020,210900241,2351,2351,2051,151,300,0,0,0,0,0,0,0,0,0,0,0,0,0,816,132,0,36,48,1
2020,210900251,1608,1608,1108,1108,500,0,0,0,0,0,0,0,0,0,0,0,0,0,2211,840,5,360,96,1
2020,210900261,28366,7366,7366,7366,0,21000,21000,21000,0,0,0,0,0,0,0,0,0,0,1152,216,240,40,60,33
2020,210900301,68001,42501,4501,4501,38000,25500,20000,0,0,20000,5500,5500,0,0,8900,8900,0,5300,4060,240,100,100,120,1373
2020,210900331,15810,15810,810,810,15000,0,0,0,0,0,0,0,0,0,5000,5000,5000,0,843,120,116,18,85,1
2020,210900341,1320,1320,120,120,1200,0,0,0,0,0,0,0,0,0,0,0,0,0,1449,120,15,110,140,5
2020,210900361,3074,3074,2074,2074,1000,0,0,0,0,0,0,0,0,0,2290,2290,0,2290,1838,650,10,240,144,2
2020,210900371,14030,30,30,30,0,14000,12000,12000,0,0,2000,2000,0,0,7034,7034,5860,60,1178,151,70,200,72,33
2020,210900381,50451,5751,5751,5751,0,44700,40000,40000,0,0,4700,4700,0,0,16940,16940,14940,2000,2840,360,100,400,180,342
2020,210900391,86460,10360,10360,10360,0,76100,76000,40000,36000,0,100,100,0,0,17600,16000,16000,0,6286,360,36,545,180,1006
2020,211000102,8630,8630,3630,3630,5000,0,0,0,0,0,0,0,0,0,1040,1040,1000,0,641,120,0,11,30,3946
2020,211000122,18060,14560,9560,9560,5000,3500,2500,0,2500,0,1000,1000,0,0,7000,7000,7000,0,1362,140,480,240,180,304
2020,211000132,119580,6380,6380,6380,0,113200,113000,113000,0,0,200,200,0,0,26000,26000,26000,0,3680,360,20,120,240,903
2020,211000162,6240,6240,240,240,6000,0,0,0,0,0,0,0,0,0,3550,3550,0,3000,3302,1152,240,300,180,225
2020,211000182,48330,30,30,30,0,48300,48000,28000,20000,0,300,200,100,0,1000,0,0,0,2256,240,120,96,120,84
2020,211000202,17369,3336,3336,3336,0,14033,14000,14000,0,0,33,0,33,0,6046,6046,6046,0,2757,217,60,204,276,17
2020,211000232,58100,50500,5500,5500,45000,7600,0,0,0,0,7600,7600,0,0,50,50,0,0,4364,360,30,300,204,505
2020,211000242,93909,15429,15429,15429,0,78480,77000,77000,0,0,1480,1480,0,0,0,0,0,0,3090,240,500,200,400,1624
2020,211000252,1330,30,30,30,0,1300,0,0,0,0,1300,1300,0,0,0,0,0,0,963,60,3,240,240,27
2020,211000262,18450,200,200,200,0,18250,18000,18000,0,0,250,0,250,0,800,0,0,0,1966,180,250,100,116,24
2020,211000272,5,5,5,5,0,0,0,0,0,0,0,0,0,0,0,0,0,0,683,84,60,10,24,1
2020,211000292,60190,150,150,150,0,60040,60000,60000,0,0,40,40,0,0,25100,25100,25000,0,2958,370,360,60,48,113
2020,211000312,109780,10780,10780,8780,0,99000,98000,98000,0,0,1000,700,300,0,27000,0,0,0,4622,1530,400,410,60,178
2020,211000322,6790,6790,6290,3290,500,0,0,0,0,0,0,0,0,0,3000,3000,0,3000,1390,650,100,20,120,1
2020,211000342,16640,16340,340,340,16000,300,0,0,0,0,300,300,0,0,0,0,0,0,1638,192,30,264,264,31
2020,211000352,301500,6700,6700,6700,0,294800,290000,140000,150000,0,4800,4800,0,0,5000,0,0,0,7470,960,120,1440,480,5606
2020,211000362,2936,2936,1936,1936,1000,0,0,0,0,0,0,0,0,0,10,10,0,0,1422,360,40,72,120,27
2020,211000372,14805,12005,1005,1005,11000,2800,0,0,0,0,2800,1800,0,1000,7060,7060,7000,0,3991,216,250,600,180,48
2020,211000382,13200,13200,200,200,13000,0,0,0,0,0,0,0,0,0,1688,1688,0,1688,3322,1020,380,50,360,1
2020,211600111,23424,21424,1424,1424,20000,2000,0,0,0,0,2000,2000,0,0,1200,1200,0,0,852,160,50,60,42,128
2020,211600201,3530,30,30,30,0,3500,3500,3500,0,0,0,0,0,0,0,0,0,0,740,70,20,0,0,4
2020,211600211,5100,5060,2560,2560,2500,40,0,0,0,0,40,0,40,0,0,0,0,0,1200,280,42,135,124,8
2020,211600241,16996,4096,4096,4096,0,12900,12000,12000,0,0,900,900,0,0,7660,7660,7660,0,2060,130,10,180,120,51
2020,211600251,2487,2442,1442,1442,1000,45,0,0,0,0,45,0,45,0,0,0,0,0,1206,516,50,80,120,19
2020,211600261,31560,3560,3560,3560,0,28000,28000,25000,3000,0,0,0,0,0,300,0,0,0,1575,260,180,140,95,48
2020,211600281,11550,250,250,250,0,11300,11000,11000,0,0,300,300,0,0,0,0,0,0,1330,240,24,180,36,34
2020,211600291,5750,5750,5750,5750,0,0,0,0,0,0,0,0,0,0,0,0,0,0,791,200,150,15,36,1
2020,211600321,53650,10050,10050,4050,0,43600,42000,42000,0,0,1600,1500,100,0,0,0,0,0,2380,300,330,200,160,827
2020,211600331,112000,30400,30400,30400,0,81600,75000,55000,20000,0,6600,6500,100,0,28000,28000,26000,2000,3520,300,50,300,320,1403
2020,211600361,41960,6360,6360,6360,0,35600,35000,35000,0,0,600,600,0,0,30426,126,0,0,3353,420,520,150,87,72
2020,211600381,63000,3000,3000,3000,0,60000,60000,60000,0,0,0,0,0,0,0,0,0,0,1278,240,690,0,36,20
2020,211700111,45685,5785,5785,5785,0,39900,39000,39000,0,0,900,900,0,0,0,0,0,0,2960,360,240,480,240,92
2020,211700151,84500,23800,23800,23800,0,60700,60500,60500,0,0,200,200,0,0,0,0,0,0,1366,226,30,50,120,154
2020,211700161,43108,39358,7358,7358,32000,3750,0,0,0,0,3750,3500,250,0,2800,2800,2800,0,5090,360,200,650,180,85
2020,211700171,58646,8646,8646,8646,0,50000,50000,50000,0,0,0,0,0,0,0,0,0,0,2024,200,300,240,144,83
2020,211700181,50210,5210,5210,5210,0,45000,45000,45000,0,0,0,0,0,0,0,0,0,0,1832,240,100,120,72,32
2020,211700201,45073,6473,6473,6473,0,38600,37000,37000,0,0,1600,1600,0,0,5000,5000,0,0,4020,180,10,500,180,803
2020,211700211,8190,5540,5040,4040,500,2650,0,0,0,0,2650,0,1650,1000,1100,1100,0,0,2319,540,180,69,240,6
2020,211700221,2742,2742,1742,242,1000,0,0,0,0,0,0,0,0,0,5268,5268,268,0,1310,360,30,180,60,1
2020,211700241,412,320,320,320,0,92,0,0,0,0,92,0,92,0,0,0,0,0,1023,140,240,90,20,1
2020,211700251,23708,3208,3208,3208,0,20500,20000,20000,0,0,500,500,0,0,7510,7510,7000,0,2469,180,9,580,110,37
2020,211700261,35545,145,145,145,0,35400,32500,25000,7500,0,2900,1900,1000,0,0,0,0,0,1296,120,70,180,76,71
2020,211700281,16770,1470,1470,1470,0,15300,15000,15000,0,0,300,300,0,0,7638,7638,7368,0,2002,180,12,560,120,79
2020,211700321,23522,4372,4372,4372,0,19150,19000,19000,0,0,150,150,0,0,0,0,0,0,1446,110,50,310,230,51
2020,211700331,98660,57860,10860,10860,47000,40800,35000,0,35000,0,5800,5800,0,0,6000,0,0,0,6070,300,120,360,300,497
2020,211700341,17907,3057,3057,3057,0,14850,14850,0,14850,0,0,0,0,0,30000,30000,0,0,1043,240,100,60,36,95
2020,211700371,2150,2150,150,150,2000,0,0,0,0,0,0,0,0,0,0,0,0,0,799,460,25,0,19,0
2020,211700381,1642,1642,1142,1142,500,0,0,0,0,0,0,0,0,0,360,360,0,360,1090,540,10,60,100,1
2020,211700391,9600,2600,2300,2300,300,7000,7000,0,7000,0,0,0,0,0,5000,0,0,0,919,420,49,10,60,26
2020,211800111,1260,1260,260,260,1000,0,0,0,0,0,0,0,0,0,0,0,0,0,578,420,10,6,18,1
2020,211800121,1784,1784,1484,1484,300,0,0,0,0,0,0,0,0,0,0,0,0,0,866,360,30,60,36,1
2020,211800141,2750,2250,2250,250,0,500,0,0,0,0,500,500,0,0,0,0,0,0,2266,360,10,120,276,9
2020,211800161,121800,32500,12500,12500,20000,89300,80000,0,80000,0,9300,800,500,8000,200,200,0,0,4134,360,1200,480,312,491
2020,211800191,32100,32100,32100,32100,0,0,0,0,0,0,0,0,0,0,0,0,0,0,1175,260,120,5,30,5
2020,211800201,61614,10874,10874,10874,0,50740,50000,30000,20000,0,740,400,340,0,0,0,0,0,4200,300,250,750,480,1201
2020,211800231,53627,2427,2427,2227,0,51200,47000,47000,0,0,4200,2700,1500,0,29000,29000,28400,0,3898,780,135,520,130,90
2020,211800251,7482,6482,4482,3982,2000,1000,0,0,0,0,1000,1000,0,0,2000,2000,0,0,2580,780,20,240,120,61
2020,211800281,2800,2740,440,440,2300,60,0,0,0,0,60,0,60,0,0,0,0,0,1315,300,110,30,85,1
2020,211800291,40480,15350,15350,15350,0,25130,25000,25000,0,0,130,130,0,0,0,0,0,0,2508,240,424,132,106,129
2020,211800301,53146,2146,2146,2146,0,51000,50000,50000,0,0,1000,1000,0,0,1050,1050,800,200,3270,200,30,250,130,46
2020,211800341,149050,8990,6990,2990,2000,140060,130000,0,130000,0,10060,2000,60,8000,78800,50800,50800,0,2870,840,180,200,240,156
2020,211900131,231489,61389,61389,61389,0,170100,170000,170000,0,0,100,100,0,0,0,0,0,0,2574,400,200,340,240,560
2020,211900151,1280,1280,980,980,300,0,0,0,0,0,0,0,0,0,300,300,300,0,1469,588,400,24,42,1
2020,211900171,3008,3008,8,8,3000,0,0,0,0,0,0,0,0,0,0,0,0,0,600,110,0,60,20,0
2020,211900181,3572,3422,2422,2422,1000,150,0,0,0,0,150,150,0,0,900,900,0,0,1310,500,10,120,120,110
2020,211900211,14881,1881,1881,1881,0,13000,13000,13000,0,0,0,0,0,0,0,0,0,0,1170,88,65,80,82,13
2020,211900231,36176,804,804,804,0,35372,35000,12000,23000,0,372,287,85,0,10200,10200,0,10200,4613,192,80,380,180,44
2020,211900251,647,647,157,157,490,0,0,0,0,0,0,0,0,0,100,100,0,0,1086,226,100,30,30,1
2020,211900261,9176,2176,2176,2176,0,7000,7000,7000,0,0,0,0,0,0,400,400,400,0,1560,180,40,150,180,17
2020,211900271,15400,400,400,400,0,15000,15000,15000,0,0,0,0,0,0,0,0,0,0,1086,156,110,60,60,38
2020,211900281,10343,10093,2093,2093,8000,250,0,0,0,0,250,250,0,0,0,0,0,0,3470,160,20,480,180,60
2020,211900291,304130,34330,34330,34330,0,269800,268000,50000,218000,0,1800,1800,0,0,137900,89900,89900,0,2648,204,24,204,156,406
2020,211900321,4820,4470,3470,3470,1000,350,0,0,0,0,350,350,0,0,1000,1000,0,0,2544,600,350,120,144,194
2020,211900371,135064,70064,20064,20064,50000,65000,60000,0,60000,0,5000,4000,1000,0,6000,1000,0,0,5160,720,60,480,300,3257
2020,211900391,31008,1508,1508,1508,0,29500,28900,28900,0,0,600,600,0,0,7100,7100,6600,500,5900,500,100,600,400,61
2020,212000102,2095,2095,95,95,2000,0,0,0,0,0,0,0,0,0,0,0,0,0,1800,600,30,50,300,36
2020,212000112,7999,7799,3799,3799,4000,200,0,0,0,0,200,200,0,0,2980,2980,1800,0,1747,900,5,50,72,27
2020,212000122,90330,2330,2330,2330,0,88000,88000,88000,0,0,0,0,0,0,22020,22020,22020,0,3410,480,120,150,360,331
2020,212000132,4040,3640,140,140,3500,400,0,0,0,0,400,400,0,0,1000,1000,0,0,1620,240,24,96,120,4
2020,212000152,42500,700,700,700,0,41800,41800,41800,0,0,0,0,0,0,0,0,0,0,1222,264,176,10,36,41
2020,212000172,3600,3600,1500,1500,2100,0,0,0,0,0,0,0,0,0,0,0,0,0,556,96,60,10,10,1
2020,212000202,15754,2754,2754,2754,0,13000,13000,13000,0,0,0,0,0,0,7705,7705,7105,0,2384,376,50,288,200,51
2020,212000222,7040,40,40,40,0,7000,7000,7000,0,0,0,0,0,0,0,0,0,0,625,120,30,15,30,7
2020,212000232,100,80,80,80,0,20,0,0,0,0,20,0,20,0,1592,1592,0,1592,2016,480,50,120,216,1
2020,212000242,9670,9170,170,170,9000,500,0,0,0,0,500,500,0,0,900,900,0,900,2140,330,50,300,250,32
2020,212000252,10200,10200,9700,9700,500,0,0,0,0,0,0,0,0,0,0,0,0,0,3590,360,170,182,180,127
2020,212000272,27079,9579,9579,9579,0,17500,16500,16500,0,0,1000,1000,0,0,8120,8120,8000,0,2140,240,60,200,180,61
2020,212000282,1350,1350,1050,1050,300,0,0,0,0,0,0,0,0,0,500,500,0,500,1180,360,0,60,120,61
2020,212000292,31282,16282,16282,16282,0,15000,12000,12000,0,0,3000,3000,0,0,3646,3646,0,300,2506,180,20,280,240,70
2020,212000302,105726,4000,4000,4000,0,101726,90000,40000,50000,0,11726,11500,226,0,38500,0,0,0,4218,360,800,600,168,498
2020,212000312,68120,10782,10782,10782,0,57338,54000,9000,45000,0,3338,400,2938,0,26200,1200,1200,0,6408,936,20,576,264,90
2020,212000322,31170,4670,4670,4670,0,26500,26500,26500,0,0,0,0,0,0,0,0,0,0,1612,192,100,36,84,42
2020,212000332,795,795,295,295,500,0,0,0,0,0,0,0,0,0,0,0,0,0,4796,960,24,72,480,2
2020,212000342,62260,37360,8360,8360,29000,24900,22000,0,22000,0,2900,2900,0,0,5730,5730,5500,200,3600,250,150,300,160,148
2020,212000372,11147,11147,2647,2647,8500,0,0,0,0,0,0,0,0,0,3000,3000,0,0,2180,600,10,60,120,25
2020,212000392,650,650,150,150,500,0,0,0,0,0,0,0,0,0,0,0,0,0,729,480,90,20,15,0
2020,212600141,33330,330,330,330,0,33000,32000,31000,1000,0,1000,1000,0,0,6350,6350,5200,1150,1534,156,100,360,96,36
2020,212600161,210,210,10,10,200,0,0,0,0,0,0,0,0,0,800,800,0,800,1914,432,200,60,120,12
2020,212600171,970,970,520,520,450,0,0,0,0,0,0,0,0,0,0,0,0,0,560,60,80,10,20,1
2020,212600201,37120,10670,10670,10670,0,26450,26000,16000,10000,0,450,450,0,0,0,0,0,0,1310,120,20,240,120,141
2020,212600221,120,120,120,120,0,0,0,0,0,0,0,0,0,0,100,100,0,0,1365,360,150,120,40,77
2020,212600241,18035,980,980,980,0,17055,17000,17000,0,0,55,0,55,0,0,0,0,0,779,181,35,10,25,12
2020,212600351,117600,600,600,600,0,117000,117000,17000,100000,0,0,0,0,0,2500,0,0,0,1836,240,300,30,36,431
2020,212600361,29870,3870,3870,3870,0,26000,26000,26000,0,0,0,0,0,0,12816,12816,9816,0,2142,350,50,180,192,56
2020,212600381,2000,1400,400,400,1000,600,0,0,0,0,600,400,200,0,160,160,0,160,2010,720,180,120,240,16
2020,212600391,4168,4100,2600,2600,1500,68,0,0,0,0,68,0,68,0,2135,2135,1400,420,2940,641,45,180,312,18
2020,212700101,62068,100,100,100,0,61968,61500,60000,1500,0,468,400,68,0,200,200,0,0,2560,360,120,120,120,114
2020,212700131,76048,980,980,980,0,75068,75000,75000,0,0,68,0,68,0,1000,0,0,0,2502,230,1320,30,60,75
2020,212700151,43720,7820,7820,7820,0,35900,35000,35000,0,0,900,900,0,0,1600,1600,1600,0,3940,300,100,720,180,694
2020,212700171,269030,247530,212530,212530,35000,21500,20000,0,20000,0,1500,1000,500,0,0,0,0,0,2864,390,200,500,150,713
2020,212700191,530,530,530,530,0,0,0,0,0,0,0,0,0,0,0,0,0,0,411,57,50,12,22,1
2020,212700201,129104,27759,11759,11759,16000,101345,99000,0,99000,0,2345,2000,345,0,85500,16000,8000,8000,4100,300,50,290,120,1304
2020,212700221,84860,23160,160,160,23000,61700,54000,0,54000,0,7700,7700,0,0,46000,8000,7000,0,4260,400,100,360,300,19
2020,212700231,31092,17092,17092,17092,0,14000,14000,14000,0,0,0,0,0,0,0,0,0,0,2786,300,1000,180,96,50
2020,212700241,26380,17820,17820,17820,0,8560,7500,7500,0,0,1060,600,460,0,60,60,0,0,2790,180,60,240,120,57
2020,212700271,10160,160,160,160,0,10000,10000,10000,0,0,0,0,0,0,6000,6000,6000,0,610,84,10,60,36,9
2020,212700291,16060,1460,1460,1460,0,14600,14500,14500,0,0,100,100,0,0,0,0,0,0,1170,130,120,50,20,49
2020,212700301,4300,4300,900,900,3400,0,0,0,0,0,0,0,0,0,20,20,0,0,1150,306,84,18,42,1
2020,212700311,27168,22068,2568,2568,19500,5100,5000,0,0,5000,100,100,0,0,11500,11500,6500,5000,2530,120,300,150,120,128
2020,212700331,25105,105,105,105,0,25000,25000,25000,0,0,0,0,0,0,0,0,0,0,787,130,33,96,30,51
2020,212700351,18068,17968,2968,2968,15000,100,0,0,0,0,100,100,0,0,0,0,0,0,2870,410,100,360,210,404
2020,212700361,9005,3005,3005,5,0,6000,6000,6000,0,0,0,0,0,0,7703,7703,3925,0,805,50,5,100,120,11
2020,212700371,29048,27048,5048,5048,22000,2000,0,0,0,0,2000,2000,0,0,12000,12000,10000,2000,4490,240,100,120,360,63
2020,212800101,3724,3724,724,724,3000,0,0,0,0,0,0,0,0,0,2900,2900,2100,0,1175,96,70,40,16,113
2020,212800111,19242,842,842,842,0,18400,18400,13000,5400,0,0,0,0,0,2850,2850,0,0,1951,180,60,60,75,13
2020,212800121,39922,1922,1922,1422,0,38000,38000,38000,0,0,0,0,0,0,0,0,0,0,2348,248,100,120,190,78
2020,212800161,119610,33460,15460,15460,18000,86150,85000,0,85000,0,1150,650,500,0,32279,9279,9279,0,5608,650,350,158,200,562
2020,212800171,67728,7228,7228,7228,0,60500,60000,60000,0,0,500,500,0,0,4760,4760,4760,0,4964,300,10,578,276,175
2020,212800191,6795,6795,795,795,6000,0,0,0,0,0,0,0,0,0,0,0,0,0,2290,920,200,120,120,1
2020,212800221,17790,4790,4790,4790,0,13000,13000,13000,0,0,0,0,0,0,0,0,0,0,882,168,250,12,15,20
2020,212800231,8555,670,670,670,0,7885,0,0,0,0,7885,850,35,7000,0,0,0,0,1088,120,360,24,44,16
2020,212800241,24232,6122,6122,6122,0,18110,18000,18000,0,0,110,0,110,0,0,0,0,0,1889,180,55,180,144,27
2020,212800251,19150,1550,1550,1550,0,17600,14600,14600,0,0,3000,3000,0,0,13900,13900,7000,0,1654,144,30,230,250,294
2020,212800261,521,521,21,21,500,0,0,0,0,0,0,0,0,0,0,0,0,0,1147,318,120,72,138,1
2020,212800271,1283,1283,183,183,1100,0,0,0,0,0,0,0,0,0,0,0,0,0,638,233,32,24,18,1
2020,212800281,75700,11100,11100,11100,0,64600,62500,30000,32500,0,2100,1700,400,0,6000,6000,0,6000,7425,360,100,475,240,1758
2020,212800291,59753,7540,7540,7540,0,52213,52000,40000,12000,0,213,100,113,0,5881,3081,3081,0,1548,120,40,100,38,62
2020,212800301,72889,8889,8889,8889,0,64000,64000,57000,0,7000,0,0,0,0,3500,3500,3500,0,3944,180,100,120,264,67
2020,212800321,46712,1012,1012,12,0,45700,45000,45000,0,0,700,0,0,700,0,0,0,0,1011,219,240,14,60,57
2020,212800331,40527,3697,3697,3697,0,36830,32000,32000,0,0,4830,4830,0,0,16940,16940,10480,3760,4040,350,100,900,250,447
2020,212800341,47787,9587,9587,9587,0,38200,38000,38000,0,0,200,200,0,0,9670,9670,9670,0,3078,444,1300,100,104,282
2020,212800351,116080,43580,43580,43580,0,72500,65000,65000,0,0,7500,7500,0,0,31000,31000,31000,0,7560,500,120,400,240,3953
2020,212800361,30340,650,650,650,0,29690,26000,26000,0,0,3690,3690,0,0,13020,13020,13000,0,2820,300,60,600,240,111
2020,212800381,15148,1998,1998,1998,0,13150,13000,8000,5000,0,150,150,0,0,0,0,0,0,2800,123,10,480,96,29
2020,212800391,16700,16700,7700,3700,9000,0,0,0,0,0,0,0,0,0,0,0,0,0,767,60,36,120,36,1
2020,212900111,28046,8046,8046,8046,0,20000,20000,20000,0,0,0,0,0,0,400,400,0,400,2761,180,96,150,135,23
2020,212900121,24851,6851,6851,6851,0,18000,17000,17000,0,0,1000,1000,0,0,50,50,0,0,5280,240,200,600,420,88
2020,212900161,66000,700,700,700,0,65300,65000,65000,0,0,300,300,0,0,0,0,0,0,1144,360,60,72,72,94
2020,212900171,39900,10900,10900,7900,0,29000,26000,26000,0,0,3000,0,3000,0,7600,7600,7600,0,4598,168,20,310,220,52
2020,212900181,31690,30940,16940,16940,14000,750,0,0,0,0,750,750,0,0,0,0,0,0,2190,130,400,250,100,162
2020,212900191,4000,4000,3000,3000,1000,0,0,0,0,0,0,0,0,0,0,0,0,0,2478,600,10,120,120,169
2020,212900221,61130,25830,25830,21330,0,35300,34000,34000,0,0,1300,800,500,0,0,0,0,0,4420,210,30,550,300,597
2020,212900231,56010,9460,9460,9460,0,46550,45000,45000,0,0,1550,1550,0,0,3300,3300,3000,0,6080,450,300,650,180,1408
2020,212900241,17105,2105,2105,2105,0,15000,15000,15000,0,0,0,0,0,0,300,0,0,0,643,96,108,24,34,4
2020,212900271,30,30,30,30,0,0,0,0,0,0,0,0,0,0,0,0,0,0,707,180,24,20,18,1
2020,212900281,29806,2806,2806,2806,0,27000,25500,22500,3000,0,1500,1500,0,0,9510,9510,9510,0,3240,240,50,800,270,234
2020,212900291,84040,23240,23240,23240,0,60800,57000,52000,5000,0,3800,3800,0,0,3580,3580,3220,0,5660,360,200,1400,200,530
2020,212900301,45720,720,720,720,0,45000,45000,29000,16000,0,0,0,0,0,14707,707,0,240,1242,300,100,60,30,75
2020,212900311,82355,555,555,555,0,81800,70000,70000,0,0,11800,11800,0,0,29500,29500,28900,0,7240,500,100,500,360,1780
2020,212900321,31979,9299,9299,9299,0,22680,20000,20000,0,0,2680,2200,480,0,0,0,0,0,3390,280,50,500,240,272
2020,212900341,37952,2902,2902,2902,0,35050,35000,35000,0,0,50,0,50,0,0,0,0,0,1200,190,10,120,40,31
2020,212900351,41056,3056,3056,3056,0,38000,38000,38000,0,0,0,0,0,0,0,0,0,0,1030,50,80,36,0,31
2020,212900361,23712,11712,11712,11712,0,12000,12000,12000,0,0,0,0,0,0,0,0,0,0,1032,181,153,60,40,75
2020,213000112,74320,4794,4794,4794,0,69526,69000,45000,24000,0,526,300,226,0,16500,2500,0,2500,3774,264,600,100,240,486
2020,213000132,45000,5000,5000,5000,0,40000,40000,40000,0,0,0,0,0,0,0,0,0,0,1025,200,10,20,65,21
2020,213000152,26150,550,550,550,0,25600,25000,25000,0,0,600,600,0,0,8250,8250,8000,250,4710,300,150,300,250,557
2020,213000172,9010,10,10,10,0,9000,9000,9000,0,0,0,0,0,0,2220,2220,0,1370,1380,300,200,60,60,12
2020,213000202,32870,2140,2140,2140,0,30730,30700,21700,9000,0,30,30,0,0,2219,219,0,0,1454,180,120,120,84,48
2020,213000212,43950,5360,5360,5360,0,38590,35000,15000,20000,0,3590,3500,90,0,14000,0,0,0,5022,312,450,360,276,341
2020,213000222,32215,65,65,65,0,32150,31000,18000,13000,0,1150,1150,0,0,29000,29000,20000,7300,1956,144,12,100,240,107
2020,213000232,18771,771,771,771,0,18000,18000,18000,0,0,0,0,0,0,500,500,500,0,1689,240,30,72,132,143
2020,213000252,5120,5120,4120,4120,1000,0,0,0,0,0,0,0,0,0,0,0,0,0,1105,300,10,120,55,36
2020,213000272,530,530,30,30,500,0,0,0,0,0,0,0,0,0,0,0,0,0,1270,600,20,30,60,1
2020,213000312,51028,5228,5228,5228,0,45800,41000,41000,0,0,4800,2800,300,1700,2700,2700,1000,1700,3360,140,20,192,180,66
2020,213000342,27156,580,580,580,0,26576,25000,25000,0,0,1576,1576,0,0,5200,5200,5200,0,3575,175,200,300,240,85
2020,213000352,44900,800,800,800,0,44100,25000,15000,10000,0,19100,3100,0,16000,0,0,0,0,1250,180,180,540,120,76
2020,213000362,14510,13710,710,710,13000,800,0,0,0,0,800,800,0,0,1000,1000,0,1000,1936,260,50,300,180,39
2020,213000372,5598,5598,2598,2598,3000,0,0,0,0,0,0,0,0,0,7440,7440,0,5040,6144,1488,36,1200,100,35
2020,213000382,16600,1600,1600,1600,0,15000,15000,15000,0,0,0,0,0,0,0,0,0,0,1380,180,120,24,36,35
2020,213000392,201,201,1,1,200,0,0,0,0,0,0,0,0,0,0,0,0,0,439,96,5,10,24,1
2020,213600101,94630,14630,14630,14630,0,80000,80000,60000,20000,0,0,0,0,0,5000,5000,5000,0,5950,500,1000,800,600,175
2020,213600131,22778,22302,2302,2302,20000,476,0,0,0,0,476,250,226,0,5000,5000,0,5000,2000,240,50,200,160,39
2020,213600141,1690,1690,1440,1440,250,0,0,0,0,0,0,0,0,0,1000,1000,1000,0,581,180,10,40,36,1
2020,213600161,35660,4660,4660,4660,0,31000,31000,19000,12000,0,0,0,0,0,9000,9000,9000,0,2240,240,400,180,180,62
2020,213600221,77270,6970,6970,6970,0,70300,70000,70000,0,0,300,200,100,0,0,0,0,0,5540,600,20,660,180,1892
2020,213600231,245,245,15,15,230,0,0,0,0,0,0,0,0,0,1900,1900,0,1900,726,120,54,72,60,0
2020,213600241,622,622,622,622,0,0,0,0,0,0,0,0,0,0,120,120,0,120,1118,120,24,96,72,1
2020,213600311,23600,8300,8300,6300,0,15300,15000,0,0,15000,300,300,0,0,6000,6000,6000,0,3740,420,100,300,120,272
2020,213600321,72418,20418,20418,20418,0,52000,50000,50000,0,0,2000,2000,0,0,0,0,0,0,2520,300,400,150,120,619
2020,213600341,7862,7862,4462,4462,3400,0,0,0,0,0,0,0,0,0,1600,1600,1600,0,2848,348,87,55,280,203
2020,213600351,8648,5708,1508,1508,4200,2940,2940,0,2940,0,0,0,0,0,0,0,0,0,1874,324,30,100,180,21
2020,213600371,18000,18000,1000,1000,17000,0,0,0,0,0,0,0,0,0,0,0,0,0,770,120,15,20,360,7
2020,213700111,51589,1544,1544,1544,0,50045,50000,50000,0,0,45,0,45,0,9800,9800,9800,0,2670,240,120,360,250,111
2020,213700181,11100,11100,6100,6100,5000,0,0,0,0,0,0,0,0,0,0,0,0,0,2460,130,30,220,120,186
2020,213700201,17454,3841,3841,3841,0,13613,10000,10000,0,0,3613,3500,113,0,6012,6012,4000,0,2581,276,60,470,245,102
2020,213700211,16111,14971,5971,5971,9000,1140,0,0,0,0,1140,800,340,0,3500,3500,3000,0,1850,200,20,50,180,27
2020,213700231,30550,550,550,550,0,30000,30000,30000,0,0,0,0,0,0,2000,2000,0,2000,1420,240,100,200,130,47
2020,213700271,1000,1000,500,500,500,0,0,0,0,0,0,0,0,0,0,0,0,0,589,280,4,20,15,0
2020,213700301,3819,3119,2119,2119,1000,700,0,0,0,0,700,700,0,0,2000,2000,0,0,2680,550,50,450,180,98
2020,213700341,10190,1190,1190,1190,0,9000,9000,9000,0,0,0,0,0,0,0,0,0,0,595,77,150,20,18,11
2020,213700361,12581,876,876,876,0,11705,11500,11500,0,0,205,205,0,0,480,480,480,0,2300,96,5,300,30,264
2020,213700381,12456,12406,2406,2406,10000,50,0,0,0,0,50,0,50,0,7700,7700,6000,1700,3588,276,12,300,300,4
2020,213800101,55900,10900,10900,10900,0,45000,43000,43000,0,0,2000,2000,0,0,11600,11600,10000,1600,5100,310,90,190,310,602
2020,213800121,8560,8480,480,480,8000,80,0,0,0,0,80,80,0,0,0,0,0,0,898,120,60,120,48,14
2020,213800131,925,925,25,25,900,0,0,0,0,0,0,0,0,0,0,0,0,0,421,216,0,10,15,1
2020,213800141,61060,60,60,60,0,61000,60000,60000,0,0,1000,1000,0,0,10551,10551,10551,0,1945,310,140,360,240,114
2020,213800161,91250,48400,48400,48400,0,42850,42200,40000,2200,0,650,650,0,0,0,0,0,0,2046,240,36,200,180,161
2020,213800171,21608,13408,7408,7408,6000,8200,7000,0,7000,0,1200,1200,0,0,0,0,0,0,1425,200,65,200,150,106
2020,213800191,21500,1000,1000,1000,0,20500,20000,20000,0,0,500,500,0,0,0,0,0,0,4560,450,200,250,400,77
2020,213800211,20,20,20,20,0,0,0,0,0,0,0,0,0,0,0,0,0,0,591,80,40,30,12,0
2020,213800241,32395,3295,3295,3295,0,29100,29000,29000,0,0,100,0,100,0,13200,13200,13000,0,1970,180,500,180,120,72
2020,213800261,19920,17320,320,320,17000,2600,0,0,0,0,2600,2600,0,0,14800,14800,13000,0,2370,240,30,600,180,65
2020,213800311,130140,14740,14740,14740,0,115400,115000,25000,56000,34000,400,400,0,0,35200,35000,35000,0,5612,384,360,290,248,1029
2020,213800331,6825,25,25,25,0,6800,5500,5500,0,0,1300,1300,0,0,2300,2300,1300,0,2175,150,150,170,85,65
2020,213800381,6727,6524,2824,2824,3700,203,0,0,0,0,203,0,203,0,0,0,0,0,1702,312,100,192,132,1
2020,213800391,9802,5622,1622,1622,4000,4180,0,0,0,0,4180,4180,0,0,170,170,0,0,1890,300,100,240,120,56
2020,213900141,6800,6300,5300,5300,1000,500,0,0,0,0,500,500,0,0,0,0,0,0,4050,840,20,450,230,59
2020,213900151,1420,1420,420,420,1000,0,0,0,0,0,0,0,0,0,200,200,0,200,1750,720,10,80,108,1
2020,213900171,56834,31834,31834,31834,0,25000,25000,25000,0,0,0,0,0,0,0,0,0,0,2340,536,171,120,48,185
2020,213900181,60450,300,300,300,0,60150,60000,60000,0,0,150,150,0,0,0,0,0,0,1023,230,25,96,42,104
2020,213900221,13751,13751,11751,11751,2000,0,0,0,0,0,0,0,0,0,0,0,0,0,2010,150,300,240,180,26
2020,213900251,32032,13232,13232,13232,0,18800,18000,18000,0,0,800,800,0,0,19500,19500,12500,7000,3834,300,30,360,300,61
2020,213900261,92335,54685,14685,14685,40000,37650,35000,0,35000,0,2650,2650,0,0,20000,0,0,0,5910,360,300,850,130,1870
2020,213900311,10680,1180,1180,1180,0,9500,7000,7000,0,0,2500,2500,0,0,2500,2500,0,0,2630,240,50,330,240,37
2020,213900321,116300,15500,15500,13500,0,100800,100000,100000,0,0,800,300,500,0,14500,7500,7500,0,2604,300,80,360,144,476
2020,213900331,29346,12396,12396,12396,0,16950,13500,13500,0,0,3450,3450,0,0,0,0,0,0,1677,180,11,360,96,162
2020,213900341,7025,2125,1125,1125,1000,4900,0,0,0,0,4900,4900,0,0,6090,6090,0,1040,2290,636,30,360,180,374
2020,213900351,110,110,10,10,100,0,0,0,0,0,0,0,0,0,2000,2000,0,0,1092,384,0,0,84,4
2020,213900361,49018,33518,7518,7518,26000,15500,15000,0,15000,0,500,500,0,0,9000,9000,9000,0,5380,360,300,600,120,1285
2020,213900371,148430,7270,7270,7270,0,141160,133760,38000,95760,0,7400,7400,0,0,45600,0,0,0,2768,276,12,360,120,3325
2020,213900391,156392,153212,120212,120212,33000,3180,0,0,0,0,3180,3180,0,0,0,0,0,0,2955,360,15,600,240,416
2020,214000102,98160,2960,2960,2960,0,95200,95000,25000,70000,0,200,200,0,0,48345,8345,8000,0,4250,156,1000,300,240,244
2020,214000112,41656,6656,6656,4656,0,35000,35000,35000,0,0,0,0,0,0,0,0,0,0,3296,222,100,120,316,169
2020,214000122,118088,5075,5075,4875,0,113013,110000,110000,0,0,3013,2900,113,0,30250,30250,30000,0,2770,300,100,300,140,714
2020,214000132,30750,30750,5750,5600,25000,0,0,0,0,0,0,0,0,0,6800,6800,0,1800,2130,180,100,200,50,921
2020,214000142,5880,5280,4280,4280,1000,600,0,0,0,0,600,600,0,0,0,0,0,0,2242,1180,200,150,144,161
2020,214000152,109560,8860,8860,8860,0,100700,95000,95000,0,0,5700,5700,0,0,16180,16180,15000,680,4562,506,92,600,240,1919
2020,214000182,14200,14000,6000,6000,8000,200,0,0,0,0,200,200,0,0,0,0,0,0,5275,960,700,360,442,32
2020,214000192,2051,1551,51,51,1500,500,0,0,0,0,500,500,0,0,2000,2000,0,0,2324,720,5,600,87,9
2020,214000302,2470,2470,2020,2020,450,0,0,0,0,0,0,0,0,0,3600,3600,0,0,1202,288,244,56,144,2
2020,214000322,81930,2930,2930,2930,0,79000,79000,40000,39000,0,0,0,0,0,34000,0,0,0,1686,238,612,15,96,79
2020,214000332,40628,308,308,308,0,40320,40000,40000,0,0,320,320,0,0,4200,4200,2700,0,2890,308,37,362,294,63
2020,214000342,1730,1730,730,730,1000,0,0,0,0,0,0,0,0,0,0,0,0,0,1982,650,10,72,240,84
2020,214000382,3490,3390,890,890,2500,100,0,0,0,0,100,100,0,0,60,60,0,0,2274,72,20,240,132,76
2020,214000392,39627,8797,8797,8797,0,30830,30600,30000,600,0,230,230,0,0,4500,4500,4500,0,5238,324,84,365,182,406
2020,214600111,94774,55774,31774,31774,24000,39000,39000,0,39000,0,0,0,0,0,53630,21630,19000,2400,2950,240,180,240,360,576
2020,214600121,92440,4440,4440,4440,0,88000,87000,77000,10000,0,1000,0,1000,0,3600,3600,2600,1000,2551,195,36,260,480,206
2020,214600161,42000,2000,2000,2000,0,40000,40000,40000,0,0,0,0,0,0,3000,3000,3000,0,1464,384,120,72,48,62
2020,214600311,32320,2030,2030,2030,0,30290,22000,22000,0,0,8290,290,8000,0,9280,9280,9280,0,2064,300,100,600,144,84
2020,214600331,31001,8501,8501,8501,0,22500,22000,22000,0,0,500,500,0,0,0,0,0,0,3123,240,300,168,120,250
2020,214600351,24208,19028,11028,6028,8000,5180,0,0,0,0,5180,80,100,5000,2500,2500,2000,0,3900,200,300,200,250,31
2020,214600361,1350,550,550,550,0,800,0,0,0,0,800,800,0,0,0,0,0,0,2170,480,10,100,120,65
2020,214600381,35600,500,500,500,0,35100,35000,35000,0,0,100,0,100,0,0,0,0,0,972,339,36,72,18,23
2020,214600391,52870,600,600,600,0,52270,50000,7000,43000,0,2270,0,2270,0,0,0,0,0,512,72,5,100,55,44
2020,214700111,2073,2073,673,673,1400,0,0,0,0,0,0,0,0,0,0,0,0,0,1770,300,300,60,180,1
2020,214700121,15546,15546,546,546,15000,0,0,0,0,0,0,0,0,0,9955,9955,9900,0,1440,700,20,80,100,1
2020,214700131,265958,10958,10958,10958,0,255000,250000,100000,150000,0,5000,5000,0,0,4720,720,0,530,2426,240,136,150,240,450
2020,214700141,32651,11351,11351,11351,0,21300,21000,21000,0,0,300,300,0,0,0,0,0,0,1452,90,40,264,72,49
2020,214700161,27280,19330,3330,3330,16000,7950,0,0,0,0,7950,450,0,7500,15,15,0,0,1635,260,180,20,55,5
2020,214700171,1041,1041,541,541,500,0,0,0,0,0,0,0,0,0,983,983,0,983,2028,744,20,180,180,14
2020,214700301,23608,7130,7130,7130,0,16478,0,0,0,0,16478,800,15678,0,3560,3560,0,0,3146,142,10,600,360,14
2020,214700311,18590,1590,1590,1590,0,17000,15000,15000,0,0,2000,2000,0,0,11196,11196,10256,0,2564,132,12,240,60,225
2020,214700321,31261,4961,4961,4961,0,26300,23000,23000,0,0,3300,3300,0,0,9200,9200,9200,0,1961,156,24,181,120,377
2020,214700331,9805,9805,3105,3105,6700,0,0,0,0,0,0,0,0,0,19600,19600,0,19600,2063,513,170,175,122,13
2020,214700341,71601,70651,14651,14651,56000,950,0,0,0,0,950,950,0,0,0,0,0,0,6930,700,150,1000,180,2363
2020,214700381,33210,1060,1060,1060,0,32150,27000,27000,0,0,5150,5150,0,0,17792,17792,17412,380,3180,720,20,360,240,526
2020,214800101,119800,9800,9800,9800,0,110000,105000,105000,0,0,5000,5000,0,0,30500,30500,30000,500,4750,600,50,300,300,1710
2020,214800131,20012,12,12,12,0,20000,20000,20000,0,0,0,0,0,0,0,0,0,0,920,120,25,60,60,159
2020,214800141,35570,29070,10570,10570,18500,6500,6500,0,0,6500,0,0,0,0,0,0,0,0,2200,300,300,360,240,42
2020,214800151,1095,1095,120,120,975,0,0,0,0,0,0,0,0,0,0,0,0,0,1575,247,72,96,120,288
2020,214800161,57070,4070,4070,4070,0,53000,53000,53000,0,0,0,0,0,0,168,168,0,0,2320,168,30,300,72,44
2020,214800191,2798,2798,2798,2798,0,0,0,0,0,0,0,0,0,0,0,0,0,0,1115,105,100,20,85,57
2020,214800311,60007,8057,8057,7057,0,51950,50000,50000,0,0,1950,1950,0,0,9540,9540,9515,0,4618,372,53,420,372,359
2020,214800331,91959,30500,30500,30500,0,61459,56000,56000,0,0,5459,2459,3000,0,0,0,0,0,5480,360,200,720,360,211
2020,214800341,27995,4945,4945,3445,0,23050,22000,22000,0,0,1050,250,300,500,15770,15770,8470,7000,4024,300,180,240,264,65
2020,214800391,21110,11160,11160,8660,0,9950,0,0,0,0,9950,3900,50,6000,3500,3500,3000,0,3120,210,1500,120,200,430
2020,214900101,10864,8864,3864,2664,5000,2000,0,0,0,0,2000,0,500,1500,3000,3000,1000,2000,2057,720,12,240,120,1
2020,214900131,41400,41400,6400,6400,35000,0,0,0,0,0,0,0,0,0,0,0,0,0,950,230,20,20,110,1
2020,214900141,2400,2400,400,400,2000,0,0,0,0,0,0,0,0,0,0,0,0,0,1542,720,30,84,132,1
2020,214900171,38380,3380,3380,3380,0,35000,35000,15000,20000,0,0,0,0,0,3000,0,0,0,1671,203,670,0,60,58
2020,214900181,2116,2116,1116,1116,1000,0,0,0,0,0,0,0,0,0,0,0,0,0,1565,780,20,50,40,0
2020,214900311,63370,1250,1250,1250,0,62120,60000,60000,0,0,2120,2120,0,0,15392,15392,15392,0,2563,420,120,620,288,425
2020,214900321,49615,25485,5485,1485,20000,24130,24000,0,22000,2000,130,130,0,0,18650,17650,15000,650,4823,184,100,183,72,39
2020,214900341,8642,8642,1142,1142,7500,0,0,0,0,0,0,0,0,0,0,0,0,0,2121,243,31,175,182,1
2020,214900361,41820,38020,3020,3020,35000,3800,0,0,0,0,3800,3800,0,0,17400,17400,15400,2000,5000,300,120,550,300,527
2020,214900381,36954,5100,5100,5100,0,31854,28500,28500,0,0,3354,2354,1000,0,0,0,0,0,4486,336,108,315,247,101
2020,214900391,24226,23896,1896,1896,22000,330,0,0,0,0,330,330,0,0,22400,22400,20000,2400,3963,300,82,600,420,45
2020,215000102,17506,3280,280,280,3000,14226,14000,0,14000,0,226,0,226,0,0,0,0,0,1022,212,10,100,240,4
2020,215000112,87230,1130,1130,1130,0,86100,80000,40000,40000,0,6100,100,0,6000,39980,11980,5480,6500,2931,231,100,1060,180,97
2020,215000122,42120,41820,10820,10820,31000,300,0,0,0,0,300,300,0,0,0,0,0,0,4430,360,100,200,360,2341
2020,215000152,1542,1472,1195,1195,277,70,0,0,0,0,70,70,0,0,0,0,0,0,1016,156,120,130,120,13
2020,215000162,550,550,50,50,500,0,0,0,0,0,0,0,0,0,0,0,0,0,851,140,100,40,16,1
2020,215000192,65393,40393,26393,26393,14000,25000,25000,0,25000,0,0,0,0,0,1000,0,0,0,1861,168,5,120,108,371
2020,215000312,10600,2600,2600,2600,0,8000,8000,0,8000,0,0,0,0,0,0,0,0,0,1752,156,50,204,72,20
2020,215000342,64240,13800,13800,13800,0,50440,49640,27500,0,22140,800,800,0,0,23390,23390,1250,22140,4067,360,37,350,180,1484
2020,215000352,20750,5950,5950,5950,0,14800,14500,14500,0,0,300,300,0,0,3930,3930,3930,0,4725,300,100,375,420,1080
2020,215000362,21476,2876,2876,2876,0,18600,15000,15000,0,0,3600,3600,0,0,6968,6968,6968,0,3178,150,10,606,130,146
2020,215000372,21640,3000,3000,3000,0,18640,18000,18000,0,0,640,640,0,0,40,40,0,0,3284,316,50,220,278,237
2020,215000382,22308,1608,1308,1308,300,20700,20000,0,20000,0,700,700,0,0,5000,5000,5000,0,3020,460,520,240,230,73
2020,215000392,6046,5980,5980,5980,0,66,0,0,0,0,66,0,66,0,4700,4700,4700,0,1005,150,152,24,48,7
2020,215600111,13,13,13,13,0,0,0,0,0,0,0,0,0,0,0,0,0,0,463,216,30,50,18,1
2020,215600141,11408,3408,3408,3408,0,8000,8000,8000,0,0,0,0,0,0,12,12,0,0,3306,438,50,240,288,177
2020,215600181,435440,82140,82140,82140,0,353300,349500,160000,189500,0,3800,3500,300,0,109000,29500,26500,3000,5790,600,500,450,240,3008
2020,215600311,80400,7000,7000,7000,0,73400,72500,32500,40000,0,900,900,0,0,8500,3500,0,3500,3636,300,200,120,216,1366
2020,215600321,1520,907,407,407,500,613,0,0,0,0,613,500,113,0,700,700,0,0,2502,447,224,408,180,107
2020,215600331,22704,8704,8704,8704,0,14000,14000,14000,0,0,0,0,0,0,8600,8600,8600,0,1498,240,100,120,48,92
2020,215600391,42890,10890,10890,10890,0,32000,32000,32000,0,0,0,0,0,0,0,0,0,0,2419,295,210,104,210,40
2020,215700101,14674,12874,9874,9774,3000,1800,0,0,0,0,1800,1800,0,0,0,0,0,0,6210,1440,1000,360,360,97
2020,215700121,18450,450,450,450,0,18000,18000,18000,0,0,0,0,0,0,7760,7760,7460,300,2020,280,120,180,300,46
2020,215700131,18500,18500,7500,7500,11000,0,0,0,0,0,0,0,0,0,2000,2000,2000,0,2160,360,150,50,40,3
2020,215700151,9010,9010,3010,3010,6000,0,0,0,0,0,0,0,0,0,120,120,0,0,2066,180,10,150,168,1
2020,215700161,15840,150,150,150,0,15690,15000,15000,0,0,690,690,0,0,6400,6400,6000,200,1642,50,120,78,120,37
2020,215700181,311300,151000,151000,151000,0,160300,160000,150000,10000,0,300,300,0,0,1000,0,0,0,5886,540,20,360,126,831
2020,215700191,3590,3590,2530,2530,1060,0,0,0,0,0,0,0,0,0,0,0,0,0,648,72,220,10,36,1
2020,215700311,16460,160,160,160,0,16300,16000,16000,0,0,300,300,0,0,0,0,0,0,1102,230,78,90,84,95
2020,215700321,66600,7300,7300,7300,0,59300,59000,59000,0,0,300,300,0,0,3000,3000,0,0,6142,380,1820,370,150,547
2020,215700351,22400,17600,16600,16600,1000,4800,3400,0,0,3400,1400,1100,300,0,200,200,0,0,2668,960,30,240,144,365
2020,215700381,36448,12548,12548,11548,0,23900,20000,20000,0,0,3900,2900,0,1000,10032,10032,9932,0,2286,240,120,480,216,138
2020,215700391,2338,2310,210,210,2100,28,0,0,0,0,28,28,0,0,1800,1800,0,1800,2216,372,480,186,108,5
2020,215800111,65140,5140,5140,5140,0,60000,60000,60000,0,0,0,0,0,0,0,0,0,0,2548,300,20,48,60,61
2020,215800131,27290,1290,1290,1290,0,26000,26000,26000,0,0,0,0,0,0,14500,14500,12000,2500,2204,278,50,956,120,145
2020,215800171,40400,3050,3050,3050,0,37350,37000,23000,14000,0,350,350,0,0,5100,5100,5000,0,1715,156,90,384,101,125
2020,215800351,84440,25320,7320,7320,18000,59120,57820,0,22000,35820,1300,1100,200,0,54070,36070,14400,21540,4110,360,1000,600,150,528
2020,215800381,1830,1830,30,30,1800,0,0,0,0,0,0,0,0,0,660,660,0,210,2350,360,330,320,240,0
2020,215800391,133150,3150,3150,3150,0,130000,130000,90000,40000,0,0,0,0,0,10000,10000,0,0,962,130,120,150,50,174
2020,215900101,95500,13500,500,500,13000,82000,78000,0,78000,0,4000,4000,0,0,28500,8500,6500,2000,2162,206,270,72,180,224
2020,215900111,32250,32250,12250,12250,20000,0,0,0,0,0,0,0,0,0,0,0,0,0,1122,120,12,96,180,127
2020,215900141,52917,10617,10617,9617,0,42300,40000,40000,0,0,2300,2300,0,0,37480,32480,30000,2480,3006,240,1000,480,336,559
2020,215900161,4500,4100,200,200,3900,400,0,0,0,0,400,400,0,0,0,0,0,0,2893,516,0,450,180,33
2020,215900171,3640,3640,1140,1140,2500,0,0,0,0,0,0,0,0,0,0,0,0,0,2020,144,130,180,120,20
2020,215900311,33344,6244,6244,6244,0,27100,26000,26000,0,0,1100,1100,0,0,2035,2035,1423,7,1488,300,50,320,88,122
2020,215900321,58220,7020,7020,7020,0,51200,51000,28000,23000,0,200,0,200,0,1000,0,0,0,4280,300,60,240,480,2264
2020,215900341,122482,43762,43762,43262,0,78720,78000,60000,18000,0,720,720,0,0,19771,19271,19256,0,3086,480,80,482,360,138
2020,215900351,2080,2080,80,80,2000,0,0,0,0,0,0,0,0,0,0,0,0,0,2195,300,120,40,360,121
2020,215900381,45740,22740,4740,4740,18000,23000,23000,0,23000,0,0,0,0,0,23580,23580,21580,2000,1650,300,250,0,300,234
2020,215900391,1050,850,350,350,500,200,0,0,0,0,200,200,0,0,0,0,0,0,2210,480,60,200,180,100
2020,216000132,18560,560,560,560,0,18000,18000,18000,0,0,0,0,0,0,0,0,0,0,1344,185,35,50,108,24
2020,216000142,56650,56650,38650,38650,18000,0,0,0,0,0,0,0,0,0,0,0,0,0,550,110,32,24,24,83
2020,216000162,1100,1100,100,100,1000,0,0,0,0,0,0,0,0,0,0,0,0,0,1480,840,10,60,60,6
2020,216000182,107430,36830,6830,6830,30000,70600,70000,0,70000,0,600,600,0,0,49000,21000,20000,1000,5562,216,50,240,216,565
2020,216000192,111840,9390,9390,9390,0,102450,100550,80000,20550,0,1900,1900,0,0,24500,24500,24500,0,3200,300,50,200,200,4374
2020,216000322,360890,50010,20010,20010,30000,310880,310000,0,310000,0,880,880,0,0,93000,70000,70000,0,7016,396,2500,700,300,1016
2020,216000332,51850,3100,3100,3100,0,48750,48000,48000,0,0,750,750,0,0,15520,15520,14520,1000,3780,360,300,720,180,130
2020,216000342,64824,22924,2924,2924,20000,41900,40000,0,40000,0,1900,1900,0,0,27200,7200,7200,0,3791,240,200,270,180,2491
2020,216000352,58100,2100,2100,2100,0,56000,56000,56000,0,0,0,0,0,0,20,20,0,0,1278,300,30,10,60,69
2020,216000362,55750,4150,4150,4150,0,51600,50000,50000,0,0,1600,1600,0,0,8204,8204,1507,4697,7171,420,1000,1000,300,169
2020,216000382,128500,6000,6000,6000,0,122500,119500,62000,57500,0,3000,3000,0,0,54920,9920,0,9600,8240,1480,300,240,120,2467
2020,216000392,28750,20330,20330,20330,0,8420,8350,8350,0,0,70,0,70,0,0,0,0,0,1150,97,600,53,60,190
2020,216600101,2632,2632,1632,1632,1000,0,0,0,0,0,0,0,0,0,140,140,0,0,2551,1080,80,144,180,27
2020,216600121,1900,1800,800,800,1000,100,0,0,0,0,100,100,0,0,0,0,0,0,1076,412,50,100,90,24
2020,216600151,58706,1706,1706,1706,0,57000,57000,57000,0,0,0,0,0,0,14500,14500,14500,0,1854,168,20,120,216,45
2020,216600301,83826,526,526,526,0,83300,82000,47000,35000,0,1300,1300,0,0,3000,0,0,0,4668,648,150,400,50,180
2020,216600311,62670,17370,17370,17370,0,45300,43000,43000,0,0,2300,1800,500,0,10000,10000,10000,0,3740,300,200,400,100,344
2020,216600321,2750,2750,50,50,2700,0,0,0,0,0,0,0,0,0,0,0,0,0,524,60,60,120,24,12
2020,216600341,20540,5020,5020,5020,0,15520,15000,15000,0,0,520,520,0,0,1810,1810,1740,0,1105,240,30,200,65,36
2020,216600361,471486,22000,22000,22000,0,449486,442000,42000,400000,0,7486,3260,4226,0,15000,0,0,0,6736,600,100,1200,336,1770
2020,216600371,71642,54542,15792,15792,38750,17100,13500,0,0,13500,3600,3600,0,0,0,0,0,0,4620,400,200,300,120,494
2020,216600381,12300,200,200,200,0,12100,12000,12000,0,0,100,100,0,0,0,0,0,0,720,204,10,20,38,33
2020,216700101,2510,2510,10,10,2500,0,0,0,0,0,0,0,0,0,0,0,0,0,485,120,15,20,20,1
2020,216700131,10555,10205,4205,3705,6000,350,0,0,0,0,350,350,0,0,3450,3450,0,3400,1798,600,63,250,180,218
2020,216700141,1365,1365,365,365,1000,0,0,0,0,0,0,0,0,0,5000,5000,0,0,548,216,2,49,36,13
2020,216700151,800,800,300,300,500,0,0,0,0,0,0,0,0,0,2170,2170,0,1770,1565,636,5,84,120,9
2020,216700161,185225,7225,7225,4225,0,178000,166000,46000,120000,0,12000,0,3000,9000,45000,30000,30000,0,4050,800,50,1300,200,365
2020,216700171,64900,26700,8700,8700,18000,38200,38000,0,38000,0,200,200,0,0,5000,0,0,0,1602,132,80,70,60,143
2020,216700311,158000,18000,18000,18000,0,140000,140000,60000,80000,0,0,0,0,0,28000,28000,28000,0,1400,240,100,50,100,506
2020,216700321,135630,24472,24472,21472,0,111158,108845,80000,13200,15645,2313,2313,0,0,14875,14875,0,14875,9900,350,300,900,300,2001
2020,216700361,20900,100,100,100,0,20800,19000,19000,0,0,1800,1800,0,0,6500,6500,5500,1000,1805,175,10,200,150,114
2020,216800141,102117,9117,9117,9117,0,93000,90000,90000,0,0,3000,3000,0,0,0,0,0,0,2958,250,300,310,150,171
2020,216800181,12320,2320,320,320,2000,10000,10000,0,10000,0,0,0,0,0,3000,0,0,0,2450,500,1200,20,70,9
2020,216800301,30519,12519,12519,12519,0,18000,17500,17500,0,0,500,500,0,0,0,0,0,0,3020,240,210,240,150,401
2020,216800311,23735,4885,4885,4885,0,18850,17500,17500,0,0,1350,1350,0,0,7924,7924,6024,1900,2760,260,40,500,190,218
2020,216800321,3170,2890,1590,1590,1300,280,0,0,0,0,280,280,0,0,1000,1000,0,1000,2022,336,0,384,54,16
2020,216800331,105652,25052,25052,25052,0,80600,80000,80000,0,0,600,600,0,0,4900,4900,0,4900,4880,600,200,300,130,3563
2020,216800341,31136,5871,5871,5871,0,25265,24500,8000,16500,0,765,350,415,0,0,0,0,0,768,180,180,60,60,18
2020,216800351,3080,3080,80,80,3000,0,0,0,0,0,0,0,0,0,0,0,0,0,693,231,142,14,24,1
2020,216800361,62619,34119,8119,6119,26000,28500,16000,0,0,16000,12500,500,10000,2000,12000,12000,0,12000,6939,360,20,410,360,820
2020,216800371,94525,11025,11025,11025,0,83500,83000,43000,40000,0,500,500,0,0,50625,35625,34655,950,2720,360,150,60,120,265
2020,216800381,291050,41000,41000,41000,0,250050,250000,21000,229000,0,50,0,50,0,0,0,0,0,940,120,400,50,60,314
2020,216800391,135170,5020,5020,1520,0,130150,129900,20900,109000,0,250,250,0,0,2900,2900,2900,0,2720,300,320,320,150,106
2020,216900101,620,570,570,570,0,50,0,0,0,0,50,50,0,0,0,0,0,0,1585,312,20,535,132,170
2020,216900111,26510,25510,7010,7010,18500,1000,0,0,0,0,1000,1000,0,0,10060,10060,10000,0,3739,123,300,150,240,359
2020,216900121,170,170,20,20,150,0,0,0,0,0,0,0,0,0,0,0,0,0,1388,149,60,24,60,0
2020,216900131,9714,9014,4014,4014,5000,700,0,0,0,0,700,700,0,0,2000,2000,0,2000,2655,136,10,300,135,53
2020,216900141,38200,34900,8900,8900,26000,3300,0,0,0,0,3300,3200,100,0,20000,20000,20000,0,2366,180,120,300,300,280
2020,216900161,365500,136600,136600,136600,0,228900,228000,200000,28000,0,900,400,500,0,700,0,0,0,3930,500,100,400,160,844
2020,216900171,228700,27500,27500,27500,0,201200,200000,200000,0,0,1200,1200,0,0,53500,53500,53500,0,4030,370,100,110,200,2176
2020,216900191,178180,14980,14980,14980,0,163200,162000,70000,92000,0,1200,1200,0,0,0,0,0,0,4275,480,240,360,45,308
2020,216900321,78550,15050,15050,15050,0,63500,57000,27000,30000,0,6500,3500,0,3000,12000,12000,12000,0,5900,400,200,300,300,1600
2020,216900331,40214,3914,3914,3914,0,36300,34000,31000,3000,0,2300,2300,0,0,14700,14700,11000,400,1483,640,100,138,65,44
2020,216900341,56500,11000,7500,4000,3500,45500,45000,0,45000,0,500,500,0,0,40000,10000,10000,0,1260,240,20,180,80,749
2020,216900351,61429,429,429,429,0,61000,60000,60000,0,0,1000,1000,0,0,30070,30070,22140,6930,5700,620,300,180,396,313
2020,216900361,117650,650,650,650,0,117000,117000,57000,60000,0,0,0,0,0,0,0,0,0,1367,350,20,80,42,140
2020,216900381,460320,53470,53470,42470,0,406850,365350,75000,290175,175,41500,3500,38000,0,108629,37629,23029,14600,4250,600,120,300,120,665
2020,217000102,69080,9080,80,80,9000,60000,60000,0,60000,0,0,0,0,0,450,450,400,0,1008,96,360,36,60,91
2020,217000112,6670,6670,6670,6670,0,0,0,0,0,0,0,0,0,0,0,0,0,0,3800,200,100,150,200,108
2020,217000132,54800,800,800,800,0,54000,54000,54000,0,0,0,0,0,0,0,0,0,0,480,80,50,10,60,31
2020,217000142,791680,36680,36680,36680,0,755000,755000,135000,620000,0,0,0,0,0,30000,0,0,0,4130,600,150,100,180,5523
2020,217000162,33925,2825,2825,2825,0,31100,31000,31000,0,0,100,0,100,0,0,0,0,0,1620,134,100,100,80,70
2020,217000182,105600,2600,2600,2600,0,103000,100000,100000,0,0,3000,3000,0,0,14000,0,0,0,2856,168,120,72,96,1956
2020,217000192,11300,11300,8300,6700,3000,0,0,0,0,0,0,0,0,0,0,0,0,0,3670,900,350,180,120,35
2020,217000312,48625,12420,4020,4020,8400,36205,32500,0,32500,0,3705,3705,0,0,6405,6405,6400,0,5848,852,70,624,240,568
2020,217000322,39890,7390,7390,7390,0,32500,29500,29500,0,0,3000,3000,0,0,13800,13800,13800,0,3390,240,1000,360,130,490
2020,217000332,13757,757,757,757,0,13000,13000,13000,0,0,0,0,0,0,0,0,0,0,701,204,50,10,16,9
2020,217000352,66840,28740,28740,28740,0,38100,33500,30500,3000,0,4600,4600,0,0,52,52,0,0,9739,300,1496,785,360,316
2020,217000362,61546,5346,5346,5346,0,56200,52400,52400,0,0,3800,3800,0,0,20000,20000,20000,0,3750,300,30,240,240,103
2020,217000382,35890,24190,1190,1190,23000,11700,10000,0,0,10000,1700,1700,0,0,22000,22000,0,21200,2029,300,60,180,180,40
2020,217000392,21908,2908,2908,2908,0,19000,18000,18000,0,0,1000,1000,0,0,38,38,0,0,2254,360,80,360,120,1025
2020,217600101,60,60,60,60,0,0,0,0,0,0,0,0,0,0,0,0,0,0,684,180,0,0,24,9
2020,217600121,16100,950,950,950,0,15150,15000,15000,0,0,150,0,150,0,0,0,0,0,690,83,100,30,40,13
2020,217600131,9935,9375,1375,1375,8000,560,0,0,0,0,560,560,0,0,0,0,0,0,333,65,36,84,36,26
2020,217600141,7520,7520,20,20,7500,0,0,0,0,0,0,0,0,0,7200,7200,7200,0,589,84,15,5,15,0
2020,217600161,360176,9456,9456,9456,0,350720,347220,140000,200000,7220,3500,3500,0,0,59000,59000,49000,10000,7810,1020,300,400,360,1673
2020,217600301,48672,6172,6172,6172,0,42500,37000,30000,7000,0,5500,5500,0,0,23500,23500,16000,0,6960,360,800,500,300,847
2020,217600311,29388,19888,14888,14888,5000,9500,2500,0,0,2500,7000,7000,0,0,12500,12500,4000,5000,6300,1500,100,500,200,346
2020,217600321,75457,5947,5947,5947,0,69510,69000,69000,0,0,510,310,200,0,17840,17840,17840,0,3662,300,200,280,150,97
2020,217600331,25180,22100,4600,4600,17500,3080,0,0,0,0,3080,2780,300,0,13364,13364,13364,0,2748,250,300,350,48,23
2020,217600341,11277,4777,2927,927,1850,6500,0,0,0,0,6500,2000,4500,0,11100,11100,1100,10000,1538,239,0,200,96,40
2020,217600351,195890,8490,8490,8490,0,187400,177900,25000,152900,0,9500,9500,0,0,22000,19000,19000,0,5402,280,20,260,164,359
2020,217600361,12436,748,748,748,0,11688,11600,10000,1600,0,88,0,88,0,0,0,0,0,788,180,60,72,48,26
2020,217600381,65878,15398,15398,15398,0,50480,47000,47000,0,0,3480,3480,0,0,10400,10400,9400,1000,7914,420,20,410,284,1164
2020,217600391,23118,21818,1818,1818,20000,1300,0,0,0,0,1300,1300,0,0,0,0,0,0,3320,360,120,360,240,67
2020,217700111,2795,2795,1795,1795,1000,0,0,0,0,0,0,0,0,0,200,200,0,200,1402,540,10,72,120,1
2020,217700121,22200,22200,6200,6200,16000,0,0,0,0,0,0,0,0,0,0,0,0,0,1260,240,120,120,120,31
2020,217700131,20794,20794,794,794,20000,0,0,0,0,0,0,0,0,0,0,0,0,0,2914,96,60,288,336,2
2020,217700161,13300,11300,4300,4300,7000,2000,2000,0,0,2000,0,0,0,0,20,20,0,0,1381,58,90,96,73,17
2020,217700191,7973,7973,2473,2473,5500,0,0,0,0,0,0,0,0,0,5800,5800,3500,2100,4359,570,20,294,465,57
2020,217700301,196100,10005,10005,8505,0,186095,185595,55000,130595,0,500,400,100,0,21392,11392,11392,0,2320,300,240,100,140,199
2020,217700311,14546,13970,4170,4170,9800,576,0,0,0,0,576,350,226,0,60,60,0,0,4750,960,480,480,360,76
2020,217700321,13046,12646,4646,4646,8000,400,0,0,0,0,400,400,0,0,7200,7200,6000,1200,2402,400,100,50,140,270
2020,217700341,4405,5,5,5,0,4400,4000,4000,0,0,400,400,0,0,0,0,0,0,1317,166,10,60,120,33
2020,217700351,15992,15992,1992,1992,14000,0,0,0,0,0,0,0,0,0,0,0,0,0,2366,360,300,120,96,1010
2020,217700381,34980,6280,6280,6280,0,28700,26000,26000,0,0,2700,2700,0,0,2200,2200,2200,0,1992,324,42,96,180,107
2020,217800101,14256,14256,4256,4256,10000,0,0,0,0,0,0,0,0,0,81,81,0,0,1779,516,9,210,84,500
2020,217800121,562380,68280,68280,67280,0,494100,490000,250000,240000,0,4100,4100,0,0,3000,0,0,0,7040,1380,50,360,300,545
2020,217800301,23612,2112,2112,2112,0,21500,20500,20500,0,0,1000,1000,0,0,4250,4250,4250,0,3870,270,100,300,250,383
2020,217800311,18995,15995,1995,1995,14000,3000,0,0,0,0,3000,3000,0,0,8140,8140,8140,0,2150,400,50,200,120,37
2020,217800321,84311,3511,3511,3511,0,80800,74600,32000,39600,3000,6200,6200,0,0,800,0,0,0,4400,540,600,660,274,509
2020,217800331,5608,5608,4608,1608,1000,0,0,0,0,0,0,0,0,0,0,0,0,0,2676,660,10,10,96,1
2020,217800351,19141,6141,6141,5141,0,13000,10000,10000,0,0,3000,1500,500,1000,5500,5500,5500,0,3249,820,100,360,250,165
2020,217800371,578,528,28,28,500,50,0,0,0,0,50,0,50,0,0,0,0,0,890,383,72,36,19,1
2020,217800381,325,325,25,25,300,0,0,0,0,0,0,0,0,0,700,700,0,700,667,370,20,24,84,1
2020,217800391,65128,14560,14560,13560,0,50568,49000,30000,19000,0,1568,1500,68,0,6000,5000,0,0,4176,406,60,780,156,245
2020,217900101,100450,14400,14400,14400,0,86050,86000,80000,6000,0,50,50,0,0,0,0,0,0,2304,360,120,120,84,215
2020,217900111,82262,9962,9962,9962,0,72300,72000,67000,5000,0,300,300,0,0,180,180,0,0,2478,276,120,84,72,88
2020,217900131,49220,19020,19020,9020,0,30200,28000,28000,0,0,2200,2200,0,0,7200,7200,0,7200,4990,240,600,800,240,178
2020,217900151,2602,2602,1732,1732,870,0,0,0,0,0,0,0,0,0,0,0,0,0,1027,240,18,60,84,5
2020,217900161,600,600,100,100,500,0,0,0,0,0,0,0,0,0,6140,6140,0,5040,1821,140,12,324,360,48
2020,217900171,114248,8328,8328,8328,0,105920,105000,105000,0,0,920,920,0,0,19000,19000,19000,0,3990,500,50,700,240,832
2020,217900181,154522,58722,11722,11722,47000,95800,94000,0,94000,0,1800,1800,0,0,3500,0,0,0,3296,276,350,400,180,64
2020,217900191,150630,22630,22630,22630,0,128000,125000,125000,0,0,3000,3000,0,0,37400,37400,34900,2500,5364,384,50,200,120,302
2020,217900301,15560,14070,2070,2070,12000,1490,0,0,0,0,1490,1490,0,0,3920,3920,3000,800,3041,360,96,482,156,140
2020,217900321,6674,5306,3406,3406,1900,1368,0,0,0,0,1368,1300,68,0,3400,3400,3400,0,2386,156,60,360,192,44
2020,217900331,2473,2428,628,628,1800,45,0,0,0,0,45,0,45,0,0,0,0,0,1016,336,10,120,72,3
2020,217900341,141890,990,990,990,0,140900,140000,35000,105000,0,900,900,0,0,89000,89000,88500,500,1506,360,120,480,96,822
2020,217900351,230070,20670,20670,8670,0,209400,190000,45000,145000,0,19400,4400,15000,0,20724,12724,12424,0,9702,1380,500,570,300,1103
2020,217900371,62619,16619,16619,16619,0,46000,46000,36000,10000,0,0,0,0,0,0,0,0,0,7740,600,120,1200,240,1466
2020,218000112,2110,2110,110,110,2000,0,0,0,0,0,0,0,0,0,100,100,0,0,2610,840,10,180,180,18
2020,218000122,39000,6000,1000,1000,5000,33000,33000,0,33000,0,0,0,0,0,5000,0,0,0,2563,900,20,10,193,41
2020,218000132,24200,4200,4200,4200,0,20000,20000,20000,0,0,0,0,0,0,0,0,0,0,1015,360,40,0,0,60
2020,218000152,1990,1990,990,990,1000,0,0,0,0,0,0,0,0,0,2600,2600,0,2500,2744,1140,24,10,120,23
2020,218000302,3045,2165,465,465,1700,880,0,0,0,0,880,880,0,0,0,0,0,0,1890,370,80,250,110,31
2020,218000312,2660,2660,1160,1160,1500,0,0,0,0,0,0,0,0,0,0,0,0,0,1650,450,130,50,60,1
2020,218000332,9474,2034,2034,2034,0,7440,6500,5000,1500,0,940,890,50,0,0,0,0,0,840,120,10,100,36,19
2020,218000342,11519,4069,4069,4069,0,7450,7200,5200,2000,0,250,150,100,0,500,500,0,500,1200,480,95,80,132,16
2020,218600101,210000,9000,9000,9000,0,201000,200000,200000,0,0,1000,0,1000,0,9000,9000,9000,0,1271,234,70,106,96,527
2020,218600161,229460,44860,44860,41860,0,184600,165000,130000,35000,0,19600,4000,600,15000,7600,3000,3000,0,5740,240,2040,300,240,877
2020,218600171,361042,12342,12342,12342,0,348700,345000,300000,45000,0,3700,3700,0,0,42900,40900,39700,1100,12960,810,100,900,300,2984
2020,218600191,305670,174270,79270,79270,95000,131400,125000,0,125000,0,6400,6400,0,0,55000,0,0,0,5410,340,250,1000,420,2003
2020,218600311,26634,9334,7334,7334,2000,17300,0,0,0,0,17300,17300,0,0,9100,9100,0,3000,3398,120,60,240,300,141
2020,218600321,5820,4140,140,140,4000,1680,0,0,0,0,1680,1680,0,0,0,0,0,0,2276,140,156,300,120,309
2020,218600351,16420,4420,3420,3420,1000,12000,12000,0,12000,0,0,0,0,0,6650,1650,1600,0,1460,630,10,30,70,73
2020,218700121,267850,27000,12000,12000,15000,240850,240000,0,240000,0,850,850,0,0,75000,0,0,0,3050,310,240,120,50,871
2020,218700131,203220,2220,2220,2220,0,201000,200000,200000,0,0,1000,1000,0,0,0,0,0,0,2660,480,180,120,240,667
2020,218700171,8116,7616,616,616,7000,500,0,0,0,0,500,500,0,0,10320,10320,5900,2300,3250,200,200,150,300,121
2020,218700191,16518,7918,918,918,7000,8600,6000,0,6000,0,2600,2500,100,0,3300,300,0,0,1952,60,20,192,60,50
2020,218700311,14790,11590,590,590,11000,3200,0,0,0,0,3200,3200,0,0,13400,13400,9600,0,4030,960,100,300,400,106
2020,218700321,34797,8047,8047,8047,0,26750,24000,24000,0,0,2750,2750,0,0,2560,2560,2560,0,2490,353,100,384,264,264
2020,218700331,60262,26408,14408,14408,12000,33854,30500,0,30500,0,3354,1450,1904,0,0,0,0,0,6040,560,400,600,420,739
2020,218700341,1150,400,400,400,0,750,0,0,0,0,750,750,0,0,0,0,0,0,1300,215,100,150,60,36
2020,218700351,31320,320,320,320,0,31000,29000,29000,0,0,2000,2000,0,0,28880,28880,22960,3948,2677,156,50,288,180,337
2020,218700361,1730,1730,1730,1730,0,0,0,0,0,0,0,0,0,0,50,50,0,0,1770,85,0,20,270,52
2020,218800131,40970,36420,1420,1420,35000,4550,0,0,0,0,4550,4500,50,0,12200,12200,10700,1500,3364,420,10,550,144,190
2020,218800171,17310,17310,3310,3310,14000,0,0,0,0,0,0,0,0,0,0,0,0,0,1107,165,100,180,72,101
2020,218800311,111300,7500,7500,7500,0,103800,100000,40000,60000,0,3800,800,3000,0,11050,8050,8000,0,1384,200,10,120,84,1110
2020,218800321,42100,600,600,600,0,41500,40000,40000,0,0,1500,900,600,0,0,0,0,0,1522,250,30,220,42,41
2020,218900101,31470,31170,1170,1170,30000,300,0,0,0,0,300,300,0,0,0,0,0,0,2910,350,80,140,180,492
2020,218900131,360,360,220,220,140,0,0,0,0,0,0,0,0,0,50,50,50,0,567,120,45,0,18,1
2020,218900141,460,400,200,200,200,60,0,0,0,0,60,60,0,0,818,818,0,0,1630,168,240,120,132,1
2020,218900171,17280,15280,1780,1780,13500,2000,0,0,0,0,2000,2000,0,0,3180,3180,3180,0,2940,300,120,180,108,43
2020,218900181,4070,4070,70,70,4000,0,0,0,0,0,0,0,0,0,2800,2800,2800,0,1410,500,150,20,40,1
2020,218900301,183590,12950,12950,12950,0,170640,170000,130000,40000,0,640,600,40,0,43000,43000,43000,0,4580,250,100,650,300,235
2020,218900311,200,200,200,200,0,0,0,0,0,0,0,0,0,0,0,0,0,0,663,120,60,20,30,5
2020,219000102,171900,68400,68400,68400,0,103500,90000,90000,0,0,13500,500,13000,0,0,0,0,0,3387,397,90,735,300,1054
2020,219000112,10215,10215,215,215,10000,0,0,0,0,0,0,0,0,0,0,0,0,0,2151,300,250,25,156,5
2020,219000122,15000,15000,0,0,15000,0,0,0,0,0,0,0,0,0,0,0,0,0,540,100,100,0,20,7
2020,219000132,34150,30650,650,650,30000,3500,0,0,0,0,3500,3500,0,0,0,0,0,0,3600,240,200,720,130,168
2020,219000152,38900,600,600,600,0,38300,38000,38000,0,0,300,300,0,0,15000,15000,15000,0,3120,240,216,240,126,62
2020,219000182,9130,8130,630,630,7500,1000,0,0,0,0,1000,1000,0,0,6600,6600,5600,1000,3144,180,0,60,144,46
2020,219000192,86000,8000,8000,8000,0,78000,78000,25000,53000,0,0,0,0,0,1750,1750,0,1700,1454,84,90,84,48,31
2020,219600121,145112,33612,3612,3612,30000,111500,110000,0,110000,0,1500,1500,0,0,10,10,0,0,4516,1210,10,430,146,311
2020,219600151,381929,72529,72529,72529,0,309400,289000,160000,129000,0,20400,8400,12000,0,1509,0,0,0,2435,323,36,120,76,2748
2020,219600191,340907,221507,221507,221507,0,119400,100000,100000,0,0,19400,2400,17000,0,288,288,0,0,9262,591,386,925,404,1992
2020,219700131,95610,2910,2910,2910,0,92700,90000,90000,0,0,2700,2000,700,0,22390,22390,22390,0,2854,300,250,300,144,432
2020,219700141,53960,1460,1460,1460,0,52500,50000,50000,0,0,2500,2500,0,0,22500,22500,21500,1000,6700,600,600,500,200,757
2020,219700181,65200,25000,1000,1000,24000,40200,40000,0,40000,0,200,200,0,0,30600,600,0,600,1520,120,100,240,120,115
2020,219700191,9100,9100,3100,100,6000,0,0,0,0,0,0,0,0,0,0,0,0,0,450,60,20,20,80,0
2020,219800111,68000,7500,7500,7500,0,60500,54000,54000,0,0,6500,1500,5000,0,18000,18000,10000,8000,1640,240,100,200,300,254
2020,219800121,75340,13340,13340,13340,0,62000,60000,60000,0,0,2000,1900,100,0,0,0,0,0,4050,250,20,360,200,406
2020,219800141,34058,2058,2058,2058,0,32000,28000,28000,0,0,4000,4000,0,0,31040,31040,21500,5960,3220,220,250,150,300,74
2020,219800151,44520,2820,2820,1820,0,41700,40000,40000,0,0,1700,700,0,1000,0,0,0,0,2579,444,120,120,168,74
2020,219800161,8180,6580,4580,4580,2000,1600,0,0,0,0,1600,1600,0,0,700,700,0,700,3330,720,100,320,360,181
2020,219800181,3010,3010,10,10,3000,0,0,0,0,0,0,0,0,0,3000,3000,0,0,3204,1200,60,360,180,1
2020,219800191,100,100,100,100,0,0,0,0,0,0,0,0,0,0,0,0,0,0,563,60,100,180,96,9
2020,219900101,30200,200,200,200,0,30000,30000,30000,0,0,0,0,0,0,500,500,500,0,990,180,200,60,20,17
2020,219900121,256118,105118,42118,42118,63000,151000,150000,0,150000,0,1000,1000,0,0,55000,0,0,0,8216,350,1676,800,150,2801
2020,219900131,26590,26590,1590,1590,25000,0,0,0,0,0,0,0,0,0,7000,7000,7000,0,3060,120,30,120,180,61
2020,219900161,7466,2966,1966,1966,1000,4500,0,0,0,0,4500,4500,0,0,7014,7014,0,164,1945,690,10,200,360,399
2020,219900171,8685,8185,1185,1185,7000,500,0,0,0,0,500,500,0,0,3500,3500,2000,0,1518,132,36,180,144,47
2020,219900181,77735,74735,23735,3735,51000,3000,0,0,0,0,3000,3000,0,0,106000,106000,30000,76000,4800,600,200,300,150,254
2020,220000202,21150,3150,3150,3150,0,18000,18000,18000,0,0,0,0,0,0,0,0,0,0,600,80,60,10,17,23
2020,220000212,2644,2494,2494,2494,0,150,0,0,0,0,150,150,0,0,0,0,0,0,1440,180,30,240,180,27
2020,220000242,10966,8866,8866,8866,0,2100,0,0,0,0,2100,2100,0,0,70,70,0,0,3780,250,650,200,240,610
2020,220000252,30589,29650,9650,9650,20000,939,0,0,0,0,939,600,339,0,0,0,0,0,2790,240,400,360,240,31
2020,220000292,51008,18858,18858,18858,0,32150,29000,29000,0,0,3150,2750,400,0,0,0,0,0,3111,420,20,150,120,97
2020,220000302,2750,2750,250,250,2500,0,0,0,0,0,0,0,0,0,0,0,0,0,1382,408,360,60,84,2
2020,220000312,5020,2820,320,320,2500,2200,0,0,0,0,2200,2200,0,0,2000,2000,0,2000,3012,480,12,360,360,192
2020,220000332,6500,6500,6500,6500,0,0,0,0,0,0,0,0,0,0,0,0,0,0,1136,240,120,20,36,15
2020,220000342,35095,10082,10082,10082,0,25013,24000,18000,6000,0,1013,900,113,0,11000,10500,10000,500,3566,240,560,360,420,386
2020,220000352,36800,10000,10000,10000,0,26800,25000,25000,0,0,1800,1800,0,0,0,0,0,0,1460,240,100,240,80,30
2020,220000362,2700,2700,700,700,2000,0,0,0,0,0,0,0,0,0,0,0,0,0,1130,200,100,100,240,1
2020,220000372,1850,1620,620,620,1000,230,0,0,0,0,230,230,0,0,1400,1400,0,1400,3255,420,80,204,420,15
2020,220600211,17400,200,200,200,0,17200,17000,17000,0,0,200,0,200,0,4150,4150,4100,0,1343,260,50,70,42,35
2020,220600221,21520,6300,6300,6300,0,15220,15000,15000,0,0,220,120,100,0,2566,2566,2536,0,2990,200,100,160,300,18
2020,220600231,11050,50,50,50,0,11000,11000,11000,0,0,0,0,0,0,4000,0,0,0,660,100,100,10,20,11
2020,220600241,5592,5550,5550,5550,0,42,0,0,0,0,42,0,42,0,0,0,0,0,630,100,100,10,20,7
2020,220600251,3200,3200,200,200,3000,0,0,0,0,0,0,0,0,0,1500,1500,0,1500,1755,100,50,55,250,1
2020,220600261,34020,3820,3820,3820,0,30200,28000,28000,0,0,2200,2100,100,0,400,400,0,0,2720,360,50,100,100,87
2020,220600271,55,55,55,55,0,0,0,0,0,0,0,0,0,0,0,0,0,0,325,55,75,20,18,1
2020,220600291,1844,1044,744,744,300,800,0,0,0,0,800,800,0,0,0,0,0,0,2500,600,200,210,132,6
2020,220600301,17414,1814,1814,1814,0,15600,15000,15000,0,0,600,600,0,0,7449,7449,6649,0,1390,240,120,240,180,192
2020,220600321,166050,45200,45200,40200,0,120850,120000,25000,95000,0,850,850,0,0,0,0,0,0,3192,276,60,144,108,207
2020,220600331,30,30,30,30,0,0,0,0,0,0,0,0,0,0,0,0,0,0,385,72,0,20,18,1
2020,220600341,39716,8340,8340,8340,0,31376,30000,30000,0,0,1376,1150,226,0,150,50,0,0,2311,300,30,420,144,134
2020,220600351,29282,7702,7702,7702,0,21580,21500,18500,3000,0,80,80,0,0,14396,14396,13046,800,2392,180,250,160,132,55
2020,220600361,37158,7288,7288,7288,0,29870,29000,19000,10000,0,870,690,180,0,11800,11800,10800,1000,6150,1540,100,300,180,912
2020,220600381,46050,1000,1000,1000,0,45050,29400,10000,19400,0,15650,3500,12150,0,17000,16000,16000,0,2476,150,300,700,220,194
2020,220700211,45559,7359,7359,7359,0,38200,31000,31000,0,0,7200,0,7200,0,0,0,0,0,2970,300,30,100,60,51
2020,220700241,15,15,15,15,0,0,0,0,0,0,0,0,0,0,0,0,0,0,1916,248,30,80,156,0
2020,220700251,1500,1100,100,100,1000,400,0,0,0,0,400,400,0,0,1620,1620,0,900,1190,360,10,200,120,135
2020,220700261,7564,6884,6384,6384,500,680,0,0,0,0,680,500,180,0,0,0,0,0,2715,840,50,500,240,41
2020,220700281,140120,6820,6820,6820,0,133300,123000,23000,100000,0,10300,0,5300,5000,7000,7000,7000,0,4270,300,250,700,240,2317
2020,220700291,33929,18789,18789,18789,0,15140,15000,15000,0,0,140,140,0,0,156,156,0,0,1560,150,50,300,100,88
2020,220700311,28560,5600,5600,5600,0,22960,22900,8500,14400,0,60,0,60,0,0,0,0,0,893,316,96,36,36,42
2020,220700321,29562,4862,4862,4862,0,24700,24000,24000,0,0,700,700,0,0,0,0,0,0,1100,192,30,240,90,60
2020,220700371,34290,5590,5590,5290,0,28700,21500,21500,0,0,7200,4200,0,3000,18050,18050,14250,2000,3935,215,20,380,600,331
2020,220700381,22830,3180,3180,3180,0,19650,17000,17000,0,0,2650,2650,0,0,0,0,0,0,2334,264,40,120,180,304
2020,220700391,15426,3000,3000,3000,0,12426,10000,10000,0,0,2426,2200,226,0,0,0,0,0,2538,220,180,420,144,119
2020,220800211,2595,2595,1595,1595,1000,0,0,0,0,0,0,0,0,0,0,0,0,0,1970,600,260,60,40,0
2020,220800221,15540,340,340,340,0,15200,15000,15000,0,0,200,100,100,0,150,0,0,0,1270,130,140,230,100,16
2020,220800231,9944,2944,2944,2944,0,7000,7000,7000,0,0,0,0,0,0,758,758,678,0,2860,300,400,200,420,181
2020,220800251,19920,4085,4085,4085,0,15835,15000,10000,5000,0,835,700,135,0,0,0,0,0,1122,160,80,360,72,48
2020,220800261,1600,1600,100,100,1500,0,0,0,0,0,0,0,0,0,0,0,0,0,675,150,130,60,15,4
2020,220800281,5605,1205,1205,1205,0,4400,3700,0,2000,1700,700,700,0,0,15000,15000,0,0,1890,200,10,200,180,24
2020,220800291,29150,9150,9150,8650,0,20000,18800,16800,2000,0,1200,0,1200,0,5300,5300,4800,500,1268,320,30,140,72,24
2020,220800311,4320,20,20,20,0,4300,4300,4300,0,0,0,0,0,0,0,0,0,0,377,60,12,6,6,5
2020,220800331,19720,2920,2920,2920,0,16800,14000,14000,0,0,2800,2700,100,0,11149,11149,8969,0,3501,216,30,600,324,97
2020,220800341,17600,600,600,600,0,17000,15000,7500,7500,0,2000,2000,0,0,2400,2400,2400,0,1393,228,60,92,173,77
2020,220800351,125975,10095,10095,8695,0,115880,110000,110000,0,0,5880,5480,400,0,53040,9040,9000,0,4552,908,1104,360,360,141
2020,220800361,22508,3008,3008,3008,0,19500,19500,18000,1500,0,0,0,0,0,100,0,0,0,1652,300,120,108,240,35
2020,220800391,151100,91900,91900,91900,0,59200,54000,24000,30000,0,5200,5200,0,0,0,0,0,0,5778,424,300,600,240,2764
2020,220900201,47400,2000,2000,2000,0,45400,45000,45000,0,0,400,400,0,0,30200,30200,30000,200,2430,360,100,240,240,112
2020,220900211,27923,3828,3828,3828,0,24095,19000,19000,0,0,5095,2000,95,3000,12800,8800,5000,800,1192,72,5,150,50,23
2020,220900221,19810,4760,4760,4760,0,15050,15000,15000,0,0,50,50,0,0,140,0,0,0,4760,300,600,600,360,315
2020,220900231,310,310,10,10,300,0,0,0,0,0,0,0,0,0,0,0,0,0,420,120,15,10,20,0
2020,220900241,32000,7000,7000,7000,0,25000,25000,25000,0,0,0,0,0,0,4700,4700,3700,700,1920,300,30,15,84,48
2020,220900281,60712,6512,6512,6212,0,54200,51000,16000,35000,0,3200,1600,1600,0,23773,3773,3700,0,1850,360,10,300,240,197
2020,220900311,33124,5124,5124,5124,0,28000,27500,25000,0,2500,500,500,0,0,4500,0,0,0,2553,420,120,300,102,97
2020,220900321,12500,1300,1300,1300,0,11200,10500,10500,0,0,700,700,0,0,0,0,0,0,2012,192,40,350,120,63
2020,220900331,49850,16250,16250,16250,0,33600,32000,32000,0,0,1600,1600,0,0,1500,1500,1500,0,4150,400,150,200,400,1316
2020,220900351,31227,3727,3727,3527,0,27500,21000,21000,0,0,6500,6500,0,0,4510,4510,1920,2000,2481,273,60,180,300,302
2020,220900361,9990,490,490,490,0,9500,7000,7000,0,0,2500,2500,0,0,1483,1483,0,0,2864,193,1035,237,102,61
2020,220900371,7130,6330,3330,3330,3000,800,0,0,0,0,800,800,0,0,6500,6500,6500,0,2439,144,200,360,360,32
2020,220900381,43468,20090,20090,20090,0,23378,19000,19000,0,0,4378,3700,678,0,4500,4500,3000,500,5695,840,5,600,360,1126
2020,221000202,42154,7268,7268,7268,0,34886,31700,25700,6000,0,3186,2800,386,0,15600,15100,15100,0,2309,280,189,300,120,148
2020,221000212,920,920,720,720,200,0,0,0,0,0,0,0,0,0,20,20,0,0,1294,500,30,30,84,4
2020,221000232,33926,11286,11286,11286,0,22640,19000,11000,8000,0,3640,3200,440,0,0,0,0,0,2850,125,55,420,240,82
2020,221000252,60000,16200,6200,4200,10000,43800,43000,0,43000,0,800,800,0,0,28000,27000,27000,0,5870,150,100,500,300,333
2020,221000262,53800,5600,5600,2600,0,48200,47000,47000,0,0,1200,1000,200,0,3000,0,0,0,881,120,20,276,15,101
2020,221000292,59200,3000,3000,3000,0,56200,55000,40000,15000,0,1200,1200,0,0,9000,0,0,0,2530,200,10,370,300,226
2020,221000312,23125,2425,2425,2425,0,20700,17000,17000,0,0,3700,3700,0,0,7720,7720,7720,0,2860,320,10,500,120,77
2020,221000322,56700,16300,16300,16300,0,40400,40000,40000,0,0,400,300,100,0,0,0,0,0,1613,222,70,410,120,82
2020,221000332,15307,2779,1079,1079,1700,12528,10000,0,10000,0,2528,2460,68,0,2785,2785,0,0,2792,300,60,360,132,54
2020,221000342,13162,12162,9162,9162,3000,1000,0,0,0,0,1000,1000,0,0,3000,3000,3000,0,1714,278,30,300,156,493
2020,221000352,43223,21723,21723,21723,0,21500,18500,18500,0,0,3000,3000,0,0,0,0,0,0,1770,180,200,320,120,317
2020,221000372,7900,1800,1800,1800,0,6100,5200,4000,1200,0,900,900,0,0,2900,2900,0,2900,2458,163,50,260,240,194
2020,221000382,10932,706,706,706,0,10226,10000,10000,0,0,226,0,226,0,0,0,0,0,1396,180,120,24,72,11
2020,221000392,19600,4000,4000,4000,0,15600,15000,15000,0,0,600,600,0,0,20,20,0,0,2696,200,180,360,276,33
2020,221600201,1145,945,445,445,500,200,0,0,0,0,200,200,0,0,530,530,0,530,1030,540,70,80,40,17
2020,221600211,77854,52254,52254,52254,0,25600,21000,0,21000,0,4600,4100,500,0,0,0,0,0,3205,280,390,200,235,739
2020,221600221,98220,33020,33020,33020,0,65200,60000,60000,0,0,5200,5200,0,0,0,0,0,0,706,50,20,70,15,1057
2020,221600251,20720,3720,3720,2720,0,17000,15000,15000,0,0,2000,1800,100,100,4000,4000,4000,0,2710,250,60,200,150,79
2020,221600261,23636,7286,7286,7286,0,16350,15000,15000,0,0,1350,1350,0,0,6350,6350,6200,150,2860,250,100,60,210,69
2020,221600311,260,260,30,30,230,0,0,0,0,0,0,0,0,0,0,0,0,0,715,150,5,20,120,0
2020,221600321,29696,10912,10912,10912,0,18784,17500,11000,6500,0,1284,600,684,0,14168,8168,8168,0,1788,336,120,480,72,82
2020,221600341,11130,1700,1700,1700,0,9430,9000,9000,0,0,430,180,250,0,0,0,0,0,2280,220,900,240,60,68
2020,221600351,12864,11764,9764,9764,2000,1100,0,0,0,0,1100,1100,0,0,0,0,0,0,1954,150,10,210,180,50
2020,221600361,19061,7241,7241,7241,0,11820,8500,7200,1300,0,3320,2800,520,0,3185,3185,1000,0,2377,256,15,360,156,38
2020,221600381,19736,7976,7976,7976,0,11760,11000,11000,0,0,760,280,480,0,0,0,0,0,2802,252,120,82,108,38
2020,221600391,5200,200,200,200,0,5000,5000,5000,0,0,0,0,0,0,0,0,0,0,777,127,30,20,20,17
2020,221700211,11600,7600,2600,100,5000,4000,3000,0,0,3000,1000,1000,0,0,1800,1800,0,1600,791,220,13,144,73,24
2020,221700221,24152,2552,2552,2552,0,21600,20000,20000,0,0,1600,1600,0,0,0,0,0,0,2527,100,700,50,450,137
2020,221700241,25310,250,250,250,0,25060,25000,25000,0,0,60,0,60,0,9200,0,0,0,1302,222,240,18,20,27
2020,221700251,179968,8118,8118,8118,0,171850,170000,80000,90000,0,1850,1600,250,0,60000,10000,0,0,5360,480,200,240,240,834
2020,221700261,17935,6735,6735,6735,0,11200,10000,0,10000,0,1200,700,500,0,2400,2400,1000,1100,2790,120,100,200,300,61
2020,221700301,73083,3083,3083,3083,0,70000,70000,60000,10000,0,0,0,0,0,14400,12000,12000,0,929,180,40,12,192,97
2020,221700311,5600,4100,1600,1600,2500,1500,0,0,0,0,1500,1500,0,0,0,0,0,0,900,150,100,50,50,36
2020,221700331,32828,4190,4190,4190,0,28638,28000,3000,25000,0,638,0,638,0,0,0,0,0,1270,160,80,120,50,296
2020,221700351,500,500,500,500,0,0,0,0,0,0,0,0,0,0,0,0,0,0,601,120,40,12,24,1
2020,221700361,2200,500,500,500,0,1700,1700,1700,0,0,0,0,0,0,0,0,0,0,725,100,240,10,15,3
2020,221700371,27914,1914,1914,1914,0,26000,26000,16000,10000,0,0,0,0,0,5610,5610,3000,2500,1855,300,130,70,180,428
2020,221700391,300,300,300,300,0,0,0,0,0,0,0,0,0,0,0,0,0,0,1135,330,160,60,15,1
2020,221800201,21430,330,330,330,0,21100,19500,19500,0,0,1600,1600,0,0,1384,1384,0,0,1479,210,240,10,60,36
2020,221800211,42539,12489,12489,12489,0,30050,30000,30000,0,0,50,30,20,0,355,55,0,0,2230,600,40,270,250,115
2020,221800231,85700,500,500,500,0,85200,85000,35000,50000,0,200,0,200,0,35500,24000,24000,0,1727,300,200,45,90,390
2020,221800241,25880,2880,2880,2880,0,23000,23000,23000,0,0,0,0,0,0,30,30,0,0,1110,210,300,20,20,36
2020,221800271,35700,600,600,600,0,35100,35000,25000,10000,0,100,0,100,0,0,0,0,0,1500,130,450,100,70,31
2020,221800281,757,257,57,57,200,500,0,0,0,0,500,480,20,0,100,100,0,0,2274,1260,10,84,240,6
2020,221800291,11150,1850,1850,1850,0,9300,9000,9000,0,0,300,0,300,0,4000,4000,4000,0,3790,180,1000,200,190,21
2020,221800311,12334,1766,1766,1766,0,10568,10000,10000,0,0,568,500,68,0,0,0,0,0,1310,150,80,300,50,814
2020,221800321,53142,4716,4716,4716,0,48426,47000,20000,27000,0,1426,1200,226,0,14851,14351,14351,0,2220,380,500,100,120,119
2020,221800351,82714,11788,11788,6788,0,70926,68500,9000,59500,0,2426,2200,226,0,0,0,0,0,2258,350,120,346,132,133
2020,221800361,5185,185,185,185,0,5000,5000,5000,0,0,0,0,0,0,3600,3600,1600,0,1324,230,240,84,67,10
2020,221800371,19460,7820,7820,7820,0,11640,11500,5500,6000,0,140,0,140,0,0,0,0,0,1011,170,64,36,84,15
2020,221800381,400,400,400,400,0,0,0,0,0,0,0,0,0,0,0,0,0,0,872,132,120,30,30,1
2020,221800391,4312,3612,1612,1612,2000,700,0,0,0,0,700,400,300,0,8260,8260,0,8260,1657,280,27,320,240,696
2020,221900201,42610,2540,2540,2540,0,40070,40000,40000,0,0,70,0,70,0,0,0,0,0,1754,250,80,150,74,43
2020,221900211,19510,10450,10450,10450,0,9060,9000,8500,500,0,60,0,60,0,0,0,0,0,690,95,70,40,36,107
2020,221900221,233880,85880,85880,85880,0,148000,124000,90000,34000,0,24000,14000,10000,0,5000,5000,0,0,14860,1000,500,2000,360,5150
2020,221900231,69500,21200,21200,20200,0,48300,46000,45000,1000,0,2300,500,1800,0,800,0,0,0,3512,240,230,380,190,117
2020,221900261,17710,410,410,410,0,17300,17300,17300,0,0,0,0,0,0,0,0,0,0,1496,80,304,36,36,22
2020,221900271,58000,6200,6200,6200,0,51800,49000,45000,4000,0,2800,2800,0,0,200,200,0,200,3927,1050,180,210,81,23
2020,221900301,10922,4922,4922,4922,0,6000,6000,6000,0,0,0,0,0,0,0,0,0,0,2104,570,60,240,204,8
2020,221900321,870,870,570,570,300,0,0,0,0,0,0,0,0,0,2868,2868,190,2600,1598,456,2,12,48,154
2020,221900341,32434,6334,6334,6334,0,26100,26000,6000,20000,0,100,100,0,0,12500,12000,12000,0,2006,132,400,120,84,45
2020,221900371,1470,1470,1470,1470,0,0,0,0,0,0,0,0,0,0,0,0,0,0,926,160,10,20,43,1
2020,221900381,27608,14040,14040,14040,0,13568,4000,4000,0,0,9568,1500,68,8000,0,0,0,0,2590,300,30,600,60,90
2020,221900391,12400,4350,4350,4350,0,8050,7500,4500,3000,0,550,550,0,0,0,0,0,0,1372,132,36,300,54,35
2020,222000202,43900,24900,24900,23900,0,19000,17000,17000,0,0,2000,2000,0,0,0,0,0,0,4020,300,300,250,200,223
2020,222000212,400,400,300,300,100,0,0,0,0,0,0,0,0,0,1970,1970,0,720,2080,360,40,60,50,1
2020,222000232,43355,3970,3970,3970,0,39385,37500,37500,0,0,1885,1885,0,0,94,94,0,0,4460,300,200,600,200,240
2020,222000242,44066,13130,13130,13130,0,30936,30800,30800,0,0,136,0,136,0,0,0,0,0,1026,240,125,12,24,32
2020,222000252,34842,7242,7242,7242,0,27600,27000,27000,0,0,600,600,0,0,0,0,0,0,2171,300,50,240,36,121
2020,222000272,11330,11330,10930,10930,400,0,0,0,0,0,0,0,0,0,30,30,0,0,1634,204,50,96,104,3
2020,222000282,10690,9590,7090,7090,2500,1100,0,0,0,0,1100,1100,0,0,71,71,0,0,3000,249,88,350,230,330
2020,222000302,71652,15652,15652,13152,0,56000,23000,23000,0,0,33000,18000,5000,10000,2850,350,0,0,3420,360,120,360,240,6533
2020,222000312,4100,100,100,100,0,4000,4000,4000,0,0,0,0,0,0,0,0,0,0,542,130,40,40,42,6
2020,222000322,27020,20,20,20,0,27000,27000,7000,20000,0,0,0,0,0,0,0,0,0,1207,145,160,42,70,7
2020,222000332,37612,2262,2262,2262,0,35350,35000,5000,30000,0,350,300,50,0,37,37,0,0,1809,550,200,230,198,21
2020,222000342,1035,35,35,35,0,1000,1000,1000,0,0,0,0,0,0,0,0,0,0,416,180,60,20,20,1
2020,222000352,18260,4140,4140,4140,0,14120,13000,13000,0,0,1120,1120,0,0,4700,4700,0,4700,2231,88,200,144,56,1164
2020,222600211,233170,20670,20670,20670,0,212500,210000,90000,120000,0,2500,2500,0,0,57460,9460,9460,0,4080,480,240,720,240,380
2020,222600221,30,30,30,30,0,0,0,0,0,0,0,0,0,0,0,0,0,0,565,150,70,30,15,0
2020,222600231,13380,2180,2180,2180,0,11200,10600,10600,0,0,600,500,100,0,500,0,0,0,2460,200,30,250,360,113
2020,222600241,164038,9888,9888,8888,0,154150,148500,72000,76500,0,5650,2650,3000,0,29700,16100,14500,0,5200,700,100,500,450,1048
2020,222600261,51925,3425,3425,2925,0,48500,47000,32000,15000,0,1500,1500,0,0,7200,4200,4200,0,2217,180,500,350,200,45
2020,222600281,35996,4016,4016,4016,0,31980,31000,31000,0,0,980,700,280,0,17330,17330,17310,0,5520,360,50,600,360,479
2020,222600291,110238,24928,24928,24928,0,85310,78500,55000,23500,0,6810,800,6010,0,9200,9200,9200,0,4650,300,50,600,300,133
2020,222600301,730,730,230,230,500,0,0,0,0,0,0,0,0,0,1500,1500,0,0,2410,620,300,160,80,22
2020,222600311,11158,8908,8908,8908,0,2250,1500,1500,0,0,750,550,200,0,0,0,0,0,1630,150,180,280,120,4
2020,222600321,9605,2605,2605,2605,0,7000,7000,7000,0,0,0,0,0,0,0,0,0,0,576,124,100,30,20,8
2020,222600331,11625,3935,3935,3935,0,7690,7500,7500,0,0,190,150,40,0,0,0,0,0,815,120,20,72,48,30
2020,222600341,33840,1140,1140,1140,0,32700,30000,30000,0,0,2700,2400,300,0,3000,3000,3000,0,1970,200,100,150,100,89
2020,222600351,1040,40,40,40,0,1000,1000,1000,0,0,0,0,0,0,0,0,0,0,262,60,36,30,36,6
2020,222600361,10100,100,100,100,0,10000,10000,1000,9000,0,0,0,0,0,2000,2000,0,2000,316,60,60,10,36,8
2020,222700201,45016,9516,9516,9516,0,35500,35300,15000,20300,0,200,0,200,0,5700,0,0,0,1944,330,170,24,120,46
2020,222700221,22280,4050,4050,4050,0,18230,17000,17000,0,0,1230,1230,0,0,0,0,0,0,2590,170,150,350,230,90
2020,222700241,205350,4250,4250,2750,0,201100,190000,150000,40000,0,11100,3600,7500,0,75780,75780,66760,7000,4580,560,40,1200,240,526
2020,222700251,44576,6776,6776,6776,0,37800,37800,30000,0,7800,0,0,0,0,70,70,0,0,1320,300,70,20,72,26
2020,222700261,21235,5085,5085,5085,0,16150,16000,16000,0,0,150,0,150,0,800,800,0,300,1900,500,150,100,150,18
2020,222700281,92404,5304,5304,5304,0,87100,87000,75000,12000,0,100,0,100,0,0,0,0,0,2330,700,10,80,100,103
2020,222700311,40435,37660,21660,21660,16000,2775,0,0,0,0,2775,2600,175,0,0,0,0,0,2432,360,50,150,180,98
2020,222700331,469,469,169,69,300,0,0,0,0,0,0,0,0,0,130,130,0,130,1515,828,52,23,38,0
2020,222700341,8400,2900,2900,900,0,5500,5500,5500,0,0,0,0,0,0,0,0,0,0,1006,180,20,9,48,4
2020,222700351,12084,882,882,882,0,11202,6000,1000,5000,0,5202,550,4652,0,0,0,0,0,1356,330,550,60,18,23
2020,222700371,2098,2098,1098,1098,1000,0,0,0,0,0,0,0,0,0,30,30,0,0,3980,540,100,360,120,127
2020,222800201,85410,6410,6410,6410,0,79000,77000,62000,15000,0,2000,1800,200,0,11800,11800,11800,0,3860,370,35,320,225,836
2020,222800241,800,800,300,300,500,0,0,0,0,0,0,0,0,0,0,0,0,0,1328,700,20,0,98,1
2020,222800281,240,240,10,10,230,0,0,0,0,0,0,0,0,0,0,0,0,0,856,165,18,45,18,2
2020,222800301,1120,1120,900,900,220,0,0,0,0,0,0,0,0,0,0,0,0,0,974,300,20,30,24,1
2020,222800311,19919,7160,7160,7160,0,12759,11500,1500,10000,0,1259,900,359,0,0,0,0,0,1826,114,600,180,159,29
2020,222800321,23517,5000,5000,5000,0,18517,18000,0,18000,0,517,430,87,0,0,0,0,0,1370,200,180,84,48,56
2020,222800351,40020,10820,10820,10820,0,29200,28000,15000,13000,0,1200,1000,200,0,300,0,0,0,3908,216,500,300,282,191
2020,222800361,43090,13030,13030,13030,0,30060,26000,0,26000,0,4060,4060,0,0,21000,21000,21000,0,4396,252,30,400,218,37
2020,222900201,47139,9758,9758,7758,0,37381,37000,37000,0,0,381,250,131,0,1000,0,0,0,2885,420,100,540,175,99
2020,222900231,540,540,340,340,200,0,0,0,0,0,0,0,0,0,700,700,0,700,1930,460,10,240,120,15
2020,222900241,34470,2170,2170,2170,0,32300,32000,20000,12000,0,300,300,0,0,9000,0,0,0,2730,400,200,150,120,79
2020,222900251,29162,4322,4322,4322,0,24840,22340,20000,2340,0,2500,2500,0,0,17200,17200,7700,8500,3390,230,300,120,340,635
2020,222900261,138924,691,691,691,0,138233,94800,29800,65000,0,43433,3866,39567,0,53000,53000,53000,0,2279,181,21,295,193,394
2020,222900271,25104,23904,7904,7604,16000,1200,0,0,0,0,1200,700,500,0,0,0,0,0,2584,240,60,200,84,222
2020,222900281,28328,7908,7908,7908,0,20420,18000,15000,3000,0,2420,1700,720,0,4150,4150,4150,0,3080,400,350,600,130,87
2020,222900301,109690,1690,1690,1690,0,108000,107000,5000,102000,0,1000,500,500,0,0,0,0,0,960,180,100,120,60,36
2020,222900311,42700,2270,2270,2270,0,40430,40000,15000,25000,0,430,200,230,0,18100,8100,8000,100,2534,240,500,180,180,62
2020,222900321,24417,8917,8917,8917,0,15500,14800,5800,9000,0,700,700,0,0,18300,18300,16300,2000,4160,600,300,1360,300,481
2020,222900331,39898,10298,10298,10298,0,29600,26600,18600,8000,0,3000,3000,0,0,16824,16824,7820,8433,2640,240,200,200,240,711
2020,222900341,15820,220,220,220,0,15600,15000,10000,5000,0,600,300,300,0,0,0,0,0,928,189,72,58,106,20
2020,222900351,77500,6900,6900,6900,0,70600,68000,5000,63000,0,2600,1400,1200,0,0,0,0,0,3481,591,300,520,108,44
2020,223000212,37670,13670,11670,11670,2000,24000,24000,0,15000,9000,0,0,0,0,5150,5150,0,5000,4286,1266,300,100,220,165
2020,223000222,1290,1210,1210,1210,0,80,0,0,0,0,80,0,80,0,4550,4550,0,4300,1386,0,12,72,84,1
2020,223000252,14530,1830,1830,1830,0,12700,12000,12000,0,0,700,700,0,0,8050,8050,6000,2000,3036,209,80,120,48,33
2020,223600211,55300,3300,3300,3300,0,52000,52000,27000,25000,0,0,0,0,0,500,0,0,0,3090,360,410,240,60,83
2020,223600231,120496,53696,53696,53696,0,66800,65000,35000,30000,0,1800,600,1200,0,60,60,0,0,3950,200,1000,200,150,284
2020,223600241,53744,1564,1564,1564,0,52180,51500,31500,20000,0,680,380,300,0,10500,10500,10500,0,3390,300,60,400,180,186
2020,223600261,10182,9378,7578,7578,1800,804,0,0,0,0,804,0,804,0,0,0,0,0,2061,245,1000,60,48,12
2020,223700201,17636,6530,6530,6530,0,11106,11000,11000,0,0,106,0,106,0,3000,3000,3000,0,2110,250,120,200,240,40
2020,223700211,35580,10580,10580,10580,0,25000,25000,25000,0,0,0,0,0,0,4500,500,0,0,3550,520,40,200,240,56
2020,223700221,26280,6280,6280,6280,0,20000,19000,19000,0,0,1000,1000,0,0,991,991,940,0,2620,170,180,250,240,128
2020,223700241,12970,970,970,970,0,12000,12000,12000,0,0,0,0,0,0,0,0,0,0,700,120,200,30,20,13
2020,223700271,25390,10890,10690,10690,200,14500,10000,0,0,10000,4500,3500,1000,0,11000,11000,0,11000,3896,500,216,400,120,1367
2020,223800201,1599,1219,1219,1219,0,380,0,0,0,0,380,380,0,0,0,0,0,0,1830,300,100,300,160,25
2020,223800211,46585,17465,17465,17465,0,29120,28000,28000,0,0,1120,800,320,0,0,0,0,0,3317,240,20,245,180,134
2020,223800221,51342,7962,7962,7962,0,43380,42000,32000,10000,0,1380,1280,100,0,0,0,0,0,5220,320,500,460,200,2008
2020,223800241,35064,2964,2964,1464,0,32100,30000,20000,10000,0,2100,1100,1000,0,9875,9875,9875,0,2402,230,82,250,150,63
2020,223800251,29424,3324,3324,3324,0,26100,26100,22000,4100,0,0,0,0,0,15000,15000,15000,0,780,200,50,15,25,17
2020,223900201,56252,19852,19852,19852,0,36400,35000,25000,10000,0,1400,1400,0,0,130,130,0,0,4250,250,100,600,100,1614
2020,223900211,19760,15960,15960,3960,0,3800,3300,0,0,3300,500,0,500,0,0,0,0,0,1436,180,120,36,60,43
2020,223900231,24320,3160,3160,3160,0,21160,21000,21000,0,0,160,160,0,0,0,0,0,0,2334,360,60,360,204,66
2020,223900241,22960,1310,1310,1310,0,21650,21000,21000,0,0,650,650,0,0,2250,2250,950,800,2385,300,50,200,255,322
2020,223900251,6920,2290,90,90,2200,4630,4500,0,4500,0,130,0,130,0,0,0,0,0,576,140,50,15,30,6
2020,230000202,84060,160,160,160,0,83900,83600,18000,65600,0,300,300,0,0,23000,23000,23000,0,1107,180,110,156,121,82
2020,230000212,202500,7000,7000,7000,0,195500,192000,42000,150000,0,3500,3500,0,0,33000,27000,27000,0,4120,600,240,1200,288,1208
2020,230000232,110857,27462,27462,26162,0,83395,66000,24000,0,42000,17395,14395,0,3000,25000,25000,0,25000,2833,396,676,335,195,372
2020,230000262,20850,3200,3200,3200,0,17650,17500,11500,6000,0,150,150,0,0,10750,10750,8750,2000,2800,240,150,300,360,126
2020,230000272,37530,2330,2330,2330,0,35200,35000,35000,0,0,200,200,0,0,5600,0,0,0,2020,300,350,120,60,76
2020,230000292,61560,15186,15186,15186,0,46374,45000,45000,0,0,1374,1374,0,0,6028,6028,6028,0,9137,480,30,1080,324,4097
2020,230000342,77671,1490,1490,1490,0,76181,75000,15000,60000,0,1181,1000,181,0,0,0,0,0,1807,189,210,120,168,127
2020,230000352,12662,5662,5662,5662,0,7000,7000,7000,0,0,0,0,0,0,2800,2800,2800,0,916,290,10,72,120,38
2020,230000362,8636,8636,2636,2636,6000,0,0,0,0,0,0,0,0,0,3850,3850,3850,0,3290,460,100,400,300,3
2020,230000382,27265,16089,2089,2089,14000,11176,10000,0,10000,0,1176,950,226,0,24000,23000,10000,13000,1734,300,100,100,84,57
2020,230600211,28268,3500,3500,1100,0,24768,18000,18000,0,0,6768,3368,0,3400,10272,10272,10172,0,2380,216,60,240,144,105
2020,230600231,166895,32620,32620,30120,0,134275,65000,65000,0,0,69275,2275,55000,12000,27400,27400,27400,0,6030,420,1200,500,400,1332
2020,230600241,230,230,30,30,200,0,0,0,0,0,0,0,0,0,0,0,0,0,875,80,140,57,36,1
2020,230600251,25360,180,180,180,0,25180,25000,25000,0,0,180,180,0,0,20,20,0,0,891,96,40,60,75,42
2020,230600261,13713,600,600,600,0,13113,13000,13000,0,0,113,0,113,0,0,0,0,0,1146,148,230,20,90,17
2020,230600281,12560,2560,2560,2560,0,10000,8000,8000,0,0,2000,2000,0,0,530,530,530,0,3009,168,700,182,275,135
2020,230600291,35072,40,40,40,0,35032,35000,35000,0,0,32,0,32,0,9310,9310,9240,0,1922,240,180,144,98,102
2020,230600311,50543,20843,20843,20843,0,29700,18500,13000,5500,0,11200,1200,0,10000,3700,3200,1900,1300,2800,180,230,100,168,40
2020,230600321,60,60,60,60,0,0,0,0,0,0,0,0,0,0,0,0,0,0,980,180,50,10,60,23
2020,230600331,23530,7030,7030,7030,0,16500,5000,5000,0,0,11500,10000,0,1500,0,0,0,0,1948,240,20,400,108,209
2020,230600351,118668,86098,86098,82498,0,32570,27000,19000,0,8000,5570,3570,2000,0,0,0,0,0,4301,360,30,540,192,1514
2020,230700211,890,890,390,390,500,0,0,0,0,0,0,0,0,0,0,0,0,0,1744,480,100,60,144,1
2020,230700221,4710,1960,60,60,1900,2750,0,0,0,0,2750,250,2500,0,0,0,0,0,1284,224,72,150,28,4
2020,230700261,47600,2600,2600,2600,0,45000,45000,35000,10000,0,0,0,0,0,0,0,0,0,826,240,100,60,56,51
2020,230700281,56106,9706,9706,9706,0,46400,45300,33300,0,12000,1100,1100,0,0,5800,5800,5800,0,2935,440,200,215,80,121
2020,230700331,7100,900,900,900,0,6200,6000,6000,0,0,200,200,0,0,4500,4500,3000,1500,883,162,36,127,72,36
2020,230700341,8550,350,350,350,0,8200,8000,8000,0,0,200,200,0,0,399,399,0,399,912,158,88,120,30,29
2020,230700351,36800,13150,13150,13150,0,23650,22970,15000,7970,0,680,400,280,0,0,0,0,0,1820,150,400,360,180,74
2020,230700381,29311,11972,11972,11972,0,17339,15000,9000,6000,0,2339,2000,339,0,0,0,0,0,3928,268,320,360,180,99
2020,230800211,41324,4174,3774,3774,400,37150,35000,0,35000,0,2150,2000,150,0,34875,17875,10775,7100,2942,360,5,360,240,231
2020,230800241,34200,4000,4000,4000,0,30200,26500,26500,0,0,3700,3700,0,0,0,0,0,0,1948,197,0,170,96,62
2020,230800251,6380,200,200,200,0,6180,6000,6000,0,0,180,180,0,0,3000,3000,3000,0,1015,199,20,180,36,41
2020,230800271,190000,24000,24000,24000,0,166000,162000,52000,110000,0,4000,4000,0,0,35324,32324,32324,0,6320,660,180,900,200,867
2020,230800281,87684,42344,42344,42344,0,45340,45000,25000,20000,0,340,250,90,0,0,0,0,0,3378,216,180,300,192,73
2020,230800311,18080,80,80,80,0,18000,6500,5500,1000,0,11500,1500,0,10000,0,0,0,0,1011,67,30,360,60,15
2020,230800321,305,305,305,305,0,0,0,0,0,0,0,0,0,0,0,0,0,0,880,190,320,24,36,1
2020,230800331,2803,2803,2303,2303,500,0,0,0,0,0,0,0,0,0,0,0,0,0,1324,600,42,24,56,1
2020,230800371,19200,10200,10200,10200,0,9000,9000,9000,0,0,0,0,0,0,0,0,0,0,1362,240,200,20,72,14
2020,230800381,60382,27382,27382,27382,0,33000,30000,30000,0,0,3000,3000,0,0,1400,1400,1400,0,4312,342,100,500,300,663
2020,230800391,30920,4220,4220,4220,0,26700,24000,24000,0,0,2700,2700,0,0,180,180,0,0,4220,360,100,600,480,142
2020,230900201,110816,8500,8500,8500,0,102316,100000,100000,0,0,2316,1200,1116,0,52000,50000,50000,0,5108,1080,300,100,168,442
2020,230900211,650,650,150,150,500,0,0,0,0,0,0,0,0,0,100,100,0,0,1456,336,10,60,144,16
2020,230900231,748,718,8,8,710,30,0,0,0,0,30,30,0,0,0,0,0,0,637,260,1,60,36,7
2020,230900241,3140,2990,2290,2290,700,150,0,0,0,0,150,150,0,0,200,200,0,0,860,320,50,50,30,31
2020,230900251,35720,4144,4144,4144,0,31576,28000,28000,0,0,3576,3576,0,0,13835,13835,13835,0,2514,264,30,300,200,487
2020,230900261,107648,4060,4060,4060,0,103588,98300,62300,36000,0,5288,4788,500,0,5102,1102,0,0,5552,600,1000,700,270,461
2020,230900271,107781,12672,12672,12672,0,95109,90500,76500,14000,0,4609,4609,0,0,1000,0,0,0,3350,480,120,500,216,1405
2020,230900281,105854,27004,27004,7004,0,78850,73000,33000,30000,10000,5850,3350,500,2000,44200,24200,4200,20000,5130,170,920,920,276,386
2020,230900291,32630,30,30,30,0,32600,32600,32000,600,0,0,0,0,0,0,0,0,0,912,192,134,24,72,42
2020,230900301,64560,17760,17760,17260,0,46800,42000,10000,32000,0,4800,4800,0,0,0,0,0,0,5277,179,320,1020,172,541
2020,230900311,3180,1180,680,180,500,2000,0,0,0,0,2000,0,1000,1000,0,0,0,0,2023,492,15,480,180,1
2020,230900321,12826,1600,1600,1600,0,11226,11000,5000,6000,0,226,0,226,0,0,0,0,0,974,220,24,13,42,11
2020,230900331,6675,175,175,175,0,6500,6000,6000,0,0,500,500,0,0,4250,4250,3580,0,2206,320,85,120,195,85
2020,230900361,34310,8010,8010,8010,0,26300,24500,17000,7500,0,1800,1800,0,0,9300,9000,9000,0,4960,360,120,720,360,67
2020,230900381,52368,5368,2868,2868,2500,47000,45000,0,45000,0,2000,1900,100,0,36000,18000,18000,0,3609,180,15,360,84,100
2020,230900391,5010,4360,860,860,3500,650,0,0,0,0,650,650,0,0,1500,1500,0,1500,2366,276,50,300,120,69
2020,231000202,140952,5450,5450,4450,0,135502,130000,70000,60000,0,5502,5502,0,0,200,200,0,0,9784,480,800,500,540,13779
2020,231000212,4000,1500,1000,1000,500,2500,0,0,0,0,2500,2500,0,0,0,0,0,0,2485,750,10,180,120,50
2020,231000232,49180,2050,2050,2050,0,47130,45000,45000,0,0,2130,1970,160,0,25650,25650,25600,0,3433,276,50,540,216,239
2020,231000242,7485,5390,2390,2390,3000,2095,0,0,0,0,2095,2095,0,0,1472,1472,0,0,5022,432,200,720,360,229
2020,231000252,3163,2580,80,80,2500,583,0,0,0,0,583,583,0,0,0,0,0,0,1114,468,60,60,36,4
2020,231000262,620,620,120,120,500,0,0,0,0,0,0,0,0,0,0,0,0,0,981,240,12,10,54,0
2020,231000272,42500,1500,1500,1500,0,41000,41000,41000,0,0,0,0,0,0,0,0,0,0,612,180,60,36,48,47
2020,231000282,15819,5819,1819,1819,4000,10000,10000,0,10000,0,0,0,0,0,10400,8400,8400,0,1073,300,10,114,180,18
2020,231000292,41135,7105,7105,7105,0,34030,31000,31000,0,0,3030,3030,0,0,450,450,400,0,3587,240,20,370,300,312
2020,231000302,26348,3348,3348,3348,0,23000,22500,16000,6500,0,500,500,0,0,850,850,850,0,3342,312,450,210,252,252
2020,231000312,26328,5938,5938,5938,0,20390,20000,20000,0,0,390,390,0,0,0,0,0,0,2809,320,200,300,165,132
2020,231000352,2001,401,301,301,100,1600,0,0,0,0,1600,1600,0,0,1558,1558,0,0,1810,200,75,540,186,109
2020,231000372,4994,3494,1794,1194,1700,1500,0,0,0,0,1500,1500,0,0,720,720,0,0,2522,396,10,120,300,390
2020,231000382,3138,2938,1205,205,1733,200,0,0,0,0,200,200,0,0,1300,1300,1300,0,1842,804,0,150,144,57
2020,231600201,11030,3642,3642,3642,0,7388,7000,7000,0,0,388,160,228,0,650,650,650,0,1065,60,10,84,96,82
2020,231600241,82245,9935,9935,4935,0,72310,72000,55000,17000,0,310,200,110,0,5016,5016,4928,0,1500,300,100,120,180,112
2020,231600251,6350,850,850,850,0,5500,5500,5500,0,0,0,0,0,0,0,0,0,0,460,112,72,24,48,10
2020,231600281,9300,300,300,300,0,9000,9000,9000,0,0,0,0,0,0,0,0,0,0,1437,146,120,216,126,117
2020,231600301,47820,820,820,820,0,47000,47000,12000,35000,0,0,0,0,0,7000,7000,7000,0,848,190,47,50,32,85
2020,231600311,9328,1000,1000,1000,0,8328,8000,8000,0,0,328,170,158,0,0,0,0,0,1185,160,44,180,57,48
2020,231600331,8690,90,90,90,0,8600,7000,7000,0,0,1600,1600,0,0,4446,4446,3000,0,1830,400,10,360,140,11
2020,231600341,17396,4940,4940,4940,0,12456,12000,12000,0,0,456,0,456,0,0,0,0,0,3318,170,2242,160,84,5
2020,231600381,2200,100,100,100,0,2100,2000,2000,0,0,100,0,100,0,0,0,0,0,864,144,500,60,20,2
2020,231700201,72594,61594,45594,41594,16000,11000,0,0,0,0,11000,400,4600,6000,0,0,0,0,3025,480,24,160,108,861
2020,231700231,2720,120,20,20,100,2600,1000,0,1000,0,1600,1600,0,0,2120,2120,0,0,1480,280,150,150,120,67
2020,231700241,9348,7648,1648,1648,6000,1700,0,0,0,0,1700,1700,0,0,6576,6576,3600,1876,4045,190,280,250,288,193
2020,231700261,146748,9068,9068,9068,0,137680,135000,42000,93000,0,2680,2680,0,0,3500,0,0,0,4642,400,70,390,300,328
2020,231700271,88399,42400,42400,42400,0,45999,45000,42000,3000,0,999,470,529,0,0,0,0,0,3514,336,18,132,180,236
2020,231700291,82670,25820,25820,25820,0,56850,55000,55000,0,0,1850,1850,0,0,0,0,0,0,5816,300,400,480,180,1031
2020,231700311,4110,4110,3610,3610,500,0,0,0,0,0,0,0,0,0,0,0,0,0,1125,384,60,180,48,1
2020,231700321,20200,2970,2970,2620,0,17230,17000,7000,10000,0,230,200,30,0,7218,7218,5218,0,4157,180,2030,720,120,43
2020,231700341,11400,11150,650,650,10500,250,0,0,0,0,250,250,0,0,2750,2750,2650,0,3320,360,100,200,400,132
2020,231700361,352960,2960,2960,2960,0,350000,350000,0,350000,0,0,0,0,0,180000,150000,150000,0,1941,164,20,120,120,3268
2020,231700371,14140,10140,140,140,10000,4000,3000,0,0,3000,1000,1000,0,0,500,500,0,500,1481,120,300,84,120,338
2020,231700381,20483,10783,10783,6283,0,9700,9000,9000,0,0,700,700,0,0,1300,1300,0,300,3577,348,245,120,228,106
2020,231700391,17367,3367,3367,3367,0,14000,12000,12000,0,0,2000,500,1500,0,0,0,0,0,2343,260,13,200,120,79
2020,231800211,41535,10860,7860,7860,3000,30675,30000,0,30000,0,675,675,0,0,27000,1000,0,0,3870,1300,100,180,240,1887
2020,231800221,21380,1380,1380,1380,0,20000,20000,20000,0,0,0,0,0,0,0,0,0,0,1625,215,240,320,108,19
2020,231800231,22482,1632,1632,1632,0,20850,20500,20500,0,0,350,150,200,0,4120,4120,220,3900,4310,400,700,200,350,26
2020,231800251,17756,5262,5262,4562,0,12494,8500,8500,0,0,3994,3762,232,0,3214,3214,1924,300,1160,140,60,250,120,141
2020,231800271,858,858,358,358,500,0,0,0,0,0,0,0,0,0,3730,3730,0,3730,1494,626,120,36,228,1
2020,231800281,19500,100,100,100,0,19400,19400,16900,2500,0,0,0,0,0,2000,2000,2000,0,926,240,120,36,60,27
2020,231800301,53783,1733,1433,1433,300,52050,50000,0,50000,0,2050,2050,0,0,7050,7050,5000,0,2244,530,100,220,156,167
2020,231800311,18850,17400,2400,2400,15000,1450,0,0,0,0,1450,1350,100,0,12082,12082,12000,0,4097,560,210,243,165,46
2020,231800331,166514,34214,33214,28214,1000,132300,131000,0,130000,1000,1300,1300,0,0,32000,10000,10000,0,8110,1010,1400,1200,480,331
2020,231800341,48290,16690,16690,15690,0,31600,30000,30000,0,0,1600,1600,0,0,5827,5827,5827,0,2670,320,30,400,120,1114
2020,231800361,64084,10184,10184,9184,0,53900,48000,32000,16000,0,5900,1900,4000,0,6000,6000,6000,0,4120,300,120,720,300,1034
2020,231800391,480,480,480,480,0,0,0,0,0,0,0,0,0,0,0,0,0,0,1113,191,50,68,132,1
2020,231900201,56200,3200,3200,3200,0,53000,53000,53000,0,0,0,0,0,0,7660,7660,7660,0,4556,456,180,50,330,1249
2020,231900221,22093,9193,9193,9193,0,12900,12800,12800,0,0,100,100,0,0,0,0,0,0,2925,325,100,600,180,60
2020,231900241,14100,700,700,700,0,13400,12000,12000,0,0,1400,1400,0,0,0,0,0,0,2294,240,100,300,144,46
2020,231900251,111200,1200,1200,1200,0,110000,110000,110000,0,0,0,0,0,0,24000,0,0,0,1663,173,180,120,144,561
2020,231900271,4800,1000,1000,1000,0,3800,3800,3800,0,0,0,0,0,0,0,0,0,0,238,60,10,10,0,17
2020,231900281,21780,80,80,80,0,21700,21700,21000,700,0,0,0,0,0,0,0,0,0,1224,225,70,72,172,29
2020,231900291,32800,5800,5800,5800,0,27000,27000,0,27000,0,0,0,0,0,3000,0,0,0,340,0,150,0,20,33
2020,231900301,9580,80,80,80,0,9500,9500,9500,0,0,0,0,0,0,0,0,0,0,766,84,110,55,24,16
2020,231900331,108000,6500,3500,3500,3000,101500,100000,0,100000,0,1500,1500,0,0,60000,60000,60000,0,2680,134,1000,240,216,414
2020,231900341,10770,770,770,770,0,10000,10000,10000,0,0,0,0,0,0,8000,8000,8000,0,1273,240,240,15,48,36
2020,231900361,32706,3006,3006,3006,0,29700,28000,28000,0,0,1700,1700,0,0,23866,23866,22875,0,4050,420,100,200,400,37
2020,231900371,61271,35271,14771,14771,20500,26000,25000,0,25000,0,1000,1000,0,0,2500,500,500,0,2796,336,150,250,240,90
2020,231900391,40870,8770,8770,8770,0,32100,18500,9000,9500,0,13600,600,13000,0,0,0,0,0,5300,1330,200,250,300,75
2020,232000212,24916,3916,3916,3916,0,21000,18500,18500,0,0,2500,2500,0,0,16285,16285,13600,0,4079,143,100,720,186,253
2020,232000232,10993,965,965,965,0,10028,9900,9900,0,0,128,128,0,0,0,0,0,0,3970,140,200,300,378,37
2020,232000242,48220,13020,13020,10020,0,35200,35000,35000,0,0,200,200,0,0,0,0,0,0,2320,360,200,180,240,44
2020,232000252,42734,6564,6564,6564,0,36170,35000,35000,0,0,1170,1170,0,0,0,0,0,0,3956,216,30,400,290,90
2020,232000272,3580,3580,3280,3280,300,0,0,0,0,0,0,0,0,0,0,0,0,0,1416,396,150,110,150,24
2020,232000282,22192,2792,2792,2792,0,19400,15700,9700,6000,0,3700,3700,0,0,1920,1920,0,0,1716,156,50,240,140,40
2020,232000302,536,536,36,36,500,0,0,0,0,0,0,0,0,0,0,0,0,0,1848,360,120,60,96,1
2020,232000332,25518,992,992,992,0,24526,22000,15000,7000,0,2526,1500,1026,0,11850,11850,11500,350,2504,234,90,720,180,83
2020,232600211,42700,18200,18200,18200,0,24500,24500,24500,0,0,0,0,0,0,0,0,0,0,1675,288,150,30,42,30
2020,232600221,7150,7150,2150,2150,5000,0,0,0,0,0,0,0,0,0,0,0,0,0,1069,142,117,80,60,21
2020,232600231,43931,18791,18791,18791,0,25140,20000,20000,0,0,5140,4000,1140,0,4351,4351,1237,1500,5966,306,100,600,360,117
2020,232600241,9437,4937,437,437,4500,4500,0,0,0,0,4500,4500,0,0,10460,10460,4500,1980,4510,420,300,120,240,53
2020,232600261,25100,100,100,100,0,25000,25000,25000,0,0,0,0,0,0,0,0,0,0,730,120,120,15,40,17
2020,232600271,51150,4650,4650,4650,0,46500,43000,43000,0,0,3500,3400,100,0,13216,13216,12700,0,3480,230,10,500,240,269
2020,232600281,510,510,10,10,500,0,0,0,0,0,0,0,0,0,400,400,0,0,1856,660,36,80,100,164
2020,232600321,2980,2980,2980,480,0,0,0,0,0,0,0,0,0,0,0,0,0,0,1266,210,72,60,144,34
2020,232600331,55263,12363,12363,7363,0,42900,42000,12000,30000,0,900,900,0,0,0,0,0,0,2182,198,300,550,144,294
2020,232700241,2260,2260,60,60,2200,0,0,0,0,0,0,0,0,0,0,0,0,0,410,60,60,20,20,4
2020,232700251,23360,11660,11660,11660,0,11700,11000,11000,0,0,700,700,0,0,500,500,400,0,2018,206,10,240,240,77
2020,232700271,25100,23500,18500,8900,5000,1600,0,0,0,0,1600,1600,0,0,0,0,0,0,2235,408,200,300,41,19
2020,232700281,3250,3000,2500,2500,500,250,0,0,0,0,250,250,0,0,0,0,0,0,1321,482,120,156,72,450
2020,232700301,4485,1435,1435,1435,0,3050,900,900,0,0,2150,2150,0,0,50,50,0,0,1800,270,320,180,240,5
2020,232700311,3924,1454,1454,1454,0,2470,2000,2000,0,0,470,400,70,0,0,0,0,0,1430,170,240,210,100,26
2020,232700321,3820,1600,1600,1600,0,2220,2220,1500,720,0,0,0,0,0,0,0,0,0,784,80,500,24,30,6
2020,232700341,1300,1300,1000,1000,300,0,0,0,0,0,0,0,0,0,0,0,0,0,1739,420,5,190,180,224
2020,232800201,4430,4430,430,430,4000,0,0,0,0,0,0,0,0,0,0,0,0,0,1009,240,340,10,10,1
2020,232800231,1834,1834,1534,1534,300,0,0,0,0,0,0,0,0,0,0,0,0,0,1958,444,100,80,102,1
2020,232800271,65510,5790,5790,4290,0,59720,52000,28500,23500,0,7720,2500,5220,0,36880,26380,20080,4000,4680,216,120,240,480,148
2020,232800291,20820,17920,1920,1920,16000,2900,0,0,0,0,2900,2900,0,0,300,300,0,0,3104,388,10,450,220,107
2020,232800301,6180,180,180,180,0,6000,6000,6000,0,0,0,0,0,0,0,0,0,0,1072,186,312,36,48,20
2020,232800311,7530,1230,1230,1230,0,6300,6000,6000,0,0,300,300,0,0,0,0,0,0,1218,108,40,240,108,34
2020,232800321,37600,28100,28100,28100,0,9500,9000,9000,0,0,500,500,0,0,0,0,0,0,1309,180,124,325,50,27
2020,232800331,27140,2940,2940,2940,0,24200,17500,17500,0,0,6700,2200,4500,0,11190,11190,11190,0,2306,500,20,180,96,14
2020,232900221,7104,6724,2524,2524,4200,380,0,0,0,0,380,380,0,0,8000,8000,0,8000,4552,480,1000,264,360,21
2020,232900231,1480,1480,80,80,1400,0,0,0,0,0,0,0,0,0,0,0,0,0,1187,312,100,99,60,7
2020,232900241,41077,1827,1827,1827,0,39250,32100,21000,11100,0,7150,350,0,6800,16370,16370,14370,2000,3002,962,660,52,118,28
2020,232900271,25230,8180,8180,3180,0,17050,13000,13000,0,0,4050,4050,0,0,7373,7373,6943,0,5755,168,720,1026,384,66
2020,232900291,35909,5009,5009,5009,0,30900,29000,20000,9000,0,1900,1900,0,0,0,0,0,0,2030,360,40,300,180,133
2020,232900301,10910,760,760,760,0,10150,10000,10000,0,0,150,150,0,0,0,0,0,0,962,120,60,120,72,8
2020,232900311,22970,14770,14770,14770,0,8200,6600,3300,3300,0,1600,1500,100,0,4000,4000,0,4000,3240,480,240,500,120,835
2020,232900321,520,500,500,500,0,20,0,0,0,0,20,0,20,0,0,0,0,0,692,80,150,40,18,1
2020,232900331,11250,250,250,250,0,11000,11000,6000,5000,0,0,0,0,0,0,0,0,0,369,82,78,20,25,6
2020,233000202,32700,15900,12900,9900,3000,16800,0,0,0,0,16800,800,1000,15000,0,0,0,0,5362,1800,72,360,360,91
2020,233000212,12710,12710,710,710,12000,0,0,0,0,0,0,0,0,0,2100,2100,2100,0,4505,360,5,120,300,8
2020,233000222,69010,950,950,950,0,68060,68000,15000,53000,0,60,0,60,0,0,0,0,0,1300,240,150,120,50,24
2020,233600201,1250,150,150,150,0,1100,0,0,0,0,1100,0,1100,0,0,0,0,0,2456,600,850,20,96,1
2020,233600221,35446,10946,10946,10946,0,24500,17400,6000,11400,0,7100,2800,300,4000,2029,2029,2000,0,1676,120,250,200,96,51
2020,233700201,28360,2560,2560,2560,0,25800,23000,23000,0,0,2800,2800,0,0,9192,9192,6492,0,2004,204,60,180,120,168
2020,233700221,145269,75407,75407,75407,0,69862,64000,44000,20000,0,5862,4950,912,0,0,0,0,0,5064,276,1200,250,240,679
2020,233800211,200,200,200,200,0,0,0,0,0,0,0,0,0,0,0,0,0,0,774,300,0,120,60,1
2020,233900201,65592,2842,2842,2842,0,62750,60000,30000,30000,0,2750,1700,1050,0,800,800,0,800,1390,70,20,40,100,23
2020,240000202,14995,295,295,295,0,14700,14700,14700,0,0,0,0,0,0,0,0,0,0,761,228,65,15,46,16
2020,240000212,644,401,401,401,0,243,0,0,0,0,243,0,243,0,0,0,0,0,674,204,30,15,20,1
2020,240000222,147636,31536,31536,28536,0,116100,96900,79000,17900,0,19200,9200,10000,0,130000,130000,100000,30000,9961,485,130,483,215,3322
2020,240000242,33041,13357,13357,13357,0,19684,17700,17700,0,0,1984,1870,114,0,0,0,0,0,5706,1322,51,504,324,144
2020,240000262,27298,249,249,249,0,27049,27000,27000,0,0,49,0,49,0,300,0,0,0,961,72,48,36,36,33
2020,240000282,65390,43990,43990,28990,0,21400,18500,18500,0,0,2900,2400,500,0,200,200,0,0,3891,444,362,235,219,110
2020,240000292,21452,17752,8752,8752,9000,3700,0,0,0,0,3700,3700,0,0,3700,3700,600,0,2830,164,108,240,225,399
2020,240000302,82340,41840,41840,41840,0,40500,32500,31000,1500,0,8000,8000,0,0,10920,10920,9600,1320,6700,600,100,800,500,1725
2020,240000312,24318,2018,2018,2018,0,22300,20500,20500,0,0,1800,1800,0,0,3500,3500,3500,0,1723,180,250,360,168,85
2020,240000332,8950,550,50,50,500,8400,8400,0,7500,900,0,0,0,0,3350,3350,0,0,1580,600,140,60,120,21
2020,240000342,22948,6798,6798,6298,0,16150,12080,10000,2080,0,4070,1070,0,3000,4500,4500,3500,0,3088,648,60,420,240,84
2020,240000362,31500,15700,10200,10200,5500,15800,15000,0,15000,0,800,800,0,0,7500,3500,3500,0,1150,84,10,240,96,155
2020,240000392,3400,400,200,200,200,3000,0,0,0,0,3000,3000,0,0,0,0,0,0,1800,420,30,300,140,172
2020,240600221,1055,1055,1055,1055,0,0,0,0,0,0,0,0,0,0,2500,2500,0,1200,1967,264,5,72,360,0
2020,240600231,42751,22218,22218,22218,0,20533,19500,19500,0,0,1033,1000,33,0,1100,1100,0,1100,4399,180,60,300,240,331
2020,240600241,55320,14826,14826,14826,0,40494,37500,37500,0,0,2994,2000,994,0,1472,1472,0,1422,7275,585,750,660,310,191
2020,240600251,17522,8059,8059,8059,0,9463,8800,8800,0,0,663,550,113,0,0,0,0,0,857,93,89,129,41,59
2020,240600261,58071,13861,13861,13361,0,44210,41747,29000,12747,0,2463,1700,763,0,8600,8600,8532,0,5202,240,46,450,336,375
2020,240600271,63236,5171,5171,5171,0,58065,46000,31000,15000,0,12065,8000,2065,2000,4426,4426,2814,0,3468,490,108,620,310,1074
2020,240600281,32644,2644,2644,644,0,30000,23500,23000,500,0,6500,2900,1600,2000,1805,1805,0,1760,2763,192,58,480,288,131
2020,240600311,3,3,3,3,0,0,0,0,0,0,0,0,0,0,0,0,0,0,335,75,20,10,15,51
2020,240600321,10720,400,400,400,0,10320,10000,10000,0,0,320,320,0,0,1900,1900,1900,0,2131,261,50,180,240,206
2020,240600331,32558,13308,13308,12308,0,19250,19000,19000,0,0,250,250,0,0,0,0,0,0,2600,260,30,300,200,411
2020,240600351,31053,4053,4053,4053,0,27000,27000,27000,0,0,0,0,0,0,0,0,0,0,1120,180,70,60,120,63
2020,240600361,21228,9228,9228,9228,0,12000,10000,10000,0,0,2000,2000,0,0,4400,4400,4400,0,2569,228,700,120,300,64
2020,240600371,49080,6680,6680,6680,0,42400,20000,20000,0,0,22400,4400,0,18000,0,0,0,0,2399,300,240,860,84,166
2020,240600381,22500,4100,4100,4100,0,18400,16000,16000,0,0,2400,1400,1000,0,0,0,0,0,1101,180,5,120,156,304
2020,240600391,18978,678,678,678,0,18300,16000,16000,0,0,2300,2300,0,0,9476,9476,9476,0,1820,240,300,180,60,26
2020,240700201,11969,367,367,367,0,11602,11000,11000,0,0,602,150,452,0,100,0,0,0,1635,193,363,420,96,20
2020,240700241,12680,2468,2468,2468,0,10212,9800,9800,0,0,412,330,82,0,1200,1000,1000,0,2375,102,96,420,136,45
2020,240700251,24851,4218,4218,3218,0,20633,16000,16000,0,0,4633,2350,783,1500,2035,35,0,0,2831,180,180,570,156,129
2020,240700271,17430,16535,1535,1535,15000,895,0,0,0,0,895,785,110,0,5230,5230,5000,0,1630,180,24,144,120,7
2020,240700281,65990,7110,7110,7110,0,58880,55500,24500,31000,0,3380,3150,230,0,15020,9020,0,9020,4954,280,420,690,204,516
2020,240700301,28596,7322,7322,6422,0,21274,20500,20500,0,0,774,474,300,0,8393,8393,8354,0,5457,200,93,341,253,247
2020,240700331,19174,4174,4174,4174,0,15000,15000,7000,8000,0,0,0,0,0,1000,0,0,0,1926,480,120,96,120,30
2020,240700341,150,150,50,50,100,0,0,0,0,0,0,0,0,0,600,600,0,600,1668,398,50,120,120,31
2020,240700351,27600,14600,14600,14600,0,13000,13000,13000,0,0,0,0,0,0,0,0,0,0,1889,360,200,10,84,23
2020,240800201,56537,22797,22797,22797,0,33740,29000,29000,0,0,4740,4330,410,0,2800,0,0,0,3910,322,180,657,132,907
2020,240800211,16521,1587,1587,1587,0,14934,14000,14000,0,0,934,350,584,0,1500,0,0,0,2490,252,356,244,96,61
2020,240800221,5249,5249,4749,4749,500,0,0,0,0,0,0,0,0,0,0,0,0,0,2873,696,144,160,216,155
2020,240800251,16368,198,198,198,0,16170,16000,16000,0,0,170,0,170,0,0,0,0,0,590,115,100,45,30,17
2020,240800261,18063,13,13,13,0,18050,18000,18000,0,0,50,0,50,0,372,372,0,0,887,230,90,15,90,19
2020,240800271,22840,4645,4645,4645,0,18195,18000,18000,0,0,195,0,195,0,663,663,0,0,1230,892,84,12,45,52
2020,240800281,40878,6700,6700,6700,0,34178,32000,32000,0,0,2178,1880,298,0,7903,7903,7903,0,3661,204,227,356,180,215
2020,240800301,43530,42130,41830,41830,300,1400,0,0,0,0,1400,700,700,0,0,0,0,0,3101,715,240,300,180,39
2020,240800311,10,10,10,10,0,0,0,0,0,0,0,0,0,0,0,0,0,0,362,90,50,10,22,1
2020,240800321,23507,10512,10512,10512,0,12995,10000,10000,0,0,2995,2950,45,0,3520,3520,3520,0,2742,180,110,250,110,221
2020,240800341,36322,7622,7622,7622,0,28700,28000,28000,0,0,700,700,0,0,17496,17496,17496,0,4720,400,50,380,360,420
2020,240800351,39710,410,410,410,0,39300,35000,23000,12000,0,4300,4300,0,0,0,0,0,0,4630,430,100,700,300,431
2020,240800361,89170,5070,5070,5070,0,84100,84000,50000,34000,0,100,100,0,0,32500,14000,14000,0,3350,400,200,500,150,186
2020,240800371,13716,5716,5716,5716,0,8000,6000,6000,0,0,2000,2000,0,0,4980,4980,1180,1700,2854,240,40,240,204,413
2020,240800381,123086,37360,37360,33360,0,85726,75000,15000,60000,0,10726,6500,4226,0,8088,5088,5088,0,4250,300,500,300,150,302
2020,240800391,20278,1278,1278,1278,0,19000,15000,15000,0,0,4000,4000,0,0,5840,5840,3340,0,2800,200,500,250,150,373
2020,240900211,202,202,102,102,100,0,0,0,0,0,0,0,0,0,0,0,0,0,853,248,43,36,45,1
2020,240900221,19033,1672,1672,172,0,17361,7600,7600,0,0,9761,1100,8661,0,1750,1750,1700,0,5609,576,396,722,204,97
2020,240900241,13000,8195,6195,6135,2000,4805,4500,0,0,4500,305,200,105,0,4500,4500,0,4500,5287,560,40,484,328,52
2020,240900251,43473,3406,3406,3406,0,40067,40000,20000,20000,0,67,0,67,0,0,0,0,0,2420,360,360,120,120,19
2020,240900261,200,200,200,200,0,0,0,0,0,0,0,0,0,0,0,0,0,0,383,113,30,15,15,1
2020,240900291,16909,1819,1819,1819,0,15090,15000,15000,0,0,90,0,90,0,0,0,0,0,1845,680,120,200,200,52
2020,240900311,4310,130,130,130,0,4180,4000,4000,0,0,180,0,180,0,0,0,0,0,715,120,30,80,70,13
2020,240900321,8444,444,444,444,0,8000,8000,0,8000,0,0,0,0,0,5900,2600,2600,0,1008,150,140,50,48,49
2020,240900331,28104,3304,3304,3104,0,24800,22000,22000,0,0,2800,2800,0,0,11960,11960,10160,1800,6450,400,250,600,350,190
2020,240900341,17130,15830,6830,6830,9000,1300,0,0,0,0,1300,1300,0,0,690,690,0,0,2896,420,120,180,156,32
2020,240900351,6240,5040,540,540,4500,1200,0,0,0,0,1200,1200,0,0,3640,3640,3200,350,2191,216,80,360,110,290
2020,240900371,21740,21540,5040,5040,16500,200,0,0,0,0,200,200,0,0,15200,15200,12000,3000,1898,180,40,250,130,80
2020,240900381,793240,65360,65360,63360,0,727880,726000,26000,700000,0,1880,1880,0,0,28000,8000,8000,0,4895,600,240,585,240,3976
2020,240900391,71021,2021,2021,2021,0,69000,65000,40000,25000,0,4000,2000,2000,0,40890,35690,32000,3690,5990,480,120,920,360,534
2020,241000202,2030,1030,1030,1030,0,1000,0,0,0,0,1000,1000,0,0,0,0,0,0,1815,208,801,126,96,36
2020,241000212,1680,640,340,340,300,1040,1000,0,1000,0,40,40,0,0,0,0,0,0,799,84,125,121,36,40
2020,241000222,4059,4059,559,559,3500,0,0,0,0,0,0,0,0,0,0,0,0,0,2076,140,24,70,170,1
2020,241000242,2905,2905,2405,2405,500,0,0,0,0,0,0,0,0,0,0,0,0,0,814,400,11,35,72,1
2020,241000252,28744,2744,2744,2744,0,26000,25700,10700,15000,0,300,0,300,0,0,0,0,0,641,151,44,35,48,7
2020,241000262,48292,7492,7492,7492,0,40800,38000,38000,0,0,2800,2800,0,0,0,0,0,0,2843,168,240,121,144,212
2020,241000272,95385,60155,60155,60155,0,35230,35000,35000,0,0,230,230,0,0,0,0,0,0,1379,482,94,45,72,248
2020,241000282,68509,68509,68509,68509,0,0,0,0,0,0,0,0,0,0,0,0,0,0,2504,258,309,239,221,146
2020,241000292,600,600,400,400,200,0,0,0,0,0,0,0,0,0,0,0,0,0,1423,456,144,72,120,17
2020,241000302,4670,170,170,170,0,4500,4500,1500,3000,0,0,0,0,0,0,0,0,0,1155,200,300,30,40,13
2020,241000312,44480,1980,1980,1980,0,42500,40000,12000,28000,0,2500,2500,0,0,0,0,0,0,2140,260,120,180,180,89
2020,241000322,27000,5500,5500,5500,0,21500,14000,8000,6000,0,7500,7500,0,0,10353,10353,792,2400,4384,228,240,486,240,270
2020,241000352,8150,1100,1100,1100,0,7050,7000,7000,0,0,50,0,50,0,0,0,0,0,668,132,100,5,36,6
2020,241000362,8200,1200,1000,1000,200,7000,5000,0,5000,0,2000,1500,500,0,0,0,0,0,1138,240,24,300,120,27
2020,241000382,2760,560,560,560,0,2200,2200,2200,0,0,0,0,0,0,0,0,0,0,390,100,10,60,10,3
2020,241000392,3425,205,205,205,0,3220,3000,3000,0,0,220,220,0,0,0,0,0,0,1180,130,140,200,70,10
2020,241600201,14658,610,610,610,0,14048,14000,14000,0,0,48,0,48,0,9419,9419,9269,0,1255,368,36,108,96,27
2020,241600221,363,363,63,63,300,0,0,0,0,0,0,0,0,0,0,0,0,0,627,252,159,63,15,1
2020,241600231,24294,7299,7299,7299,0,16995,16900,16900,0,0,95,0,95,0,0,0,0,0,2492,270,280,260,192,102
2020,241600251,40597,13667,13667,13667,0,26930,24000,24000,0,0,2930,2700,230,0,0,0,0,0,5725,272,604,405,144,1783
2020,241600261,29582,3501,3501,3501,0,26081,26000,26000,0,0,81,0,81,0,11956,11956,11956,0,3532,540,1072,72,300,42
2020,241600271,71320,32844,32844,32644,0,38476,38000,28000,10000,0,476,250,226,0,0,0,0,0,2285,240,72,240,144,388
2020,241600291,1455,1406,206,206,1200,49,0,0,0,0,49,0,49,0,0,0,0,0,593,228,22,24,24,1
2020,241600311,8654,6654,6654,6654,0,2000,2000,2000,0,0,0,0,0,0,0,0,0,0,796,144,70,48,41,3
2020,241600341,34106,616,616,616,0,33490,30000,30000,0,0,3490,3490,0,0,19365,19365,14253,1581,2505,385,10,120,300,73
2020,241600351,76170,14320,14320,14320,0,61850,61500,24000,37500,0,350,350,0,0,16500,0,0,0,4560,240,400,300,120,95
2020,241600371,51940,18440,18440,13440,0,33500,19500,13000,6500,0,14000,2000,7000,5000,19100,19100,7300,8500,3132,520,200,300,252,528
2020,241600381,36681,20455,20455,20455,0,16226,15000,15000,0,0,1226,1000,226,0,0,0,0,0,4018,324,1500,240,84,121
2020,241700201,19873,425,425,425,0,19448,19000,19000,0,0,448,350,98,0,10164,10164,10164,0,3990,360,10,480,240,41
2020,241700211,250,250,7,7,243,0,0,0,0,0,0,0,0,0,8000,8000,0,0,686,119,29,30,36,0
2020,241700221,14076,3576,3576,3576,0,10500,10500,10500,0,0,0,0,0,0,175,175,0,0,592,102,120,10,18,13
2020,241700231,39509,25759,25759,25759,0,13750,12000,12000,0,0,1750,1750,0,0,2000,2000,0,2000,4439,180,30,720,240,65
2020,241700241,19892,18558,4558,4558,14000,1334,0,0,0,0,1334,1220,114,0,2800,2800,2000,800,2276,240,38,360,204,730
2020,241700261,19012,2012,2012,2012,0,17000,17000,17000,0,0,0,0,0,0,0,0,0,0,426,109,115,15,29,17
2020,241700271,25388,4563,4563,2563,0,20825,18800,12000,6000,800,2025,480,545,1000,8390,3590,480,3110,2534,230,50,260,264,27
2020,241700281,22017,10017,10017,10017,0,12000,12000,6000,6000,0,0,0,0,0,0,0,0,0,1077,107,115,121,84,38
2020,241700291,38706,15389,15389,10389,0,23317,22900,22900,0,0,417,399,18,0,6700,6700,4600,0,4091,312,530,420,240,80
2020,241700301,11680,7680,3680,3680,4000,4000,0,0,0,0,4000,4000,0,0,0,0,0,0,4144,1440,100,246,306,43
2020,241700311,1034,1034,834,834,200,0,0,0,0,0,0,0,0,0,390,390,0,390,854,348,36,120,120,1
2020,241700331,30072,1472,1472,472,0,28600,28300,10000,17000,1300,300,300,0,0,11600,11600,11600,0,2324,59,20,300,25,49
2020,241700361,40700,8020,7720,7720,300,32680,25000,0,25000,0,7680,2480,5200,0,31100,22100,20000,2000,3490,780,250,240,180,147
2020,241700371,2010,10,10,10,0,2000,2000,2000,0,0,0,0,0,0,0,0,0,0,750,130,100,10,15,3
2020,241700381,31756,11530,11530,11530,0,20226,20000,10000,10000,0,226,0,226,0,0,0,0,0,2026,356,30,144,36,23
2020,241800201,49009,7984,7984,7984,0,41025,40000,40000,0,0,1025,450,575,0,26000,26000,16000,0,6290,240,120,180,120,498
2020,241800211,53130,60,60,60,0,53070,53000,20000,33000,0,70,70,0,0,37091,7091,4200,0,1782,249,342,254,48,79
2020,241800231,207335,28385,28385,28385,0,178950,168000,68000,100000,0,10950,6450,4500,0,0,0,0,0,6830,650,45,850,175,7147
2020,241800241,9166,7563,5563,4563,2000,1603,0,0,0,0,1603,126,477,1000,1060,1060,0,0,769,125,191,67,141,25
2020,241800251,14315,5155,5155,5155,0,9160,8000,0,8000,0,1160,900,260,0,0,0,0,0,2210,250,150,310,120,122
2020,241800261,10152,152,152,152,0,10000,10000,10000,0,0,0,0,0,0,0,0,0,0,858,114,168,48,24,11
2020,241800271,1706,1706,206,206,1500,0,0,0,0,0,0,0,0,0,0,0,0,0,712,181,72,18,36,1
2020,241800291,35268,30368,10368,6068,20000,4900,0,0,0,0,4900,3700,1200,0,10800,10800,10000,0,1996,192,30,384,120,253
2020,241800311,15997,1847,1847,1847,0,14150,14000,14000,0,0,150,150,0,0,10000,10000,6000,4000,2926,360,30,330,216,315
2020,241800321,50760,4040,4040,4040,0,46720,42000,8000,34000,0,4720,520,4200,0,28000,28000,20000,8000,2000,300,200,600,200,99
2020,241800331,42169,969,969,969,0,41200,40000,40000,0,0,1200,1200,0,0,0,0,0,0,1900,300,150,150,150,92
2020,241800361,46030,3770,3770,3770,0,42260,40500,6500,34000,0,1760,1350,410,0,0,0,0,0,1099,194,80,190,84,102
2020,241800381,16190,16190,2190,2190,14000,0,0,0,0,0,0,0,0,0,9500,9500,9500,0,1052,252,10,100,180,26
2020,241800391,38014,2014,2014,2014,0,36000,36000,10000,26000,0,0,0,0,0,0,0,0,0,708,120,240,10,48,19
2020,241900221,34092,927,927,927,0,33165,30000,30000,0,0,3165,2550,615,0,0,0,0,0,3080,360,600,600,240,166
2020,241900231,22877,2287,2287,2287,0,20590,20000,20000,0,0,590,590,0,0,39,39,0,0,4567,406,106,529,223,77
2020,241900241,1113,1113,913,913,200,0,0,0,0,0,0,0,0,0,0,0,0,0,1458,416,12,27,84,17
2020,241900251,47372,26359,26359,25999,0,21013,19500,9500,10000,0,1513,1400,113,0,0,0,0,0,2582,120,300,300,120,124
2020,241900261,25900,11900,11900,11900,0,14000,14000,14000,0,0,0,0,0,0,0,0,0,0,1469,288,68,132,60,40
2020,241900271,15976,2205,2205,2205,0,13771,13000,13000,0,0,771,550,221,0,8402,8402,8152,0,3174,500,100,399,291,155
2020,241900291,3752,3752,2190,2190,1562,0,0,0,0,0,0,0,0,0,1610,1610,1610,0,485,179,101,37,15,0
2020,241900301,7855,2735,2735,2735,0,5120,4000,0,4000,0,1120,1100,20,0,1100,1100,0,0,2120,300,100,400,150,19
2020,241900311,4670,470,470,470,0,4200,4000,4000,0,0,200,200,0,0,2040,2040,0,0,3850,400,500,450,400,63
2020,241900321,7150,2000,2000,2000,0,5150,5000,5000,0,0,150,150,0,0,500,500,500,0,2276,196,600,100,240,42
2020,241900331,13305,3815,3815,3815,0,9490,9400,3400,6000,0,90,0,90,0,0,0,0,0,990,122,149,103,47,9
2020,241900351,2300,2300,200,200,2100,0,0,0,0,0,0,0,0,0,150,150,0,0,860,70,300,60,50,1
2020,241900371,26475,18995,18995,18995,0,7480,7300,4700,2600,0,180,0,180,0,0,0,0,0,1190,150,200,50,80,64
2020,241900381,31108,5158,5158,4658,0,25950,19200,10000,9200,0,6750,6300,450,0,5733,5733,0,2183,7300,600,400,1100,500,478
2020,241900391,16160,6960,6960,6960,0,9200,3000,3000,0,0,6200,6200,0,0,5930,5930,0,800,2070,130,40,600,180,310
2020,242000202,79596,31747,31747,31747,0,47849,46800,29800,0,17000,1049,710,339,0,15000,15000,0,15000,2116,392,286,276,108,108
2020,242000212,460,460,260,260,200,0,0,0,0,0,0,0,0,0,900,900,0,900,1770,624,0,36,120,0
2020,242000232,27685,835,835,835,0,26850,26500,12000,14500,0,350,350,0,0,1000,0,0,0,1524,241,144,121,84,74
2020,242000302,1143,730,230,230,500,413,0,0,0,0,413,300,113,0,1200,1200,0,1000,2600,550,120,50,360,8
2020,242000312,247,247,47,47,200,0,0,0,0,0,0,0,0,0,350,350,0,0,1270,340,10,10,60,1
2020,242000322,14170,5050,5050,5050,0,9120,9000,5000,4000,0,120,0,120,0,0,0,0,0,467,77,10,10,22,17
2020,242000342,6579,60,60,60,0,6519,6519,1569,4950,0,0,0,0,0,0,0,0,0,684,174,50,25,24,7
2020,242000382,2880,2680,680,680,2000,200,0,0,0,0,200,200,0,0,100,100,0,0,3730,370,2000,480,180,53
2020,242000392,26370,2720,2720,2720,0,23650,22000,22000,0,0,1650,1650,0,0,8070,8070,3000,5000,3710,400,200,700,500,609
2020,242600201,29969,9637,9637,9637,0,20332,20000,20000,0,0,332,150,182,0,11533,11533,9833,900,3494,638,103,207,299,61
2020,242600211,55940,7410,7410,7410,0,48530,47000,47000,0,0,1530,1530,0,0,21000,21000,13000,8000,4041,324,135,317,264,670
2020,242600221,34130,5148,5148,5148,0,28982,28000,28000,0,0,982,900,82,0,0,0,0,0,3352,229,281,518,247,630
2020,242600231,11311,7331,3331,3331,4000,3980,3580,0,0,3580,400,270,130,0,3300,3300,1100,2200,2316,180,36,300,120,42
2020,242600301,14173,6860,6860,6860,0,7313,7000,2000,5000,0,313,200,113,0,30,30,0,0,2145,195,385,420,80,43
2020,242600321,15145,145,145,145,0,15000,0,0,0,0,15000,0,15000,0,19986,19986,8500,1800,1060,110,50,50,120,226
2020,242600361,16171,4444,4444,4444,0,11727,11000,11000,0,0,727,398,329,0,10600,10600,9500,900,3860,240,150,144,126,202
2020,242700211,25475,7575,7575,7575,0,17900,16000,16000,0,0,1900,1900,0,0,0,0,0,0,2912,192,50,270,190,207
2020,242700301,22630,5645,5645,5645,0,16985,15810,8110,7700,0,1175,100,1075,0,0,0,0,0,1027,281,60,50,35,23
2020,242700311,11140,4640,4640,4640,0,6500,4000,4000,0,0,2500,1500,1000,0,0,0,0,0,1319,90,70,230,84,138
2020,242700321,4670,670,670,670,0,4000,4000,4000,0,0,0,0,0,0,0,0,0,0,607,225,50,30,42,40
2020,242700331,41836,17236,17236,17236,0,24600,16000,4000,12000,0,8600,3600,5000,0,0,0,0,0,1863,135,67,235,174,1149
2020,242700341,11780,2380,1880,1880,500,9400,8400,0,8400,0,1000,1000,0,0,1200,1200,1000,0,3018,580,30,50,432,133
2020,242700361,53398,778,778,778,0,52620,52500,5500,47000,0,120,0,120,0,0,0,0,0,292,89,24,12,8,16
2020,242800231,3310,3220,220,220,3000,90,0,0,0,0,90,0,90,0,0,0,0,0,593,208,34,60,59,7
2020,242800311,18060,10960,10960,10960,0,7100,6600,2100,4500,0,500,350,150,0,0,0,0,0,850,65,150,390,50,27
2020,242800321,74640,23940,23940,21940,0,50700,44800,31000,13800,0,5900,3750,2150,0,1500,0,0,0,3532,340,240,1120,312,131
2020,242800331,4078,2278,2178,2178,100,1800,1800,0,1800,0,0,0,0,0,0,0,0,0,1261,360,24,84,54,26
2020,242800371,11200,200,200,200,0,11000,11000,5000,6000,0,0,0,0,0,0,0,0,0,616,120,65,20,6,9
2020,242800381,8643,500,500,500,0,8143,8000,8000,0,0,143,30,113,0,4560,4560,4000,500,1013,155,160,130,48,29
2020,242800391,46200,13200,13200,13200,0,33000,29000,24000,5000,0,4000,0,4000,0,0,0,0,0,1950,250,100,20,120,48
2020,242900201,223,223,13,13,210,0,0,0,0,0,0,0,0,0,0,0,0,0,541,144,12,36,12,0
2020,242900211,8247,247,247,247,0,8000,8000,8000,0,0,0,0,0,0,0,0,0,0,743,138,68,36,15,9
2020,242900231,35477,29377,14377,4377,15000,6100,0,0,0,0,6100,6100,0,0,0,0,0,0,5285,409,11,432,420,97
2020,242900241,35480,20350,9350,9350,11000,15130,13300,0,8500,4800,1830,1740,90,0,3800,3500,0,3500,3746,156,150,540,120,437
2020,242900301,2687,2687,417,417,2270,0,0,0,0,0,0,0,0,0,1750,1750,1000,0,3329,240,10,120,300,14
2020,242900321,32260,60,60,60,0,32200,31000,7000,24000,0,1200,0,1200,0,1300,1300,1300,0,2030,270,1140,120,20,31
2020,242900331,800,700,700,700,0,100,100,100,0,0,0,0,0,0,0,0,0,0,266,36,60,10,20,3
2020,242900361,16483,783,783,783,0,15700,13600,8800,4800,0,2100,2100,0,0,6550,6550,4500,700,3812,240,10,540,160,344
2020,242900381,14811,1811,1811,1811,0,13000,2500,2500,0,0,10500,2000,0,8500,3678,3678,1406,532,1461,313,100,120,100,35
2020,242900391,14000,2000,2000,2000,0,12000,12000,4000,8000,0,0,0,0,0,500,0,0,0,565,108,12,18,30,15
2020,243000302,1332,232,232,232,0,1100,0,0,0,0,1100,1100,0,0,900,900,0,0,3377,281,36,480,240,1
2020,243000312,2628,1628,628,628,1000,1000,0,0,0,0,1000,1000,0,0,700,700,0,0,1584,466,6,240,102,41
2020,243000322,28806,1286,1286,1286,0,27520,23300,12000,11300,0,4220,4100,120,0,700,700,0,700,2606,136,1000,96,120,135
2020,250000202,7706,956,956,956,0,6750,6750,6750,0,0,0,0,0,0,0,0,0,0,1056,240,110,24,62,84
2020,250000212,15012,5212,5212,5212,0,9800,6000,5000,1000,0,3800,3800,0,0,1000,1000,0,0,2552,240,400,360,132,322
2020,250000222,7920,150,150,150,0,7770,7700,7700,0,0,70,0,70,0,0,0,0,0,483,156,46,1,18,5
2020,250000232,14768,2768,2768,2768,0,12000,8500,8500,0,0,3500,3500,0,0,4365,4365,4365,0,3580,300,120,580,360,92
2020,250000252,6566,6566,3066,3066,3500,0,0,0,0,0,0,0,0,0,0,0,0,0,1620,180,150,140,480,30
2020,250000262,17500,2400,2400,2400,0,15100,15000,15000,0,0,100,0,100,0,1350,1350,0,1350,3260,250,2080,150,110,28
2020,250000282,18680,660,660,585,0,18020,18000,18000,0,0,20,0,20,0,125,25,0,0,1230,52,430,48,83,17
2020,250000292,17050,50,50,50,0,17000,17000,17000,0,0,0,0,0,0,15,15,0,0,1004,280,170,60,46,24
2020,250000332,15210,11210,9210,8050,2000,4000,0,0,0,0,4000,3000,0,1000,5400,5400,1400,4000,2050,400,30,540,250,238
2020,250000352,13408,1330,330,330,1000,12078,11000,0,11000,0,1078,1078,0,0,1420,1420,0,1000,3396,750,200,120,200,445
2020,250000362,4420,3920,2420,2420,1500,500,0,0,0,0,500,500,0,0,0,0,0,0,781,140,20,240,36,33
2020,250000372,43248,20878,20878,20878,0,22370,17500,17000,500,0,4870,4870,0,0,3200,3200,2000,1200,7250,330,100,540,180,1615
2020,250000392,129570,8420,8420,8420,0,121150,116600,51000,55000,10600,4550,2550,2000,0,93500,65500,33500,32000,5350,500,400,250,300,4469
2020,250600211,114734,32734,32734,32734,0,82000,82000,22000,60000,0,0,0,0,0,6000,0,0,0,2409,327,230,50,110,877
2020,250600221,255,255,5,5,250,0,0,0,0,0,0,0,0,0,0,0,0,0,661,106,40,60,15,0
2020,250600261,3515,3015,15,15,3000,500,0,0,0,0,500,500,0,0,200,200,0,0,1885,200,20,150,324,11
2020,250600271,4720,20,20,20,0,4700,4700,4700,0,0,0,0,0,0,200,200,0,0,687,120,0,36,36,6
2020,250600281,72244,7544,7544,7544,0,64700,60000,50000,10000,0,4700,4700,0,0,16600,600,0,600,2838,204,200,300,228,230
2020,250600311,1410,1410,210,210,1200,0,0,0,0,0,0,0,0,0,0,0,0,0,405,50,2,12,15,1
2020,250600321,35703,17253,10253,10253,7000,18450,16500,0,16500,0,1950,1950,0,0,6400,6400,6400,0,2424,236,10,180,268,50
2020,250600341,39393,4467,4467,3967,0,34926,33000,33000,0,0,1926,1700,226,0,0,0,0,0,3680,600,50,400,180,134
2020,250600351,52913,13663,13663,12963,0,39250,31000,11000,20000,0,8250,1850,6400,0,22800,4800,4800,0,4450,700,100,300,250,818
2020,250600381,48298,17598,17598,17598,0,30700,27000,27000,0,0,3700,3400,300,0,703,703,0,0,7620,420,360,360,240,1397
2020,250600391,28554,11104,11104,8104,0,17450,14000,14000,0,0,3450,250,200,3000,600,600,600,0,3662,360,12,240,240,28
2020,250700211,1761,1761,761,761,1000,0,0,0,0,0,0,0,0,0,1030,1030,0,1000,1704,468,84,132,120,1
2020,250700241,25700,610,610,610,0,25090,25000,25000,0,0,90,90,0,0,7400,7400,7400,0,2340,300,200,200,120,60
2020,250700251,13000,5800,5800,5800,0,7200,7200,7200,0,0,0,0,0,0,0,0,0,0,820,120,10,60,80,24
2020,250700281,200,0,0,0,0,200,0,0,0,0,200,0,200,0,0,0,0,0,1193,300,24,60,29,23
2020,250700291,164332,23932,23932,23932,0,140400,139000,97000,42000,0,1400,1400,0,0,16000,0,0,0,2940,400,100,400,240,328
2020,250700311,14792,3312,3312,3312,0,11480,8000,8000,0,0,3480,3480,0,0,0,0,0,0,2752,222,160,540,204,427
2020,250700331,19815,5165,5165,5165,0,14650,14000,14000,0,0,650,650,0,0,11102,11102,8802,2300,2712,260,12,272,156,199
2020,250700341,73416,24516,24516,10516,0,48900,43000,43000,0,0,5900,3900,2000,0,40000,40000,0,40000,3687,336,60,156,240,1069
2020,250700361,1550,1550,550,550,1000,0,0,0,0,0,0,0,0,0,0,0,0,0,1394,700,20,120,24,28
2020,250700371,25714,11884,11884,11384,0,13830,12000,12000,0,0,1830,1330,0,500,1000,1000,0,1000,3795,450,15,330,250,61
2020,250700381,12020,20,20,20,0,12000,12000,12000,0,0,0,0,0,0,0,0,0,0,610,151,140,25,12,10
2020,250700391,156594,32194,32194,32194,0,124400,119000,36000,83000,0,5400,5400,0,0,14000,0,0,0,3720,450,30,500,240,547
2020,250800201,423,423,393,393,30,0,0,0,0,0,0,0,0,0,0,0,0,0,1544,576,10,60,84,1
2020,250800211,10310,9810,2810,2810,7000,500,0,0,0,0,500,500,0,0,4900,4900,4900,0,1215,125,10,180,120,11
2020,250800241,18000,1000,1000,1000,0,17000,16500,16500,0,0,500,500,0,0,1000,0,0,0,2232,200,1000,250,12,52
2020,250800251,25480,7080,7080,7080,0,18400,18000,18000,0,0,400,400,0,0,0,0,0,0,1445,173,250,210,62,50
2020,250800261,15584,2884,2884,1384,0,12700,9000,9000,0,0,3700,700,2000,1000,14200,14200,6500,5000,1030,180,50,120,120,49
2020,250800271,80710,28082,28082,28082,0,52628,52000,50000,2000,0,628,400,228,0,0,0,0,0,2344,300,8,240,136,245
2020,250800281,28444,4744,4744,4744,0,23700,23000,15000,8000,0,700,700,0,0,30,30,0,0,2278,200,100,150,250,115
2020,250800291,850,780,430,430,350,70,0,0,0,0,70,70,0,0,0,0,0,0,1255,130,10,270,120,27
2020,250800311,52000,1400,1400,1400,0,50600,49000,14000,35000,0,1600,1600,0,0,27900,27900,25000,1000,1560,300,60,300,180,224
2020,250800321,5030,4150,3950,3950,200,880,0,0,0,0,880,0,880,0,0,0,0,0,1095,192,420,10,18,1
2020,250800331,18964,2614,2614,2614,0,16350,14000,11000,3000,0,2350,1350,1000,0,6050,6050,4150,1000,2910,180,100,210,240,69
2020,250800361,74592,25792,25792,25792,0,48800,47000,27000,20000,0,1800,1300,500,0,9500,9500,9500,0,4444,600,1200,360,168,116
2020,250800391,18160,160,160,160,0,18000,5000,5000,0,0,13000,1500,0,11500,0,0,0,0,1268,244,150,360,50,16
2020,250900201,53338,3438,3438,3438,0,49900,49000,21000,28000,0,900,900,0,0,25776,8776,8000,586,4110,396,400,490,312,534
2020,250900211,43314,25314,7314,7314,18000,18000,18000,0,0,18000,0,0,0,0,100,100,0,0,1330,200,100,20,60,283
2020,250900231,18422,15422,5422,4422,10000,3000,0,0,0,0,3000,0,3000,0,5000,5000,5000,0,2796,384,60,192,120,52
2020,250900241,8347,7247,747,747,6500,1100,0,0,0,0,1100,1100,0,0,6120,6120,4600,0,1604,180,300,180,240,21
2020,250900251,13214,214,214,214,0,13000,13000,13000,0,0,0,0,0,0,0,0,0,0,2265,240,35,150,120,22
2020,250900261,3013,2843,1843,1843,1000,170,0,0,0,0,170,170,0,0,410,410,190,0,1312,300,12,230,108,11
2020,250900291,16410,4910,4910,4910,0,11500,9000,9000,0,0,2500,2500,0,0,600,600,0,0,1892,156,36,174,36,90
2020,250900311,20285,11635,11635,11635,0,8650,8000,0,8000,0,650,650,0,0,4600,4600,3700,900,2770,200,800,240,180,64
2020,250900321,28535,8265,8265,8265,0,20270,20000,20000,0,0,270,270,0,0,0,0,0,0,1375,282,50,240,84,79
2020,250900331,3899,3899,1399,1399,2500,0,0,0,0,0,0,0,0,0,150,150,0,0,1205,300,50,80,45,7
2020,250900341,42055,12618,12618,12618,0,29437,28000,28000,0,0,1437,1030,407,0,0,0,0,0,3217,350,520,360,120,263
2020,250900351,9168,7768,6768,6768,1000,1400,0,0,0,0,1400,1400,0,0,0,0,0,0,1970,120,100,260,180,121
2020,250900361,15316,6266,6266,6266,0,9050,7250,7250,0,0,1800,1800,0,0,0,0,0,0,1559,228,100,120,156,66
2020,250900371,11479,4109,4109,4109,0,7370,7000,7000,0,0,370,370,0,0,5000,5000,5000,0,2614,228,40,420,288,33
2020,250900381,23014,4464,4464,4464,0,18550,17000,17000,0,0,1550,1550,0,0,9400,9400,9400,0,2571,300,170,300,276,56
2020,250900391,42200,17300,17300,17300,0,24900,22000,22000,0,0,2900,2900,0,0,0,0,0,0,4410,500,400,400,240,445
2020,251000202,20906,15906,15406,15406,500,5000,0,0,0,0,5000,5000,0,0,8000,8000,0,8000,4236,360,60,480,96,692
2020,251000212,1100,100,100,100,0,1000,0,0,0,0,1000,1000,0,0,1100,1100,0,1100,1800,636,10,360,84,17
2020,251000232,9160,9160,4560,4560,4600,0,0,0,0,0,0,0,0,0,0,0,0,0,2270,278,1200,72,60,15
2020,251000242,10860,9560,5060,5060,4500,1300,0,0,0,0,1300,1300,0,0,1033,1033,0,0,1137,120,150,60,57,23
2020,251000262,13810,1610,1610,1610,0,12200,12000,12000,0,0,200,200,0,0,3000,3000,3000,0,986,204,20,240,72,33
2020,251000272,35300,2900,2900,2900,0,32400,30000,25000,5000,0,2400,2400,0,0,1454,1454,0,1424,4350,240,190,280,220,872
2020,251000282,31600,1600,1600,1600,0,30000,30000,30000,0,0,0,0,0,0,3800,3800,3800,0,1996,216,36,150,84,37
2020,251000302,9158,158,158,158,0,9000,9000,9000,0,0,0,0,0,0,0,0,0,0,972,160,156,48,48,11
2020,251000312,72100,15300,15300,15300,0,56800,54000,12500,41500,0,2800,2800,0,0,1000,0,0,0,3340,240,50,400,150,269
2020,251000322,16992,13643,4403,4103,9240,3349,0,0,0,0,3349,3349,0,0,8378,8378,5400,0,3330,400,264,400,276,161
2020,251000332,18900,11800,800,800,11000,7100,0,0,0,0,7100,1100,6000,0,6000,6000,6000,0,2200,150,100,300,200,66
2020,251000342,78430,7200,5000,5000,2200,71230,70000,0,70000,0,1230,1000,230,0,6000,6000,0,6000,3450,600,1350,360,360,161
2020,251000362,30950,1700,1700,1700,0,29250,26000,7000,19000,0,3250,0,3250,0,1000,1000,1000,0,1333,123,570,35,40,9
2020,251000372,33910,7960,7960,5960,0,25950,24000,14000,10000,0,1950,1950,0,0,2520,2520,2520,0,1568,238,30,230,110,46
2020,251000392,14486,3186,3186,3186,0,11300,10000,10000,0,0,1300,1300,0,0,4115,4115,4100,0,1388,212,120,156,108,72
2020,251600201,12534,12434,6934,6934,5500,100,0,0,0,0,100,100,0,0,160,160,0,0,2487,180,450,420,216,164
2020,251600211,29012,9012,9012,9012,0,20000,18000,18000,0,0,2000,2000,0,0,1300,1300,0,0,4380,600,300,600,240,123
2020,251600231,145208,22830,22830,22830,0,122378,120000,120000,0,0,2378,1700,678,0,9000,9000,8000,1000,6100,600,400,500,150,7506
2020,251600261,11000,1000,1000,1000,0,10000,10000,10000,0,0,0,0,0,0,0,0,0,0,1698,240,744,60,24,18
2020,251600281,41390,4290,4290,4290,0,37100,32600,26000,6600,0,4500,4500,0,0,9300,9300,5600,1700,4044,300,70,300,204,282
2020,251600291,201,201,2,2,199,0,0,0,0,0,0,0,0,0,0,0,0,0,628,180,0,36,12,1
2020,251600301,7015,7015,5015,5015,2000,0,0,0,0,0,0,0,0,0,0,0,0,0,1660,250,230,200,100,0
2020,251600311,40428,10928,10928,10928,0,29500,21000,21000,0,0,8500,8500,0,0,3712,3712,3712,0,9480,550,50,800,480,1334
2020,251600321,178892,19492,19492,19492,0,159400,119300,21000,95300,3000,40100,1600,38500,0,44010,44010,44000,0,4920,400,100,300,200,147
2020,251600331,6610,4610,4610,4610,0,2000,2000,2000,0,0,0,0,0,0,0,0,0,0,500,100,60,24,36,3
2020,251600351,7500,500,500,500,0,7000,7000,7000,0,0,0,0,0,0,0,0,0,0,892,204,30,30,38,8
2020,251600361,1016,15,15,15,0,1001,0,0,0,0,1001,0,1001,0,300,300,0,300,900,250,10,20,60,3
2020,251600381,10,10,10,10,0,0,0,0,0,0,0,0,0,0,5400,5400,0,4300,740,360,5,10,30,1
2020,251600391,2070,2070,270,270,1800,0,0,0,0,0,0,0,0,0,1360,1360,0,1360,1770,340,100,300,100,1
2020,251700221,15422,9422,4422,4422,5000,6000,5000,0,5000,0,1000,1000,0,0,150,150,0,0,2930,180,60,300,300,176
2020,251700231,16520,1070,1070,70,0,15450,13000,13000,0,0,2450,150,1300,1000,1800,1800,0,1800,2340,1180,200,100,100,51
2020,251700281,43310,28110,23110,23110,5000,15200,14300,0,0,14300,900,600,300,0,0,0,0,0,2082,120,150,120,72,436
2020,251700301,60560,11960,11960,11960,0,48600,48600,10000,38600,0,0,0,0,0,0,0,0,0,2142,350,500,60,132,30
2020,251700311,25500,5500,5500,5500,0,20000,20000,10000,10000,0,0,0,0,0,0,0,0,0,934,250,150,40,24,21
2020,251700321,16105,3405,3405,3405,0,12700,10000,10000,0,0,2700,2700,0,0,3820,3820,0,2500,2306,240,120,500,180,94
2020,251700331,258,258,40,40,218,0,0,0,0,0,0,0,0,0,0,0,0,0,664,180,20,20,29,0
2020,251700341,15468,8368,3568,2068,4800,7100,7000,0,7000,0,100,100,0,0,5140,4140,4140,0,2180,400,10,250,300,59
2020,251700351,24150,550,550,550,0,23600,23000,11000,12000,0,600,300,300,0,30,0,0,0,1090,120,50,240,70,13
2020,251700361,14065,12765,7265,7265,5500,1300,1000,0,1000,0,300,300,0,0,0,0,0,0,1845,240,10,72,168,50
2020,251700371,7600,100,100,100,0,7500,7500,7500,0,0,0,0,0,0,0,0,0,0,828,60,220,12,36,6
2020,251700391,67814,3764,3764,3764,0,64050,60000,20000,40000,0,4050,1050,3000,0,4000,0,0,0,4230,360,720,600,180,138
2020,251800201,23692,6542,1542,1542,5000,17150,17000,0,17000,0,150,150,0,0,0,0,0,0,2606,360,20,350,276,158
2020,251800211,31555,12355,12355,12355,0,19200,17000,17000,0,0,2200,1800,400,0,900,900,0,0,4360,360,60,480,120,86
2020,251800221,9400,8200,3000,3000,5200,1200,0,0,0,0,1200,1200,0,0,1900,1900,0,1900,1135,160,50,120,145,35
2020,251800251,33345,6445,6445,6445,0,26900,26000,26000,0,0,900,900,0,0,1200,1200,1200,0,1579,360,60,360,108,78
2020,251800281,2001,2001,1,1,2000,0,0,0,0,0,0,0,0,0,0,0,0,0,1007,120,84,12,24,9
2020,251800291,36300,7100,7100,7100,0,29200,20000,20000,0,0,9200,2100,100,7000,0,0,0,0,2180,360,200,300,120,55
2020,251800311,940,670,670,550,0,270,0,0,0,0,270,170,100,0,0,0,0,0,960,90,60,100,60,9
2020,251800341,23385,3605,3605,3605,0,19780,18000,12000,6000,0,1780,1780,0,0,8066,8066,7666,0,6560,360,40,500,320,172
2020,251800351,90660,20910,20910,20910,0,69750,69600,30000,39600,0,150,150,0,0,0,0,0,0,5400,240,100,360,360,741
2020,251800361,1270,1270,70,70,1200,0,0,0,0,0,0,0,0,0,0,0,0,0,915,240,5,120,40,1
2020,251800371,11960,760,760,760,0,11200,11000,2000,9000,0,200,0,200,0,0,0,0,0,685,300,30,20,70,16
2020,251800381,6791,2641,2641,2641,0,4150,4000,4000,0,0,150,150,0,0,500,500,0,500,1964,300,350,240,84,18
2020,251900221,786,786,786,786,0,0,0,0,0,0,0,0,0,0,500,500,0,0,1600,120,120,120,120,1
2020,251900251,472,222,22,22,200,250,0,0,0,0,250,250,0,0,5000,5000,0,5000,2765,801,180,360,168,74
2020,251900261,22660,22360,14360,14360,8000,300,0,0,0,0,300,300,0,0,0,0,0,0,2170,300,10,200,100,521
2020,251900281,12300,1300,1300,1300,0,11000,11000,11000,0,0,0,0,0,0,0,0,0,0,1078,108,70,30,90,14
2020,251900301,150,150,150,150,0,0,0,0,0,0,0,0,0,0,0,0,0,0,730,130,120,30,50,1
2020,251900321,16560,1270,1270,1270,0,15290,15200,12000,3200,0,90,90,0,0,9900,9900,9900,0,1994,360,50,250,64,19
2020,251900331,200,70,70,70,0,130,0,0,0,0,130,130,0,0,0,0,0,0,890,120,40,100,50,40
2020,251900341,163910,38510,38510,38510,0,125400,107000,40000,67000,0,18400,5400,13000,0,24000,15000,15000,0,3107,324,30,400,240,1436
2020,251900351,2550,2550,1850,1850,700,0,0,0,0,0,0,0,0,0,0,0,0,0,1001,384,10,60,36,3
2020,251900371,14205,105,105,105,0,14100,13000,13000,0,0,1100,1100,0,0,8736,8736,8736,0,1186,300,20,120,156,572
2020,251900381,2300,1100,1100,1100,0,1200,1200,1200,0,0,0,0,0,0,0,0,0,0,729,150,240,60,24,2
2020,251900391,16082,10282,10282,10282,0,5800,3500,3000,500,0,2300,2300,0,0,0,0,0,0,3455,272,50,610,270,251
2020,252000202,44600,11000,11000,11000,0,33600,33000,33000,0,0,600,500,100,0,0,0,0,0,2078,420,480,240,72,85
2020,252000222,25851,6720,6720,6720,0,19131,18000,18000,0,0,1131,450,681,0,4967,4967,4967,0,1900,240,20,240,180,84
2020,252000252,23100,100,100,100,0,23000,23000,23000,0,0,0,0,0,0,0,0,0,0,1133,180,240,60,36,35
2020,252000262,2360,2360,2160,2160,200,0,0,0,0,0,0,0,0,0,100,100,100,0,2026,300,10,60,96,1
2020,252000272,35160,31900,3900,3900,28000,3260,0,0,0,0,3260,3260,0,0,0,0,0,0,1965,240,10,350,15,773
2020,252000282,49180,2680,2680,2680,0,46500,45000,45000,0,0,1500,1000,500,0,24000,24000,24000,0,2690,300,240,240,180,88
2020,252000292,70414,13214,13214,4414,0,57200,54500,40000,14500,0,2700,2700,0,0,7500,7000,7000,0,4250,400,200,400,150,203
2020,252000302,11530,4030,30,30,4000,7500,6000,0,6000,0,1500,1500,0,0,5500,1500,1500,0,1826,300,10,500,216,108
2020,252000322,3210,1910,1910,1910,0,1300,0,0,0,0,1300,1300,0,0,0,0,0,0,1446,360,20,240,156,34
2020,252000342,40033,673,673,673,0,39360,39000,9000,30000,0,360,50,310,0,7700,7700,7200,500,3338,216,24,360,600,38
2020,252000352,14684,484,484,484,0,14200,12000,12000,0,0,2200,2200,0,0,8190,8190,5960,430,2133,240,450,220,125,21
2020,252000372,5810,10,10,10,0,5800,5500,5500,0,0,300,300,0,0,3000,3000,3000,0,659,100,114,12,55,60
2020,252000382,8580,2080,2080,2080,0,6500,6500,2500,4000,0,0,0,0,0,0,0,0,0,717,150,100,15,12,12
2020,252000392,1230,230,230,230,0,1000,1000,1000,0,0,0,0,0,0,0,0,0,0,590,180,36,12,36,2
2020,252600221,73891,18591,18591,18591,0,55300,52000,52000,0,0,3300,3300,0,0,0,0,0,0,5520,360,50,480,300,4281
2020,252600251,63380,27980,27980,26980,0,35400,32300,11000,21300,0,3100,2800,300,0,0,0,0,0,2304,780,320,300,84,328
2020,252600271,5787,5007,2007,2007,3000,780,0,0,0,0,780,780,0,0,500,500,0,0,2730,340,120,300,240,31
2020,252600311,24217,10417,10417,10117,0,13800,12000,12000,0,0,1800,1800,0,0,0,0,0,0,2420,180,180,300,120,90
2020,252600321,32100,4800,4800,4800,0,27300,27300,3300,24000,0,0,0,0,0,0,0,0,0,1220,150,480,60,60,11
2020,252600331,29500,1400,1400,1400,0,28100,28000,7000,21000,0,100,100,0,0,400,400,400,0,860,156,180,98,36,63
2020,252600341,11933,4648,4648,4648,0,7285,5000,5000,0,0,2285,2250,35,0,3394,3394,994,1000,1391,182,40,155,234,20
2020,252600351,19095,10995,10995,10695,0,8100,5700,5700,0,0,2400,2400,0,0,668,668,578,0,2672,240,250,120,312,43
2020,252600361,100,100,100,100,0,0,0,0,0,0,0,0,0,0,0,0,0,0,546,150,65,25,26,1
2020,252600371,40150,6000,6000,6000,0,34150,30000,12000,18000,0,4150,2400,1750,0,0,0,0,0,772,180,20,250,72,74
2020,252700211,9438,9248,7248,7248,2000,190,0,0,0,0,190,0,190,0,0,0,0,0,1297,216,84,60,0,2
2020,252700241,67910,19460,19460,19460,0,48450,45000,45000,0,0,3450,3300,150,0,23400,23400,21500,1900,4490,360,40,300,200,653
2020,252700291,22160,9160,9160,9160,0,13000,12000,12000,0,0,1000,600,400,0,3100,3100,3100,0,5170,360,300,600,240,497
2020,252700301,7170,170,170,170,0,7000,7000,5000,2000,0,0,0,0,0,0,0,0,0,716,144,120,24,18,4
2020,252700311,3690,490,490,490,0,3200,3000,3000,0,0,200,200,0,0,0,0,0,0,1210,250,300,200,20,21
2020,252700321,6310,110,110,110,0,6200,5600,3200,2400,0,600,0,600,0,0,0,0,0,531,120,80,40,69,5
2020,252700361,620,120,120,120,0,500,500,500,0,0,0,0,0,0,0,0,0,0,605,94,120,24,43,2
2020,252700371,4298,30,30,30,0,4268,4200,1000,3200,0,68,0,68,0,0,0,0,0,669,78,40,18,43,3
2020,252800221,45580,16270,7270,7270,9000,29310,27100,0,27100,0,2210,2210,0,0,7530,7530,6120,0,3740,280,500,480,190,500
2020,252800231,5822,2822,2322,2322,500,3000,0,0,0,0,3000,3000,0,0,2700,2700,0,2700,2226,780,40,250,120,443
2020,252800241,87340,47740,25740,24540,22000,39600,36000,0,22000,14000,3600,3600,0,0,2250,1250,0,1000,5986,1320,300,1044,324,929
2020,252800281,296808,20360,20360,20360,0,276448,272000,60000,212000,0,4448,3948,500,0,57800,38800,30300,8500,7270,520,1200,500,250,2536
2020,252800301,854,854,854,854,0,0,0,0,0,0,0,0,0,0,300,300,0,0,3750,320,480,180,60,3
2020,252800321,430400,6200,6200,6200,0,424200,406000,9000,397000,0,18200,6300,11900,0,500,500,0,500,3508,324,120,600,144,363
2020,252800341,8000,8000,1000,1000,7000,0,0,0,0,0,0,0,0,0,0,0,0,0,495,200,50,10,15,1
2020,252800351,6930,1340,1340,1340,0,5590,5550,1200,4350,0,40,0,40,0,0,0,0,0,845,108,120,60,66,5
2020,252800361,6160,1100,1100,1100,0,5060,5000,1000,4000,0,60,50,10,0,1000,1000,1000,0,699,120,36,240,42,37
2020,252800371,150,150,150,150,0,0,0,0,0,0,0,0,0,0,0,0,0,0,896,240,60,24,72,1
2020,252900211,133620,75120,75120,75120,0,58500,58500,0,58500,0,0,0,0,0,0,0,0,0,2402,370,300,10,42,270
2020,252900241,63026,12626,12626,12626,0,50400,50000,50000,0,0,400,400,0,0,500,500,500,0,4120,360,100,360,100,684
2020,252900261,5270,4620,620,620,4000,650,0,0,0,0,650,650,0,0,2136,2136,2136,0,1231,95,16,260,120,54
2020,252900271,11400,400,400,400,0,11000,11000,11000,0,0,0,0,0,0,0,0,0,0,905,150,405,10,30,12
2020,252900281,4070,4070,70,70,4000,0,0,0,0,0,0,0,0,0,25,25,0,0,1268,360,120,120,72,1
2020,252900291,4524,4524,64,64,4460,0,0,0,0,0,0,0,0,0,5350,5350,0,5300,2468,360,276,72,180,1
2020,252900301,19088,2988,2988,2988,0,16100,15800,3800,12000,0,300,300,0,0,0,0,0,0,1024,90,336,72,43,26
2020,252900311,16040,7040,7040,7040,0,9000,9000,7000,2000,0,0,0,0,0,0,0,0,0,506,150,60,30,36,30
2020,252900321,7320,1320,1320,1320,0,6000,6000,6000,0,0,0,0,0,0,0,0,0,0,806,100,40,20,36,15
2020,252900331,6850,50,50,50,0,6800,6800,6800,0,0,0,0,0,0,0,0,0,0,487,180,72,15,0,8
2020,252900341,18,18,18,18,0,0,0,0,0,0,0,0,0,0,0,0,0,0,468,72,48,15,48,0
2020,252900351,7745,445,445,445,0,7300,6000,6000,0,0,1300,1300,0,0,1500,1500,1500,0,2220,100,100,200,250,28
2020,252900371,3750,3500,3500,3500,0,250,0,0,0,0,250,250,0,0,0,0,0,0,995,120,5,150,130,21
2020,253000202,33461,61,61,61,0,33400,28400,28000,400,0,5000,2000,3000,0,18100,18100,16000,0,3000,350,120,850,250,90
2020,253000232,13760,560,60,60,500,13200,11500,0,11500,0,1700,1300,400,0,5000,5000,2000,3000,3924,420,150,480,360,41
2020,253600201,86904,56104,56104,56104,0,30800,30000,18000,12000,0,800,300,500,0,0,0,0,0,4490,200,150,360,180,1392
2020,260000202,77400,13700,13700,13700,0,63700,58500,29500,29000,0,5200,4550,650,0,1300,100,0,0,5204,480,800,360,240,511
2020,260000222,64811,38300,38300,38300,0,26511,26000,16000,10000,0,511,511,0,0,2981,2981,2981,0,1514,264,30,200,200,1314
2020,260000232,57934,6834,6834,6834,0,51100,47000,37000,10000,0,4100,3800,300,0,5500,5000,0,5000,2467,216,120,240,156,1451
2020,260000242,26330,6030,6030,6030,0,20300,20000,20000,0,0,300,300,0,0,18000,18000,17000,1000,2646,300,50,180,144,77
2020,260000252,8960,8000,4000,4000,4000,960,0,0,0,0,960,960,0,0,0,0,0,0,2748,480,50,230,168,18
2020,260000262,1150,800,400,400,400,350,0,0,0,0,350,350,0,0,0,0,0,0,987,216,30,160,36,6
2020,260000272,134093,49893,14393,14393,35500,84200,82000,0,60000,22000,2200,2200,0,0,56000,20000,20000,0,7500,600,200,400,400,1915
2020,260000282,170100,80100,80100,80100,0,90000,90000,75000,15000,0,0,0,0,0,0,0,0,0,15962,840,50,1200,72,21805
2020,260000312,10620,20,20,20,0,10600,10000,10000,0,0,600,600,0,0,6770,6770,6760,0,2786,360,120,240,360,130
2020,260000322,100,100,100,100,0,0,0,0,0,0,0,0,0,0,0,0,0,0,696,240,120,60,36,1
2020,260000332,11396,1396,1396,1396,0,10000,10000,10000,0,0,0,0,0,0,0,0,0,0,902,74,20,120,228,28
2020,260000342,16986,7686,7686,7686,0,9300,9000,7000,2000,0,300,300,0,0,0,0,0,0,4093,340,120,576,282,343
2020,260000352,2594,2594,2594,2594,0,0,0,0,0,0,0,0,0,0,0,0,0,0,1098,300,290,70,42,2
2020,260000362,16670,670,670,670,0,16000,16000,11000,5000,0,0,0,0,0,0,0,0,0,1662,108,1000,200,46,18
2020,260000372,1880,1130,1130,130,0,750,0,0,0,0,750,250,500,0,0,0,0,0,1408,24,50,240,84,27
2020,260000382,40454,5754,5754,5754,0,34700,33750,0,33750,0,950,950,0,0,20000,0,0,0,3362,392,10,480,120,2012
2020,260000392,48640,1940,1940,1940,0,46700,40000,20000,20000,0,6700,3500,3000,200,6000,6000,5000,0,2212,300,120,240,84,65
2020,260600241,29062,7630,7630,7630,0,21432,17000,17000,0,0,4432,4432,0,0,3500,3500,900,0,3050,180,50,240,180,168
2020,260600261,34848,34480,4480,4480,30000,368,0,0,0,0,368,300,68,0,9300,9300,9300,0,1630,180,40,240,120,8
2020,260600311,12230,230,230,230,0,12000,12000,12000,0,0,0,0,0,0,0,0,0,0,506,36,300,10,20,6
2020,260600321,810,170,170,170,0,640,0,0,0,0,640,640,0,0,0,0,0,0,1344,0,50,540,84,59
2020,260600341,9414,7014,3214,3214,3800,2400,0,0,0,0,2400,2400,0,0,5900,5900,2660,800,4506,408,50,800,156,113
2020,260600361,298,298,18,18,280,0,0,0,0,0,0,0,0,0,0,0,0,0,417,110,80,24,10,1
2020,260600371,7190,150,150,150,0,7040,7000,7000,0,0,40,0,40,0,1450,1450,1450,0,474,84,50,24,36,5
2020,260600381,46310,60,60,60,0,46250,46000,46000,0,0,250,0,250,0,37400,32400,30400,2000,2804,1240,360,110,150,202
2020,260600391,18030,18030,30,30,18000,0,0,0,0,0,0,0,0,0,0,0,0,0,826,168,120,10,36,11
2020,260700211,54700,8300,8300,8300,0,46400,45000,45000,0,0,1400,1400,0,0,1000,0,0,0,2290,240,180,260,120,86
2020,260700231,66610,810,810,810,0,65800,64000,40000,24000,0,1800,1600,200,0,16650,7650,4000,3500,3046,216,200,200,185,245
2020,260700241,73864,25064,25064,25064,0,48800,47000,47000,0,0,1800,1800,0,0,0,0,0,0,4800,400,350,200,400,161
2020,260700251,2400,2400,400,400,2000,0,0,0,0,0,0,0,0,0,0,0,0,0,774,60,450,10,36,1
2020,260700261,52980,10880,10880,10880,0,42100,41000,41000,0,0,1100,800,300,0,22000,14800,14800,0,2870,500,80,250,220,347
2020,260700271,66461,2261,2261,2261,0,64200,64000,24000,40000,0,200,200,0,0,20560,20060,20000,0,1530,200,150,60,50,112
2020,260700281,58822,9922,9922,9922,0,48900,47000,24000,23000,0,1900,1900,0,0,13700,13700,13700,0,4220,240,260,240,240,978
2020,260700291,34816,12316,12316,12316,0,22500,21300,21000,300,0,1200,850,350,0,1510,1510,0,1510,3260,360,50,200,240,1601
2020,260700311,5208,5208,208,208,5000,0,0,0,0,0,0,0,0,0,0,0,0,0,696,96,0,0,60,1
2020,260700331,22505,1505,1505,1505,0,21000,19000,19000,0,0,2000,2000,0,0,0,0,0,0,4480,360,500,240,180,915
2020,260700341,9366,4366,4366,3066,0,5000,5000,5000,0,0,0,0,0,0,0,0,0,0,612,56,60,60,36,6
2020,260700351,210,210,10,10,200,0,0,0,0,0,0,0,0,0,1000,1000,0,0,532,202,84,54,36,1
2020,260700361,10160,460,460,460,0,9700,9700,9700,0,0,0,0,0,0,0,0,0,0,1106,120,380,72,24,13
2020,260700371,25320,5320,5320,5020,0,20000,20000,20000,0,0,0,0,0,0,1000,1000,1000,0,2339,384,80,150,150,65
2020,260700381,96770,7820,7820,7820,0,88950,88000,38000,50000,0,950,650,300,0,13000,11000,11000,0,3290,280,120,320,180,186
2020,260700391,40345,17745,17645,6645,100,22600,9000,0,9000,0,13600,1600,6000,6000,12200,4200,3700,0,2255,480,84,216,240,88
2020,260800201,32915,15,15,15,0,32900,31800,31800,0,0,1100,1100,0,0,36000,17400,12000,0,1246,120,500,100,96,130
2020,260800231,68326,14876,14876,14876,0,53450,53000,53000,0,0,450,400,50,0,24000,24000,24000,0,5080,600,30,360,240,1960
2020,260800291,99800,14200,14200,14200,0,85600,84000,30000,54000,0,1600,1400,200,0,3700,3200,3000,200,2346,216,10,520,120,332
2020,260800301,6140,1740,1740,1740,0,4400,3500,3500,0,0,900,900,0,0,0,0,0,0,1815,280,520,700,55,27
2020,260800311,4400,400,400,400,0,4000,4000,4000,0,0,0,0,0,0,0,0,0,0,456,136,120,36,24,5
2020,260800341,10822,2438,2438,2438,0,8384,7500,7500,0,0,884,850,34,0,0,0,0,0,1504,144,250,300,300,48
2020,260800351,4700,100,100,100,0,4600,4600,4000,600,0,0,0,0,0,0,0,0,0,320,40,30,10,40,4
2020,260800361,74094,9094,9094,9094,0,65000,20000,16000,4000,0,45000,2000,43000,0,24500,24500,4500,0,1828,156,176,240,216,106
2020,260800371,115020,6420,6420,6420,0,108600,65000,5000,60000,0,43600,1600,42000,0,19000,19000,15000,4000,2992,228,120,300,264,85
2020,260800381,11050,50,50,50,0,11000,11000,11000,0,0,0,0,0,0,0,0,0,0,360,180,50,10,30,10
2020,260900201,4832,4832,4332,4332,500,0,0,0,0,0,0,0,0,0,0,0,0,0,1449,247,450,120,132,2
2020,260900221,6101,6101,101,101,6000,0,0,0,0,0,0,0,0,0,4300,4300,4300,0,1440,100,10,60,150,1
2020,260900231,6590,6590,6590,6590,0,0,0,0,0,0,0,0,0,0,0,0,0,0,2851,300,350,240,220,1
2020,260900241,20204,3204,3204,3204,0,17000,17000,17000,0,0,0,0,0,0,0,0,0,0,1372,200,360,50,96,29
2020,260900251,21300,20300,300,300,20000,1000,0,0,0,0,1000,1000,0,0,11700,11700,10000,1700,2988,300,120,360,240,49
2020,260900261,484,285,45,45,240,199,0,0,0,0,199,199,0,0,0,0,0,0,953,144,12,72,15,7
2020,260900271,482,382,152,152,230,100,0,0,0,0,100,100,0,0,0,0,0,0,1256,180,300,180,76,1
2020,260900281,31931,3431,3431,3431,0,28500,27000,27000,0,0,1500,1500,0,0,0,0,0,0,2800,240,30,130,200,75
2020,260900301,54100,4100,100,100,4000,50000,50000,0,50000,0,0,0,0,0,23000,18000,18000,0,1251,60,1,180,360,62
2020,260900311,8113,2613,2613,2613,0,5500,5500,5500,0,0,0,0,0,0,2620,2620,700,0,1449,276,120,4,84,36
2020,260900331,224826,11626,11626,11626,0,213200,212000,40000,165000,7000,1200,1200,0,0,84000,84000,60000,20000,5300,720,70,430,400,1842
2020,260900341,40520,11510,11510,10510,0,29010,25000,17000,8000,0,4010,1310,1500,1200,510,510,0,0,6032,752,500,720,360,445
2020,260900351,31724,6174,6174,6174,0,25550,25000,25000,0,0,550,550,0,0,2400,2400,0,2400,3738,256,290,510,428,130
2020,260900361,59925,23899,23899,23899,0,36026,35000,23000,12000,0,1026,300,726,0,0,0,0,0,1554,120,120,360,60,51
2020,260900371,256856,8356,8356,7816,0,248500,242400,100000,136400,6000,6100,5900,200,0,73300,63000,42000,21000,8094,480,50,700,360,2450
2020,260900381,15150,900,900,900,0,14250,14000,14000,0,0,250,250,0,0,230,230,0,0,3979,264,300,150,180,301
2020,260900391,29258,14858,14858,14858,0,14400,13500,13500,0,0,900,900,0,0,1000,1000,0,1000,5673,300,100,240,120,284
2020,261000202,191300,80700,80700,80700,0,110600,110000,30000,80000,0,600,500,100,0,400,0,0,0,3600,420,1000,360,180,346
2020,261000212,111840,62640,62640,62640,0,49200,47000,33000,14000,0,2200,1200,1000,0,9000,0,0,0,5839,360,15,300,384,3089
2020,261000222,29455,1955,1955,1955,0,27500,27000,27000,0,0,500,400,100,0,3700,3700,0,3700,2149,144,75,240,120,48
2020,261000232,15630,630,630,630,0,15000,15000,15000,0,0,0,0,0,0,0,0,0,0,1220,240,70,20,70,11
2020,261000242,106020,1020,1020,1020,0,105000,105000,55000,50000,0,0,0,0,0,1030,30,0,0,1096,220,120,36,60,167
2020,261000262,14943,12143,2143,2143,10000,2800,0,0,0,0,2800,2600,200,0,0,0,0,0,1548,180,250,80,240,214
2020,261000272,21750,1250,1250,1250,0,20500,20500,20000,500,0,0,0,0,0,5800,5000,0,0,2010,868,470,72,30,13
2020,261000282,10510,110,110,110,0,10400,10400,10400,0,0,0,0,0,0,0,0,0,0,1300,100,30,50,120,31
2020,261000302,23310,540,540,540,0,22770,21300,19500,1800,0,1470,1470,0,0,900,900,0,0,3361,825,1232,360,84,18
2020,261000312,322,322,22,22,300,0,0,0,0,0,0,0,0,0,0,0,0,0,1308,280,103,156,105,1
2020,261000322,3011,11,11,11,0,3000,3000,3000,0,0,0,0,0,0,1000,1000,1000,0,566,60,36,15,70,4
2020,261000332,14360,10092,10092,10092,0,4268,4000,4000,0,0,268,200,68,0,180,180,0,0,2682,318,726,225,96,51
2020,261000342,95880,38295,25195,25195,13100,57585,55200,0,55200,0,2385,2272,113,0,9000,2000,0,2000,7932,444,216,492,187,1248
2020,261000352,31930,19930,4980,4980,14950,12000,10000,0,10000,0,2000,2000,0,0,5880,5880,5500,200,2541,276,120,240,240,182
2020,261000362,10138,1670,1670,1670,0,8468,6000,6000,0,0,2468,2400,68,0,2983,2983,1100,0,1735,100,120,360,95,6
2020,261000372,9900,1250,1250,1250,0,8650,8000,5000,3000,0,650,350,300,0,0,0,0,0,1566,592,30,240,104,10
2020,261000382,4852,652,652,652,0,4200,4000,4000,0,0,200,0,200,0,0,0,0,0,1189,134,250,96,120,3
2020,261000392,656,656,656,656,0,0,0,0,0,0,0,0,0,0,0,0,0,0,441,136,30,30,15,1
2020,261600211,15780,3750,3750,3750,0,12030,12000,12000,0,0,30,0,30,0,1150,1150,1150,0,1700,140,600,120,240,208
2020,261600231,40150,30850,30850,5850,0,9300,8000,8000,0,0,1300,1300,0,0,0,0,0,0,1650,200,450,160,40,140
2020,261600251,94000,31000,31000,31000,0,63000,45000,45000,0,0,18000,18000,0,0,0,0,0,0,4900,480,500,700,120,209
2020,261600271,16816,5816,5816,5816,0,11000,10000,10000,0,0,1000,1000,0,0,0,0,0,0,2514,165,700,360,79,30
2020,261600281,45660,14810,10810,3810,4000,30850,30000,0,30000,0,850,850,0,0,13400,9400,9400,0,2196,216,10,420,240,155
2020,261600291,29080,27030,7030,7030,20000,2050,0,0,0,0,2050,2050,0,0,0,0,0,0,1805,200,20,240,150,79
2020,261600311,112974,11236,11236,11236,0,101738,91000,20000,71000,0,10738,8220,2518,0,12000,12000,12000,0,5900,720,500,620,360,243
2020,261600321,30006,2406,2406,2406,0,27600,25000,25000,0,0,2600,2300,300,0,7520,7520,6020,1500,2468,270,50,552,192,140
2020,261600361,13795,4495,4495,4495,0,9300,8400,2500,5900,0,900,710,190,0,0,0,0,0,1217,176,96,216,48,15
2020,261600371,132515,30555,30555,30555,0,101960,98000,0,78000,20000,3960,320,3640,0,0,0,0,0,5765,480,20,540,240,455
2020,261600391,12647,11157,7157,7157,4000,1490,0,0,0,0,1490,1400,90,0,320,320,0,0,1794,120,20,490,132,38
2020,261700201,47642,9572,9572,9572,0,38070,37000,37000,0,0,1070,550,520,0,18300,18300,18300,0,2720,300,40,500,120,110
2020,261700211,830,830,330,330,500,0,0,0,0,0,0,0,0,0,1000,1000,0,0,1965,480,5,60,120,148
2020,261700241,30,30,30,30,0,0,0,0,0,0,0,0,0,0,0,0,0,0,395,60,100,20,15,1
2020,261700261,1010,1010,50,50,960,0,0,0,0,0,0,0,0,0,0,0,0,0,1335,228,360,72,115,2
2020,261700271,18758,5138,5138,5138,0,13620,11500,11500,0,0,2120,2120,0,0,6920,6920,6520,0,2460,180,60,120,360,49
2020,261700281,112600,600,600,600,0,112000,111000,0,111000,0,1000,1000,0,0,95500,11000,7000,0,1320,120,350,180,60,207
2020,261700301,23460,8960,8960,8960,0,14500,11000,9000,0,2000,3500,1400,2100,0,1000,1000,0,1000,2747,204,5,250,180,98
2020,261700311,13040,2060,2060,2060,0,10980,9000,9000,0,0,1980,900,1080,0,4780,4780,4780,0,1140,280,10,228,120,20
2020,261700321,63684,38264,38264,38264,0,25420,25000,17000,8000,0,420,320,100,0,3050,3050,3000,0,5110,960,200,480,300,1125
2020,261700331,33209,8279,8279,8279,0,24930,22200,17000,5200,0,2730,2680,50,0,0,0,0,0,2011,243,150,300,108,176
2020,261700341,7481,6981,2681,2681,4300,500,0,0,0,0,500,500,0,0,7850,7850,3000,1800,2521,216,300,460,311,1
2020,261700351,27348,14668,14668,13668,0,12680,11000,11000,0,0,1680,1680,0,0,0,0,0,0,3794,723,202,512,248,103
2020,261700371,6091,430,430,430,0,5661,5500,5500,0,0,161,0,161,0,1700,1700,1700,0,495,90,50,10,18,6
2020,261800211,292,292,292,292,0,0,0,0,0,0,0,0,0,0,0,0,0,0,1250,600,10,10,30,1
2020,261800221,37092,22092,22092,22092,0,15000,14000,14000,0,0,1000,1000,0,0,1800,1800,1800,0,4100,240,210,720,480,1473
2020,261800231,11680,303,303,3,0,11377,10500,10500,0,0,877,877,0,0,9320,9320,6320,3000,2164,132,0,1080,192,99
2020,261800241,33670,14840,13840,12840,1000,18830,17000,0,17000,0,1830,330,0,1500,0,0,0,0,4904,2780,144,240,120,97
2020,261800261,26344,344,344,344,0,26000,26000,26000,0,0,0,0,0,0,0,0,0,0,1805,100,1000,120,25,22
2020,261800271,30170,7640,7640,7640,0,22530,22000,20000,2000,0,530,410,120,0,20,20,0,0,2360,380,220,250,120,57
2020,261800281,33300,300,300,300,0,33000,30000,30000,0,0,3000,3000,0,0,0,0,0,0,1673,150,100,143,100,209
2020,261800321,15113,9083,9033,2033,50,6030,6000,0,6000,0,30,30,0,0,6260,6260,6000,170,1576,422,32,205,120,24
2020,261800331,18893,15193,13393,13193,1800,3700,0,0,0,0,3700,250,450,3000,0,0,0,0,823,204,3,360,96,89
2020,261800341,15120,4230,3730,3730,500,10890,10000,0,10000,0,890,850,40,0,4650,4650,500,4150,2366,450,10,120,120,63
2020,261800351,424,394,119,119,275,30,0,0,0,0,30,30,0,0,500,500,0,0,2335,312,250,156,204,14
2020,261800361,22902,5372,5372,5372,0,17530,13500,3500,10000,0,4030,930,3100,0,2172,2172,2172,0,2460,240,120,360,300,371
2020,261800391,323,323,323,323,0,0,0,0,0,0,0,0,0,0,0,0,0,0,573,142,120,16,15,0
2020,261900201,1230,1230,30,30,1200,0,0,0,0,0,0,0,0,0,600,600,0,0,1060,250,100,30,150,1
2020,261900211,2550,2050,50,50,2000,500,0,0,0,0,500,0,0,500,0,0,0,0,525,180,30,30,15,1
2020,261900221,40,40,10,10,30,0,0,0,0,0,0,0,0,0,0,0,0,0,930,300,120,15,15,1
2020,261900231,25351,9851,9851,9851,0,15500,15000,15000,0,0,500,500,0,0,0,0,0,0,1037,93,193,60,72,116
2020,261900261,10260,6860,6360,5360,500,3400,0,0,0,0,3400,900,0,2500,3292,3292,0,2500,3006,1056,10,200,180,42
2020,261900281,28490,9240,6240,6240,3000,19250,18000,0,18000,0,1250,800,450,0,1000,0,0,0,4872,240,200,360,132,786
2020,261900301,23390,1140,1140,1140,0,22250,22000,8000,14000,0,250,250,0,0,0,0,0,0,1258,168,70,290,42,73
2020,261900311,3038,2988,2988,1988,0,50,0,0,0,0,50,50,0,0,0,0,0,0,3525,1602,50,684,120,90
2020,261900321,1008,898,898,898,0,110,0,0,0,0,110,110,0,0,0,0,0,0,1731,384,260,137,150,12
2020,261900331,52095,4745,4745,4745,0,47350,47350,7200,40150,0,0,0,0,0,450,450,450,0,997,106,220,60,35,27
2020,261900341,22440,3990,3990,3990,0,18450,18000,18000,0,0,450,450,0,0,9100,9100,9100,0,4406,276,240,480,480,311
2020,261900351,20698,1730,1730,1730,0,18968,18000,18000,0,0,968,900,68,0,3298,3298,3228,0,2989,240,500,204,100,102
2020,261900361,22854,6754,6754,6754,0,16100,13300,1300,12000,0,2800,0,2800,0,0,0,0,0,1408,108,600,156,24,2
2020,261900371,28050,1450,1450,1450,0,26600,26500,2500,24000,0,100,0,100,0,0,0,0,0,1404,65,930,35,54,5
2020,261900381,8518,3768,3768,3768,0,4750,4500,0,4500,0,250,0,250,0,2500,2500,2200,300,566,104,94,20,46,13
2020,262000302,4906,1030,1030,1030,0,3876,3000,2100,900,0,876,650,226,0,0,0,0,0,1474,136,120,300,108,111
2020,262000312,6841,4841,4841,4841,0,2000,2000,2000,0,0,0,0,0,0,0,0,0,0,647,50,150,5,12,2
2020,262000322,28624,6784,6784,6784,0,21840,18500,18500,0,0,3340,3340,0,0,1500,1500,1500,0,1930,180,80,100,320,63
2020,262000332,2600,200,200,200,0,2400,2400,1500,900,0,0,0,0,0,0,0,0,0,682,126,86,40,40,3
2020,262000352,2526,26,26,26,0,2500,2500,2500,0,0,0,0,0,0,0,0,0,0,366,65,24,11,24,3
2020,262000372,43632,15080,15080,15080,0,28552,27500,10000,17500,0,1052,600,452,0,25,25,0,0,1670,160,60,240,180,37
2020,262600301,34678,1591,1591,1591,0,33087,33000,6000,27000,0,87,0,87,0,0,0,0,0,1731,118,1160,24,6,15
2020,262600321,4690,2922,2922,2922,0,1768,0,0,0,0,1768,1700,68,0,1278,1278,0,0,2058,172,528,125,120,63
2020,262600341,20,20,20,20,0,0,0,0,0,0,0,0,0,0,3000,3000,0,0,1200,180,100,30,60,41
2020,262600351,11325,2725,2725,1625,0,8600,3200,500,2700,0,5400,500,4900,0,9600,9600,0,8300,1125,140,10,210,110,7
2020,262600361,41282,6682,6682,6682,0,34600,33000,10000,23000,0,1600,600,1000,0,0,0,0,0,1068,72,96,260,40,46
2020,262600371,217996,17896,17896,17896,0,200100,194000,19000,175000,0,6100,6100,0,0,58150,58150,58150,0,6024,240,100,1000,372,3956
2020,262700321,1350,1350,1350,1350,0,0,0,0,0,0,0,0,0,0,0,0,0,0,464,120,78,27,32,1
2020,262700331,11480,4140,4140,4140,0,7340,7000,7000,0,0,340,160,180,0,1900,1900,0,1900,643,133,50,65,65,31
2020,262700341,192056,8436,8436,8436,0,183620,123920,30000,93920,0,59700,4700,55000,0,18200,18200,18200,0,4538,334,50,720,258,221
2020,262700361,10361,7091,5091,5091,2000,3270,2450,0,2450,0,820,670,150,0,3000,3000,0,3000,5400,840,360,720,360,408
2020,262700371,5424,1424,1424,1424,0,4000,4000,0,4000,0,0,0,0,0,0,0,0,0,576,116,60,20,60,3
2020,262800301,79862,9982,9982,9982,0,69880,54000,3000,51000,0,15880,1340,14540,0,14600,14600,14600,0,2670,135,265,950,100,66
2020,262800311,71969,11969,11969,11449,0,60000,47300,20000,27300,0,12700,2200,10500,0,16000,16000,16000,0,6546,570,176,460,270,198
2020,262800321,52556,8138,8138,8138,0,44418,42900,2700,40200,0,1518,1400,118,0,14000,14000,14000,0,1543,156,240,270,120,31
2020,262800341,14269,14269,8269,8269,6000,0,0,0,0,0,0,0,0,0,0,0,0,0,1926,516,800,100,60,1
2020,262800351,23970,3994,3994,3994,0,19976,9500,6500,3000,0,10476,5200,5276,0,2100,2100,0,1500,4356,360,300,600,300,244
2020,262800361,27880,6880,6880,6880,0,21000,10500,7000,3500,0,10500,2300,5700,2500,3450,3450,2000,0,1740,210,50,450,144,42
2020,262800371,47856,9956,9956,9956,0,37900,19000,19000,0,0,18900,3500,15400,0,28692,28692,27000,0,2419,148,30,540,220,28
2020,262900301,29065,5290,5290,5290,0,23775,23100,6000,17100,0,675,0,675,0,5000,5000,0,5000,668,60,230,50,36,16
2020,262900311,2103,50,50,50,0,2053,2000,2000,0,0,53,0,53,0,0,0,0,0,396,65,81,52,30,2
2020,262900321,12830,530,530,530,0,12300,12300,3000,9300,0,0,0,0,0,0,0,0,0,1092,84,686,30,24,6
2020,262900331,21487,2635,2635,2459,0,18852,17800,17800,0,0,1052,600,452,0,0,0,0,0,2871,205,62,248,190,129
2020,262900341,83153,14703,14703,12703,0,68450,55000,8000,47000,0,13450,950,11000,1500,2000,0,0,0,2990,360,240,600,180,93
2020,262900351,76265,4000,4000,4000,0,72265,66415,10000,56415,0,5850,2000,3850,0,0,0,0,0,1016,333,120,144,89,274
2020,262900361,53677,3177,3177,3177,0,50500,50000,15000,35000,0,500,200,300,0,36000,36000,36000,0,2292,144,180,100,288,232
2020,262900371,18690,310,310,310,0,18380,17080,5600,11480,0,1300,1300,0,0,0,0,0,0,1320,112,340,150,72,26
2020,270000302,3240,3040,40,40,3000,200,0,0,0,0,200,100,100,0,2500,2500,0,2500,3730,240,600,600,240,78
2020,270000312,3430,430,430,430,0,3000,3000,3000,0,0,0,0,0,0,0,0,0,0,2482,192,240,200,300,5
2020,270000322,30,30,30,30,0,0,0,0,0,0,0,0,0,0,0,0,0,0,247,12,90,1,12,1
2020,270000332,9635,230,230,230,0,9405,9325,4500,4825,0,80,0,80,0,0,0,0,0,525,166,60,12,13,5
2020,270000352,123112,41412,41412,40412,0,81700,79000,28000,51000,0,2700,2500,200,0,27150,11150,11000,150,7796,624,1000,360,192,2522
2020,270000372,57800,25800,25800,20800,0,32000,26000,23500,2500,0,6000,5000,1000,0,10000,8000,0,0,2940,360,180,240,120,275
2020,270000382,29897,3984,3984,2984,0,25913,25500,13500,12000,0,413,300,113,0,14000,11000,8000,3000,2862,360,150,360,122,768
2020,270000392,36090,200,200,200,0,35890,35840,8040,27800,0,50,0,50,0,0,0,0,0,1092,112,60,100,60,13
2020,270600331,874,874,674,674,200,0,0,0,0,0,0,0,0,0,0,0,0,0,968,300,150,12,60,1
2020,270600341,6920,3910,910,110,3000,3010,0,0,0,0,3010,2000,210,800,770,770,0,0,2000,216,30,480,216,225
2020,270600351,12860,7410,7410,7410,0,5450,4000,4000,0,0,1450,1450,0,0,2756,2756,756,0,4405,370,500,384,144,63
2020,270600371,1230,1230,1230,1230,0,0,0,0,0,0,0,0,0,0,0,0,0,0,1094,244,300,70,60,4
2020,270700311,8105,1560,1560,1560,0,6545,5500,5500,0,0,1045,1000,45,0,0,0,0,0,1053,140,296,360,59,11
2020,270700321,7214,698,698,698,0,6516,5668,5500,168,0,848,800,48,0,0,0,0,0,2440,210,80,480,180,127
2020,270700331,21006,6506,6506,6506,0,14500,12000,8000,4000,0,2500,2500,0,0,0,0,0,0,1652,168,80,380,84,288
2020,270700341,22672,2872,2872,2872,0,19800,19800,19800,0,0,0,0,0,0,14100,14100,14000,0,1896,360,364,180,66,51
2020,270700351,14372,14172,4172,4172,10000,200,0,0,0,0,200,200,0,0,170,170,0,0,4550,720,500,300,130,280
2020,270700361,305,305,5,5,300,0,0,0,0,0,0,0,0,0,0,0,0,0,452,300,10,10,12,1
2020,270700371,19380,5880,5880,5880,0,13500,13000,13000,0,0,500,500,0,0,0,0,0,0,1640,250,250,220,80,91
2020,270700381,18805,805,805,805,0,18000,18000,18000,0,0,0,0,0,0,10000,10000,10000,0,1210,260,70,50,95,82
2020,270700391,10926,8500,7500,7500,1000,2426,0,0,0,0,2426,200,2226,0,1000,1000,0,1000,1022,240,100,120,60,9
2020,270800311,11216,3716,3716,3716,0,7500,6000,6000,0,0,1500,1500,0,0,7624,7624,6730,0,3470,280,20,360,180,114
2020,270800321,44844,5844,5844,5844,0,39000,34000,23000,11000,0,5000,5000,0,0,21310,13310,13310,0,4060,470,100,500,240,929
2020,270800331,24210,2910,2910,2910,0,21300,21000,21000,0,0,300,300,0,0,0,0,0,0,2646,100,72,240,144,709
2020,270800341,30930,1952,1952,1952,0,28978,27000,27000,0,0,1978,1300,678,0,0,0,0,0,2290,240,100,400,150,109
2020,270800361,21940,8740,8740,8440,0,13200,9000,9000,0,0,4200,2800,1100,300,0,0,0,0,4640,480,300,600,360,147
2020,270800371,14200,1700,1700,1700,0,12500,12000,12000,0,0,500,500,0,0,0,0,0,0,2410,120,60,360,120,44
2020,270800381,5870,5870,2570,2570,3300,0,0,0,0,0,0,0,0,0,200,200,200,0,376,50,126,30,13,1
2020,270900321,63442,4142,4142,4142,0,59300,58800,6000,40000,12800,500,200,300,0,8000,8000,8000,0,2574,240,180,540,96,58
2020,270900341,7378,5878,3066,3066,2812,1500,0,0,0,0,1500,1500,0,0,2660,2660,1960,0,2026,360,10,260,20,46
2020,270900351,29338,7138,7138,7138,0,22200,21000,14000,7000,0,1200,700,500,0,0,0,0,0,1749,264,144,180,148,66
2020,270900361,131165,365,365,365,0,130800,80700,1700,79000,0,50100,100,50000,0,41800,41800,25800,0,1900,72,30,960,360,77
2020,270900371,117588,25048,23548,23548,1500,92540,92000,0,92000,0,540,40,500,0,0,0,0,0,2392,196,340,156,50,397
2020,270900381,57915,9528,9528,6528,0,48387,45500,3500,42000,0,2887,900,987,1000,900,900,0,900,2090,76,62,576,168,34
2020,271000302,77176,1776,1776,1776,0,75400,75400,6000,69400,0,0,0,0,0,3000,0,0,0,1016,86,100,40,50,45
2020,271000312,8440,6740,2440,2440,4300,1700,0,0,0,0,1700,1700,0,0,0,0,0,0,1164,120,8,210,36,64
2020,271000322,262080,182080,182080,182080,0,80000,65000,16000,49000,0,15000,7000,8000,0,2000,2000,0,2000,5040,150,300,500,100,562
2020,271000332,2000,2000,2000,2000,0,0,0,0,0,0,0,0,0,0,0,0,0,0,1476,360,120,30,54,97
2020,271000342,226,226,26,26,200,0,0,0,0,0,0,0,0,0,15,15,0,0,1605,420,5,120,120,1
2020,271000352,6746,5666,4666,4166,1000,1080,0,0,0,0,1080,580,500,0,3600,3600,2700,0,3389,636,50,240,153,73
2020,271000372,17250,1250,1250,1250,0,16000,14000,14000,0,0,2000,200,1800,0,16664,16664,11664,0,4605,430,20,100,130,724
2020,271000382,77540,58040,58040,48040,0,19500,15000,15000,0,0,4500,4500,0,0,0,0,0,0,6626,800,200,410,276,1629
2020,271600301,27750,8650,8650,7650,0,19100,18000,15000,3000,0,1100,500,300,300,0,0,0,0,3318,948,10,240,180,101
2020,271600311,8500,500,500,500,0,8000,8000,8000,0,0,0,0,0,0,0,0,0,0,1200,240,150,30,30,13
2020,271600321,11980,1900,1900,1900,0,10080,10000,10000,0,0,80,0,80,0,0,0,0,0,1020,110,20,120,30,17
2020,271600351,153135,20735,5735,3235,15000,132400,101000,0,101000,0,31400,7400,24000,0,39000,26000,26000,0,3920,270,1200,360,240,215
2020,271600371,7464,2734,2734,2734,0,4730,4000,4000,0,0,730,730,0,0,530,530,0,0,1112,100,12,40,60,129
2020,271600391,60090,8000,8000,8000,0,52090,52000,8000,44000,0,90,0,90,0,1000,0,0,0,810,160,72,36,42,52
2020,271700341,100,100,100,100,0,0,0,0,0,0,0,0,0,0,0,0,0,0,533,57,36,18,42,1
2020,271700381,26583,433,433,433,0,26150,24000,17000,7000,0,2150,400,1750,0,1000,1000,0,1000,1940,250,50,200,60,17
2020,271700391,100192,7242,7242,7242,0,92950,91000,6000,85000,0,1950,1500,450,0,65000,15000,14000,1000,1601,165,20,100,96,138
2020,271800311,45180,8230,8230,8230,0,36950,36900,4800,32100,0,50,0,50,0,0,0,0,0,1122,117,400,30,35,20
2020,271800351,3110,510,510,510,0,2600,2000,2000,0,0,600,100,500,0,0,0,0,0,570,91,60,60,31,6
2020,271800361,30607,15455,15455,15455,0,15152,13000,13000,0,0,2152,1700,452,0,72,72,0,0,4450,200,200,400,250,243
2020,271800371,7100,100,100,100,0,7000,7000,7000,0,0,0,0,0,0,0,0,0,0,1393,120,1000,100,48,10
2020,271800381,27278,19332,5832,5832,13500,7946,0,0,0,0,7946,2720,226,5000,670,670,300,300,4051,204,120,650,90,54
2020,271800391,1710,1710,10,10,1700,0,0,0,0,0,0,0,0,0,0,0,0,0,409,100,0,15,24,0
2020,271900321,17510,1310,1310,810,0,16200,16000,16000,0,0,200,200,0,0,0,0,0,0,3100,940,150,250,140,319
2020,271900331,8750,350,350,350,0,8400,7000,7000,0,0,1400,1400,0,0,9700,9700,6500,0,2120,360,250,600,140,86
2020,271900351,105600,105300,104300,4300,1000,300,0,0,0,0,300,0,300,0,0,0,0,0,1464,444,10,200,100,21
2020,271900371,48500,6400,6400,6400,0,42100,41000,7000,34000,0,1100,0,1100,0,0,0,0,0,1472,156,96,30,0,70
2020,271900381,41950,6150,6150,6150,0,35800,30000,5000,25000,0,5800,2300,3500,0,10000,10000,10000,0,1910,490,240,360,120,75
2020,271900391,140,140,140,140,0,0,0,0,0,0,0,0,0,0,0,0,0,0,414,160,35,0,12,1
2020,272000302,8250,2200,2200,2200,0,6050,6000,6000,0,0,50,50,0,0,0,0,0,0,983,123,30,180,90,86
2020,272000322,33204,888,888,888,0,32316,27000,27000,0,0,5316,5000,316,0,15200,15200,14000,0,2698,312,22,408,276,68
2020,272000332,6095,95,95,95,0,6000,6000,6000,0,0,0,0,0,0,1900,1900,1900,0,1339,99,15,60,101,26
2020,272000342,47450,5100,5100,5100,0,42350,33000,10000,23000,0,9350,2850,6500,0,0,0,0,0,2800,200,50,600,350,106
2020,272000352,40100,4800,4800,4800,0,35300,35000,5000,30000,0,300,0,300,0,0,0,0,0,975,200,100,100,50,14
2020,272000362,15950,6100,6100,6100,0,9850,9300,2100,7200,0,550,450,100,0,0,0,0,0,1245,180,360,210,130,29
2020,272000372,9120,9120,8620,7820,500,0,0,0,0,0,0,0,0,0,3400,3400,1300,2000,1110,360,50,100,70,100
2020,272000382,2950,2950,950,950,2000,0,0,0,0,0,0,0,0,0,1000,1000,0,1000,1855,965,50,40,60,38
2020,272600321,56530,4430,4430,4430,0,52100,52000,16000,36000,0,100,100,0,0,2248,1248,0,0,2906,276,200,336,288,173
2020,272600341,9200,8900,400,400,8500,300,0,0,0,0,300,300,0,0,4500,4500,4500,0,1310,240,120,120,150,9
2020,272600361,33040,24430,24430,24430,0,8610,6600,6600,0,0,2010,710,1300,0,0,0,0,0,3306,360,250,800,216,74
2020,272600371,7840,2840,2840,2840,0,5000,5000,5000,0,0,0,0,0,0,0,0,0,0,1943,153,1240,20,10,6
2020,272700301,10550,450,450,450,0,10100,10000,10000,0,0,100,0,100,0,0,0,0,0,514,120,20,10,24,6
2020,272700331,28417,12767,12767,12767,0,15650,15000,8000,7000,0,650,600,50,0,0,0,0,0,3500,200,1200,250,150,247
2020,272700371,7700,200,200,200,0,7500,7500,7500,0,0,0,0,0,0,0,0,0,0,2368,220,1400,100,18,6
2020,272700381,29650,2650,2650,2650,0,27000,26000,26000,0,0,1000,1000,0,0,12415,12415,12415,0,3760,360,60,240,240,285
2020,272800301,100,100,100,100,0,0,0,0,0,0,0,0,0,0,0,0,0,0,1205,120,5,120,120,39
2020,272800311,2430,1630,1630,1630,0,800,0,0,0,0,800,800,0,0,220,220,0,200,1417,120,50,120,120,16
2020,272800321,30253,90,90,90,0,30163,28000,28000,0,0,2163,2050,113,0,21319,21319,19400,0,4840,216,110,240,228,49
2020,272800331,32888,4650,4650,4650,0,28238,28170,7170,21000,0,68,0,68,0,2000,2000,2000,0,1958,142,500,150,36,17
2020,272800341,5053,4013,4013,4013,0,1040,500,0,500,0,540,500,40,0,0,0,0,0,488,90,20,120,60,35
2020,272800351,28946,4546,4546,4546,0,24400,22000,22000,0,0,2400,2300,100,0,14640,14640,14640,0,4156,336,20,360,240,311
2020,272800371,6100,1300,1300,1300,0,4800,4800,4800,0,0,0,0,0,0,0,0,0,0,1040,130,120,35,40,18
2020,272900301,18850,550,550,550,0,18300,18000,18000,0,0,300,200,100,0,0,0,0,0,2360,300,240,240,120,103
2020,272900311,99000,4100,4100,4100,0,94900,93000,18000,75000,0,1900,1900,0,0,78250,73000,73000,0,4140,300,100,300,240,980
2020,272900331,363,263,63,63,200,100,0,0,0,0,100,100,0,0,0,0,0,0,2520,650,45,75,100,15
2020,272900371,200,200,200,200,0,0,0,0,0,0,0,0,0,0,0,0,0,0,278,84,10,10,14,1
2020,280000302,14286,1786,1786,1786,0,12500,12000,12000,0,0,500,500,0,0,5100,5100,5100,0,2879,360,442,355,275,39
2020,280000312,8570,570,570,570,0,8000,8000,8000,0,0,0,0,0,0,0,0,0,0,1177,240,20,32,40,14
2020,280000322,10997,9007,5007,5007,4000,1990,0,0,0,0,1990,1990,0,0,0,0,0,0,1577,210,1,240,96,145
2020,280000342,22909,17368,4368,3368,13000,5541,2275,0,2275,0,3266,2500,766,0,7030,7030,7000,0,2794,258,175,326,228,47
2020,280000352,19954,1374,1374,1374,0,18580,17000,17000,0,0,1580,1580,0,0,12500,12500,12500,0,3457,180,160,600,204,179
2020,280000362,23182,766,766,766,0,22416,19000,19000,0,0,3416,3400,16,0,9650,9650,6000,2000,2001,268,30,240,228,145
2020,280000382,40070,1870,1870,1870,0,38200,38000,19000,19000,0,200,200,0,0,0,0,0,0,1090,180,10,120,60,71
2020,280600311,23506,5506,5506,3206,0,18000,18000,18000,0,0,0,0,0,0,300,0,0,0,1358,220,257,21,60,43
2020,280600321,17992,2712,2712,2712,0,15280,15050,12000,3050,0,230,230,0,0,0,0,0,0,1416,168,12,264,60,47
2020,280600331,20672,20462,20462,20462,0,210,0,0,0,0,210,0,210,0,300,300,100,0,3294,360,120,120,144,71
2020,280600341,69404,28544,28544,28544,0,40860,39000,39000,0,0,1860,560,1300,0,0,0,0,0,3482,184,200,420,180,167
2020,280600351,142736,17010,17010,17010,0,125726,118000,30000,88000,0,7726,7500,226,0,102500,92500,87000,5500,5100,470,30,600,300,7877
2020,280600361,62119,26036,26036,26036,0,36083,35000,20000,15000,0,1083,1000,83,0,1000,0,0,0,3708,162,740,180,144,521
2020,280600371,28950,7050,7050,7050,0,21900,19000,19000,0,0,2900,2600,300,0,17850,17850,8700,8000,3710,300,600,480,240,619
2020,280600381,113200,5000,5000,5000,0,108200,101000,0,101000,0,7200,3200,4000,0,21900,21900,2500,17000,2738,600,1000,360,48,117
2020,280700341,2179,2179,79,79,2100,0,0,0,0,0,0,0,0,0,500,500,500,0,998,312,95,60,26,1
2020,280700351,23011,8601,8601,8601,0,14410,14000,10000,4000,0,410,410,0,0,2100,2100,2000,0,1896,286,120,450,180,108
2020,280700391,285923,7895,7895,7895,0,278028,270000,70000,200000,0,8028,4500,3528,0,90000,49000,49000,0,5544,360,2000,500,84,1069
2020,280800301,59383,5257,5257,5257,0,54126,51000,51000,0,0,3126,2900,226,0,22384,9984,2000,7984,4646,366,250,550,308,414
2020,280800321,27348,2348,2348,2348,0,25000,25000,4000,21000,0,0,0,0,0,0,0,0,0,1074,82,120,10,60,12
2020,280800331,5573,50,50,50,0,5523,5500,5500,0,0,23,0,23,0,0,0,0,0,682,104,300,5,13,15
2020,280800341,81608,21640,21640,16340,0,59968,36500,28000,8500,0,23468,900,22568,0,17150,17150,17000,150,2736,624,74,190,360,159
2020,280800361,51056,4506,4506,4506,0,46550,45000,25000,0,20000,1550,1550,0,0,10050,10050,0,0,4126,260,50,556,360,1381
2020,280800371,37792,9412,9412,9412,0,28380,23000,23000,0,0,5380,5200,180,0,14720,14720,13500,1000,5030,360,60,120,132,262
2020,280900301,12581,2581,2581,2581,0,10000,10000,10000,0,0,0,0,0,0,0,0,0,0,1266,180,136,72,36,49
2020,280900311,305,305,305,305,0,0,0,0,0,0,0,0,0,0,0,0,0,0,1993,660,60,240,96,271
2020,280900331,25208,9258,9258,9258,0,15950,13000,7000,0,6000,2950,2500,450,0,15,15,0,0,1827,153,40,300,199,61
2020,280900341,20835,2385,2385,2385,0,18450,18000,13000,5000,0,450,450,0,0,0,0,0,0,1266,144,50,480,60,45
2020,280900351,16265,9665,9665,9665,0,6600,5000,0,5000,0,1600,600,1000,0,450,450,0,400,2556,144,200,360,240,44
2020,280900371,140632,1862,1862,1862,0,138770,118500,14000,104500,0,20270,270,20000,0,22200,22000,22000,0,1778,318,130,210,100,197
2020,280900391,22032,6342,6342,1342,0,15690,13000,13000,0,0,2690,690,2000,0,11240,11240,10400,0,4550,300,10,240,300,91
2020,281000302,12255,10555,555,555,10000,1700,0,0,0,0,1700,1700,0,0,650,650,650,0,1763,198,55,80,200,69
2020,281000312,46452,7426,7426,4426,0,39026,33300,13300,20000,0,5726,5500,226,0,20,20,0,0,1310,150,20,180,110,124
2020,281000362,608,558,58,58,500,50,0,0,0,0,50,50,0,0,3520,3520,0,3520,4230,583,700,255,420,85
2020,281000372,7200,180,180,180,0,7020,7000,7000,0,0,20,20,0,0,1000,1000,1000,0,2200,240,70,150,100,55
2020,281000382,35604,304,304,304,0,35300,35300,35000,300,0,0,0,0,0,20000,8000,8000,0,383,130,40,24,50,33
2020,281000392,17727,4447,4447,4447,0,13280,13000,13000,0,0,280,140,140,0,0,0,0,0,1490,248,58,240,60,64
2020,281600301,45535,17615,17615,17615,0,27920,25000,16000,9000,0,2920,2800,120,0,0,0,0,0,1954,234,180,120,180,227
2020,281600311,79900,21170,21170,14670,0,58730,48500,30500,18000,0,10230,1730,4500,4000,29900,29900,16900,13000,5990,360,450,600,300,1095
2020,281600331,26262,1812,1812,1812,0,24450,23000,23000,0,0,1450,1450,0,0,5950,5950,5900,0,2508,240,100,220,196,74
2020,281600341,36710,5190,5190,5190,0,31520,30000,30000,0,0,1520,880,640,0,2070,370,0,0,1426,120,120,174,86,64
2020,281600351,10172,9142,7142,7142,2000,1030,0,0,0,0,1030,930,100,0,3250,3250,1700,850,1752,180,72,180,210,25
2020,281600391,77094,7964,7964,7964,0,69130,68000,68000,0,0,1130,0,1130,0,3300,0,0,0,3950,200,53,120,240,429
2020,281700301,60078,2827,2827,2827,0,57251,55000,36000,19000,0,2251,2000,251,0,24942,11942,9742,2200,3968,180,35,420,204,80
2020,281700311,17203,4120,4120,4120,0,13083,13000,13000,0,0,83,0,83,0,1474,1474,1000,0,2394,192,100,180,144,53
2020,281700341,40873,1710,1710,1710,0,39163,31800,6500,25300,0,7363,2200,2163,3000,15500,1500,1500,0,1538,130,454,24,88,51
2020,281700351,23590,4370,4370,4370,0,19220,18000,18000,0,0,1220,1100,120,0,1800,1800,1800,0,3374,290,80,345,200,220
2020,281700381,14160,7660,7660,7660,0,6500,6500,6500,0,0,0,0,0,0,0,0,0,0,1150,200,60,60,100,13
2020,281700391,48280,9580,9580,9580,0,38700,35900,35000,900,0,2800,2400,400,0,0,0,0,0,2880,240,60,200,240,138
2020,281800301,442,442,442,442,0,0,0,0,0,0,0,0,0,0,0,0,0,0,670,180,200,80,50,1
2020,281800311,9748,1948,1948,1948,0,7800,7000,7000,0,0,800,800,0,0,350,350,250,0,3152,202,80,240,240,28
2020,281800361,101324,10308,10308,10308,0,91016,88000,23000,65000,0,3016,1690,1326,0,33570,28570,28570,0,6180,420,1000,320,360,672
2020,281800371,57153,20001,20001,19501,0,37152,35000,23000,12000,0,2152,1700,452,0,0,0,0,0,4907,252,950,356,360,300
2020,281800381,18420,8030,8030,8030,0,10390,10000,10000,0,0,390,390,0,0,440,440,0,360,3110,220,250,200,480,400
2020,281800391,32450,3250,3250,3250,0,29200,28500,24500,4000,0,700,600,100,0,4960,4960,4760,0,4600,250,10,360,300,204
2020,281900301,63810,31160,31160,28160,0,32650,13000,13000,0,0,19650,8650,6000,5000,10000,10000,10000,0,5370,240,150,720,360,494
2020,281900321,658,658,158,158,500,0,0,0,0,0,0,0,0,0,836,836,0,836,2262,520,50,60,294,1
2020,281900371,7682,7582,5582,5482,2000,100,0,0,0,0,100,50,50,0,0,0,0,0,1670,300,60,120,110,23
2020,281900381,21200,6540,6540,6540,0,14660,13000,13000,0,0,1660,1480,180,0,12291,12291,11300,831,3112,224,58,340,340,180
2020,281900391,2180,2080,80,80,2000,100,0,0,0,0,100,0,100,0,1000,1000,0,0,814,225,15,25,60,1
2020,282000312,48310,11310,11310,11310,0,37000,27500,18000,9500,0,9500,2300,7200,0,4800,4800,2800,0,6073,780,360,600,300,318
2020,282000322,16040,3440,3440,3440,0,12600,12000,12000,0,0,600,600,0,0,3300,3300,3200,0,4950,240,240,480,480,278
2020,282000332,20024,8324,8324,8324,0,11700,11500,11500,0,0,200,200,0,0,0,0,0,0,1141,120,240,120,36,21
2020,282000342,110960,16860,16860,16860,0,94100,88000,38000,50000,0,6100,6100,0,0,34770,31770,27400,0,3558,396,10,720,360,160
2020,282000352,26510,9570,9570,9570,0,16940,15500,15000,500,0,1440,1440,0,0,500,0,0,0,3233,295,360,960,72,107
2020,282000362,53214,26501,26501,17501,0,26713,24500,12500,12000,0,2213,2100,113,0,0,0,0,0,4590,215,96,540,96,267
2020,282000372,21384,7386,7386,7386,0,13998,12500,12500,0,0,1498,1498,0,0,8670,8670,8640,0,1806,210,20,96,192,22
2020,282000382,5400,200,200,200,0,5200,5200,5200,0,0,0,0,0,0,0,0,0,0,1538,120,680,20,36,6
2020,282000392,300,300,300,300,0,0,0,0,0,0,0,0,0,0,0,0,0,0,863,144,230,20,16,1
2020,282600301,50975,34005,34005,14005,0,16970,14000,14000,0,0,2970,2670,300,0,0,0,0,0,4240,250,30,320,200,418
2020,282600311,32176,3776,3776,3776,0,28400,25000,23000,2000,0,3400,3400,0,0,12774,12774,10534,0,2926,460,96,540,180,1269
2020,282600321,64081,21371,21371,21371,0,42710,42000,21000,21000,0,710,710,0,0,13400,13400,13400,0,4116,240,300,480,156,2217
2020,282600331,160304,37404,37404,37404,0,122900,107000,52000,55000,0,15900,9500,6400,0,31700,30700,30700,0,4934,340,400,700,84,853
2020,282600341,150,100,100,100,0,50,0,0,0,0,50,0,50,0,250,250,0,0,1800,240,10,60,120,1
2020,282600351,104808,1088,1088,1088,0,103720,102000,32000,70000,0,1720,1600,120,0,19000,5000,5000,0,1780,340,120,240,96,143
2020,282600361,28204,6694,6694,6694,0,21510,19200,11200,8000,0,2310,1160,1150,0,100,100,0,0,7191,488,1370,250,290,158
2020,282600371,50,50,50,50,0,0,0,0,0,0,0,0,0,0,0,0,0,0,370,100,48,15,15,18
2020,282600381,250,230,230,230,0,20,0,0,0,0,20,0,20,0,0,0,0,0,1724,200,0,240,84,1
2020,282600391,19900,11900,11900,2900,0,8000,8000,8000,0,0,0,0,0,0,5020,5020,4532,488,3120,250,250,300,150,44
2020,282700301,44080,23500,5500,5000,18000,20580,8000,0,8000,0,12580,5580,7000,0,1200,1200,0,0,7650,950,400,200,500,413
2020,282700321,42995,3800,3800,3800,0,39195,39000,23000,16000,0,195,195,0,0,0,0,0,0,4874,228,180,200,216,1046
2020,282700341,25215,170,170,170,0,25045,25000,25000,0,0,45,0,45,0,1000,0,0,0,1375,130,320,120,60,28
2020,282700371,5707,507,507,507,0,5200,5000,5000,0,0,200,200,0,0,0,0,0,0,1097,96,60,120,79,18
2020,282700381,2212,2032,2032,2032,0,180,0,0,0,0,180,180,0,0,0,0,0,0,835,70,180,48,48,4
2020,282800311,6750,5960,2960,2960,3000,790,0,0,0,0,790,790,0,0,245,245,210,0,2675,120,700,480,180,31
2020,282800321,1310,1300,300,300,1000,10,0,0,0,0,10,0,10,0,0,0,0,0,1140,300,60,30,60,1
2020,282800331,42207,19901,19901,19901,0,22306,20200,20200,0,0,2106,2106,0,0,0,0,0,0,6099,495,200,396,315,1047
2020,282800351,35499,5939,5939,5939,0,29560,26200,4600,21600,0,3360,1520,1840,0,6380,6380,5580,500,4602,664,40,360,288,53
2020,282800361,2690,30,30,30,0,2660,2600,2600,0,0,60,0,60,0,0,0,0,0,869,136,50,30,41,4
2020,282800371,16112,3870,3870,3870,0,12242,12000,12000,0,0,242,60,182,0,0,0,0,0,3374,210,10,480,300,35
2020,282800391,27500,3780,3780,3780,0,23720,23500,2000,21500,0,220,100,120,0,0,0,0,0,2654,350,280,240,84,178
2020,282900301,8369,8369,1869,1869,6500,0,0,0,0,0,0,0,0,0,0,0,0,0,1817,348,70,92,232,27
2020,282900331,68220,22250,22250,22250,0,45970,45500,25500,20000,0,470,470,0,0,200,0,0,0,1072,200,240,36,36,250
2020,282900351,6280,1100,1100,1100,0,5180,5000,5000,0,0,180,180,0,0,0,0,0,0,1113,86,240,180,53,23
2020,282900361,14871,2071,2071,2071,0,12800,11500,5000,6500,0,1300,1300,0,0,6000,6000,5000,1000,2508,218,1300,120,57,10
2020,282900371,1029,1029,1029,1029,0,0,0,0,0,0,0,0,0,0,0,0,0,0,1570,360,240,60,40,2
2020,282900381,27957,5777,5777,5777,0,22180,20000,20000,0,0,2180,630,1550,0,13578,13578,12648,400,2670,200,450,200,150,72
2020,282900391,287,127,127,127,0,160,160,0,160,0,0,0,0,0,0,0,0,0,767,143,80,15,26,1
2020,283000302,21300,13000,13000,8000,0,8300,7000,7000,0,0,1300,1300,0,0,0,0,0,0,4736,250,1200,450,296,519
2020,283000312,2146,1026,1026,1026,0,1120,1120,0,1120,0,0,0,0,0,0,0,0,0,543,85,70,30,43,2
2020,283000322,9060,2300,2300,2300,0,6760,6160,5000,1160,0,600,600,0,0,0,0,0,0,1567,146,100,200,133,14
2020,283700301,815,335,335,335,0,480,0,0,0,0,480,80,400,0,70,70,0,0,1266,210,96,240,90,32
2020,283700311,5862,1962,1962,1962,0,3900,3500,0,3500,0,400,400,0,0,0,0,0,0,681,65,130,120,84,13
2020,283800301,6010,10,10,10,0,6000,6000,6000,0,0,0,0,0,0,0,0,0,0,413,68,35,14,34,6
2020,283900301,12944,4794,4794,4794,0,8150,8000,4000,4000,0,150,0,150,0,0,0,0,0,892,92,120,60,40,4
2020,290000202,26967,6317,6317,6240,0,20650,20000,20000,0,0,650,650,0,0,800,800,0,0,6627,420,50,660,720,302
2020,290000212,1020,1020,20,20,1000,0,0,0,0,0,0,0,0,0,0,0,0,0,1025,660,12,30,36,0
2020,290000232,8680,5180,5180,5180,0,3500,3500,3500,0,0,0,0,0,0,0,0,0,0,1267,300,310,72,102,3
2020,290000252,16,16,16,16,0,0,0,0,0,0,0,0,0,0,0,0,0,0,427,120,40,10,36,1
2020,290000262,70,70,70,70,0,0,0,0,0,0,0,0,0,0,0,0,0,0,637,160,60,96,6,1
2020,290000282,103327,32527,19527,19527,13000,70800,70000,0,70000,0,800,500,300,0,48000,8000,0,8000,5880,360,300,360,180,609
2020,290000292,30779,15779,3779,3779,12000,15000,12000,0,0,12000,3000,3000,0,0,13200,13200,0,12800,2200,240,100,150,250,738
2020,290000312,360,110,110,110,0,250,0,0,0,0,250,250,0,0,0,0,0,0,2990,200,50,400,240,13
2020,290000332,6756,4456,4456,3956,0,2300,0,0,0,0,2300,800,0,1500,370,370,0,70,2906,226,30,360,120,41
2020,290000342,2868,2568,2068,2068,500,300,0,0,0,0,300,300,0,0,0,0,0,0,2270,300,600,180,120,6
2020,290000352,45720,16720,16220,16220,500,29000,29000,0,29000,0,0,0,0,0,14000,0,0,0,1934,84,10,180,120,424
2020,290000362,19691,18891,3891,3891,15000,800,0,0,0,0,800,800,0,0,12000,12000,12000,0,2810,500,120,180,300,61
2020,290000382,83000,18500,18500,18500,0,64500,63000,43000,20000,0,1500,1500,0,0,200,0,0,0,6586,250,36,300,240,1001
2020,290600201,153850,26000,26000,26000,0,127850,122000,16000,106000,0,5850,1650,4200,0,40,0,0,0,2219,320,12,45,42,165
2020,290600311,12516,12516,11496,11496,1020,0,0,0,0,0,0,0,0,0,0,0,0,0,915,120,25,0,30,17
2020,290600321,84798,10198,10198,10198,0,74600,65000,35000,0,30000,9600,7100,2500,0,11737,11737,11736,1,6525,478,120,1520,552,131
2020,290600341,1742,1242,1242,1242,0,500,0,0,0,0,500,500,0,0,500,500,500,0,1551,386,240,300,60,4
2020,290600351,24191,4691,4691,4691,0,19500,18000,15000,3000,0,1500,1500,0,0,900,900,0,900,4316,666,100,240,360,27
2020,290600371,10492,7492,2492,2492,5000,3000,0,0,0,0,3000,3000,0,0,1260,1260,0,1260,3144,1440,36,300,480,236
2020,290600381,230480,7120,7120,7120,0,223360,210000,0,210000,0,13360,1660,1200,10500,3000,2500,0,2500,4583,183,100,300,240,159
2020,290600391,635,35,35,35,0,600,0,0,0,0,600,600,0,0,0,0,0,0,1306,360,120,120,84,41
2020,290700201,30187,157,157,157,0,30030,30000,10000,20000,0,30,0,30,0,0,0,0,0,974,301,120,84,60,46
2020,290700211,24004,9604,2604,2604,7000,14400,13600,0,13600,0,800,800,0,0,1900,1900,0,1900,2287,360,240,300,132,104
2020,290700241,29961,27961,9961,9961,18000,2000,0,0,0,0,2000,2000,0,0,300,300,0,0,2005,245,20,45,288,296
2020,290700301,15231,3531,3531,3531,0,11700,11700,11700,0,0,0,0,0,0,0,0,0,0,1238,540,110,30,50,10
2020,290700341,26732,1232,1232,1232,0,25500,25000,25000,0,0,500,500,0,0,1050,1000,1000,0,1160,420,100,60,60,27
2020,290700351,15279,12179,4379,4379,7800,3100,0,0,0,0,3100,3100,0,0,6030,6030,5000,930,1944,530,30,180,384,32
2020,290700361,107700,49900,49900,47900,0,57800,57500,30000,24000,3500,300,300,0,0,8900,7400,7400,0,4520,320,200,400,400,318
2020,290700391,23348,5568,5568,5568,0,17780,16000,16000,0,0,1780,1580,200,0,2000,2000,0,2000,1866,150,60,180,96,32
2020,290800201,10584,2784,2784,2784,0,7800,7000,7000,0,0,800,800,0,0,0,0,0,0,1580,240,120,360,60,44
2020,290800231,19300,2700,2700,2700,0,16600,16600,15000,1600,0,0,0,0,0,0,0,0,0,796,280,20,10,36,17
2020,290800241,27687,6888,6888,6888,0,20799,14000,14000,0,0,6799,6500,299,0,4000,4000,4000,0,2434,240,200,300,144,81
2020,290800251,15510,2500,2500,2500,0,13010,13000,13000,0,0,10,0,10,0,0,0,0,0,615,200,40,20,45,40
2020,290800261,52070,2470,2470,2470,0,49600,37000,12000,25000,0,12600,7600,5000,0,28900,28900,25000,0,6151,300,120,1464,360,84
2020,290800311,42150,500,500,500,0,41650,40000,15000,25000,0,1650,1150,500,0,0,0,0,0,1554,240,120,180,90,44
2020,290800341,35848,3548,3548,3548,0,32300,26000,21000,5000,0,6300,1300,5000,0,14900,14900,10000,4000,5925,800,100,600,600,418
2020,290800361,11838,2700,2700,2700,0,9138,9138,9000,138,0,0,0,0,0,0,0,0,0,896,60,150,0,30,6
2020,290800391,2587,2587,1587,1587,1000,0,0,0,0,0,0,0,0,0,0,0,0,0,1233,720,5,72,36,2
2020,290900201,32229,1660,1660,1660,0,30569,28000,19000,9000,0,2569,2500,69,0,14520,9520,6496,3024,5640,480,300,720,300,229
2020,290900211,40297,13997,13997,13997,0,26300,17000,17000,0,0,9300,2300,7000,0,0,0,0,0,4000,240,100,400,40,332
2020,290900221,34309,1709,1709,1709,0,32600,32500,30500,2000,0,100,0,100,0,6000,0,0,0,1863,300,36,240,72,33
2020,290900241,135800,2800,2800,2800,0,133000,125000,25000,100000,0,8000,0,8000,0,0,0,0,0,747,144,75,100,48,46
2020,290900261,60910,12960,12960,12960,0,47950,47500,8000,39500,0,450,450,0,0,1107,1107,1107,0,2274,360,24,420,120,88
2020,290900281,68243,18243,18243,18243,0,50000,47000,47000,0,0,3000,3000,0,0,3812,3812,3812,0,1986,216,150,300,100,393
2020,290900291,45225,4725,4725,4725,0,40500,40000,40000,0,0,500,500,0,0,400,400,0,200,3634,240,10,600,144,252
2020,290900311,35218,3318,3318,3318,0,31900,30000,30000,0,0,1900,900,1000,0,1000,1000,0,1000,3089,194,660,288,252,23
2020,290900321,50480,14330,14330,13330,0,36150,35000,35000,0,0,1150,650,0,500,1650,1500,1500,0,3432,610,120,180,204,90
2020,290900351,210800,4300,4300,4300,0,206500,205000,60000,145000,0,1500,1500,0,0,6000,0,0,0,6010,400,700,250,120,505
2020,290900361,5018,1668,1668,1668,0,3350,0,0,0,0,3350,3350,0,0,1545,1545,0,0,2748,180,100,138,204,73
2020,290900371,9431,3431,1631,131,1800,6000,0,0,0,0,6000,0,3000,3000,4200,4200,1500,2700,3762,432,40,120,324,123
2020,291000202,29221,27821,15821,15821,12000,1400,0,0,0,0,1400,1400,0,0,4540,4540,0,4540,4565,624,100,290,480,659
2020,291000212,97248,10698,10698,10698,0,86550,85000,80000,5000,0,1550,1550,0,0,4700,4700,0,4700,3691,300,286,600,240,600
2020,291000302,10300,300,300,300,0,10000,10000,10000,0,0,0,0,0,0,0,0,0,0,708,36,400,0,12,14
2020,291000312,200,200,200,200,0,0,0,0,0,0,0,0,0,0,0,0,0,0,1126,76,340,0,0,19
2020,291000322,316,266,6,6,260,50,0,0,0,0,50,0,50,0,800,800,0,0,860,56,25,15,42,1
2020,291000332,1670,170,30,30,140,1500,0,0,0,0,1500,1500,0,0,0,0,0,0,981,144,10,192,84,57
2020,291000342,71120,40420,520,520,39900,30700,30000,0,30000,0,700,700,0,0,37000,17000,17000,0,3490,300,120,300,180,130
2020,291000352,14830,14280,4280,4280,10000,550,0,0,0,0,550,550,0,0,10000,10000,0,10000,1640,360,10,12,156,12
2020,291600311,1320,120,120,120,0,1200,0,0,0,0,1200,200,1000,0,0,0,0,0,448,83,180,60,36,56
2020,291600331,21432,5932,5932,2932,0,15500,15000,15000,0,0,500,500,0,0,4100,4100,3700,400,3048,480,360,480,108,28
2020,291700311,18960,15160,8160,8160,7000,3800,2000,0,2000,0,1800,1800,0,0,0,0,0,0,3640,780,10,960,240,128
2020,291700321,85928,1928,1928,1928,0,84000,82000,22000,60000,0,2000,2000,0,0,1450,1350,0,1350,6255,271,50,380,444,64
2020,291700331,110518,22738,22738,22738,0,87780,83000,30000,53000,0,4780,3580,1200,0,11242,11242,10000,0,5035,320,400,600,300,1163
2020,291700341,74700,46000,6000,6000,40000,28700,28000,0,28000,0,700,700,0,0,9000,0,0,0,2880,360,240,360,120,300
2020,291800201,16000,3000,3000,3000,0,13000,13000,13000,0,0,0,0,0,0,0,0,0,0,441,120,30,15,20,10
2020,291800221,14950,450,450,450,0,14500,12500,12500,0,0,2000,2000,0,0,1140,1140,0,1140,736,216,60,40,0,24
2020,291800241,3183,2783,183,183,2600,400,0,0,0,0,400,400,0,0,4380,4380,2300,0,1870,470,50,120,130,26
2020,291800251,1116,316,16,16,300,800,0,0,0,0,800,800,0,0,1620,1620,0,0,1602,240,300,350,102,41
2020,291800291,26264,6100,6100,6100,0,20164,20000,20000,0,0,164,164,0,0,0,0,0,0,2662,120,2132,30,84,22
2020,291800311,273217,2992,2992,2992,0,270225,176825,43000,133825,0,93400,3400,90000,0,201800,201800,200000,1800,5058,132,50,588,388,375
2020,291800321,3296,1996,1996,1996,0,1300,0,0,0,0,1300,1300,0,0,600,600,0,0,308,60,10,60,48,6
2020,291800331,32150,21150,18150,16150,3000,11000,0,0,0,0,11000,4000,5000,2000,0,0,0,0,7110,480,10,780,480,5078
2020,291800341,81485,1065,1065,1065,0,80420,80000,50000,30000,0,420,0,420,0,0,0,0,0,846,150,50,50,36,144
2020,291900211,56180,2030,2030,2030,0,54150,50000,50000,0,0,4150,4150,0,0,9526,9526,9500,0,2880,264,60,360,264,500
2020,291900221,56566,6266,6266,5666,0,50300,48000,48000,0,0,2300,2300,0,0,18000,18000,17300,0,3644,460,60,240,144,138
2020,291900231,47770,10900,10900,10900,0,36870,35000,30000,5000,0,1870,1800,70,0,0,0,0,0,2004,244,40,300,150,147
2020,291900301,181600,80100,80100,80100,0,101500,100000,100000,0,0,1500,1500,0,0,60750,60750,60000,0,2310,380,120,120,140,64
2020,291900321,11150,1150,1150,1150,0,10000,10000,10000,0,0,0,0,0,0,0,0,0,0,483,56,100,10,22,5
2020,291900331,27074,2374,2374,2374,0,24700,23000,11000,12000,0,1700,150,1550,0,5000,5000,5000,0,2897,147,120,550,200,99
2020,291900341,44170,11470,11470,11470,0,32700,32000,32000,0,0,700,700,0,0,0,0,0,0,3233,228,60,240,120,72
2020,292800211,13930,888,888,888,0,13042,13000,13000,0,0,42,0,42,0,0,0,0,0,911,117,120,240,62,4
2020,292800261,503590,7990,7990,7990,0,495600,470000,70000,400000,0,25600,15600,10000,0,53800,41800,36000,0,3310,300,100,240,300,3420
2020,293800201,50,50,50,50,0,0,0,0,0,0,0,0,0,0,0,0,0,0,372,120,60,20,12,1
2020,293800261,24567,4567,4567,4567,0,20000,20000,20000,0,0,0,0,0,0,5320,5320,5320,0,2086,330,100,220,170,63
2020,293800281,140680,42880,13880,13880,29000,97800,90000,0,90000,0,7800,3200,600,4000,3000,0,0,0,6290,420,100,1200,380,111
2020,294800201,155420,9920,9920,9920,0,145500,145000,85000,60000,0,500,500,0,0,39500,29500,29300,200,6078,700,100,300,148,2812
2020,294800211,400,400,100,100,300,0,0,0,0,0,0,0,0,0,0,0,0,0,596,180,25,72,17,1
2020,294800231,30622,29290,6290,6290,23000,1332,0,0,0,0,1332,1250,82,0,5000,5000,0,5000,4590,420,500,360,180,387
2020,294800261,100168,9168,9168,8468,0,91000,87000,80000,7000,0,4000,4000,0,0,4900,2900,0,2900,5204,1170,200,400,312,1568
2020,295800231,65173,8693,8693,8693,0,56480,56000,40000,16000,0,480,480,0,0,7580,7580,7580,0,3620,720,400,400,300,376
2020,295800251,65370,518,518,518,0,64852,60000,60000,0,0,4852,4400,452,0,19643,19643,19523,120,1690,180,80,160,180,163
2020,295800271,53748,38548,13548,4548,25000,15200,12000,0,12000,0,3200,3200,0,0,8400,0,0,0,2910,360,150,204,240,645
2020,310000102,92040,12840,2840,2840,10000,79200,77500,0,77500,0,1700,1700,0,0,36050,5550,5550,0,3420,1180,150,360,150,243
2020,310000132,21300,17500,2500,2500,15000,3800,0,0,0,0,3800,800,3000,0,0,0,0,0,3270,600,200,750,200,91
2020,310000152,528,528,28,28,500,0,0,0,0,0,0,0,0,0,492,492,492,0,1690,420,40,120,80,1
2020,310000182,42380,300,300,300,0,42080,42000,42000,0,0,80,0,80,0,18450,18450,18450,0,2845,300,400,360,90,107
2020,310000212,203,203,3,3,200,0,0,0,0,0,0,0,0,0,6240,6240,0,650,1300,381,10,60,120,0
2020,310000232,26532,2981,2981,2981,0,23551,23500,23500,0,0,51,0,51,0,0,0,0,0,1349,234,16,98,64,29
2020,310000282,32670,170,170,170,0,32500,30000,30000,0,0,2500,2500,0,0,0,0,0,0,1506,216,60,180,100,128
2020,310000292,42155,1605,1605,1605,0,40550,38800,29800,9000,0,1750,1500,250,0,0,0,0,0,2680,240,180,420,480,1630
2020,310000312,52958,2758,2758,2758,0,50200,49000,49000,0,0,1200,1200,0,0,18833,18833,17500,0,4114,1440,120,490,324,97
2020,310000332,1650,700,0,0,700,950,0,0,0,0,950,950,0,0,600,600,0,600,2090,312,10,300,48,28
2020,310000342,10120,10008,2008,2008,8000,112,0,0,0,0,112,112,0,0,2000,2000,0,2000,1950,300,50,280,150,47
2020,310000352,22250,250,250,250,0,22000,22000,22000,0,0,0,0,0,0,0,0,0,0,1554,276,10,36,42,40
2020,310000362,2150,2000,1000,1000,1000,150,0,0,0,0,150,150,0,0,0,0,0,0,2705,770,50,350,180,27
2020,310000372,25355,25055,1055,1055,24000,300,0,0,0,0,300,300,0,0,18832,18832,18832,0,2354,90,15,360,144,85
2020,310000382,14618,14618,10618,10618,4000,0,0,0,0,0,0,0,0,0,0,0,0,0,605,50,13,120,102,37
2020,310000392,50260,5060,5060,5060,0,45200,41000,41000,0,0,4200,3700,500,0,24200,24200,15400,8000,4469,216,95,420,198,522
2020,310600171,10520,10520,4520,4520,6000,0,0,0,0,0,0,0,0,0,0,0,0,0,594,72,4,10,78,1
2020,310600181,261,261,161,161,100,0,0,0,0,0,0,0,0,0,400,400,0,200,630,60,10,12,96,1
2020,310600211,2540,2540,40,40,2500,0,0,0,0,0,0,0,0,0,0,0,0,0,550,150,15,13,42,1
2020,310600231,11560,1060,1060,1060,0,10500,10000,0,10000,0,500,0,500,0,2000,0,0,0,1482,300,100,120,72,13
2020,310600251,30233,27753,15753,15753,12000,2480,0,0,0,0,2480,2480,0,0,0,0,0,0,3839,360,300,465,300,715
2020,310600271,28300,1300,1300,1300,0,27000,26000,26000,0,0,1000,1000,0,0,1000,1000,1000,0,1921,264,540,200,108,47
2020,310600281,32927,4227,4227,4227,0,28700,28000,28000,0,0,700,700,0,0,7900,5900,5800,0,2701,240,120,186,240,122
2020,310600291,78248,19088,19088,19088,0,59160,57500,45500,12000,0,1660,1400,260,0,500,0,0,0,5060,580,650,630,300,119
2020,310600341,26736,22436,6436,6436,16000,4300,4000,0,4000,0,300,300,0,0,500,500,0,0,3009,312,90,420,247,295
2020,310600361,65858,21858,21858,21858,0,44000,40000,40000,0,0,4000,3700,300,0,4500,4500,0,4500,5100,400,400,200,200,215
2020,310600381,177000,100000,20000,20000,80000,77000,75000,0,75000,0,2000,0,2000,0,10000,0,0,0,5500,400,600,400,200,1183
2020,310700111,14284,13784,13784,13784,0,500,0,0,0,0,500,500,0,0,0,0,0,0,2710,180,10,240,180,20
2020,310700131,1279,1279,1029,1029,250,0,0,0,0,0,0,0,0,0,300,300,0,300,3102,216,150,240,156,0
2020,310700151,12520,12520,3520,3520,9000,0,0,0,0,0,0,0,0,0,0,0,0,0,1406,132,360,60,54,1
2020,310700181,21020,20,20,20,0,21000,21000,21000,0,0,0,0,0,0,0,0,0,0,210,0,20,0,0,1
2020,310700191,20020,20020,20,20,20000,0,0,0,0,0,0,0,0,0,0,0,0,0,1608,250,150,60,48,32
2020,310700211,3990,3990,490,490,3500,0,0,0,0,0,0,0,0,0,0,0,0,0,1702,240,60,240,102,1
2020,310700221,2040,40,40,40,0,2000,2000,2000,0,0,0,0,0,0,0,0,0,0,633,121,60,24,46,2
2020,310700231,41588,11088,11088,11088,0,30500,30000,30000,0,0,500,500,0,0,14080,14080,13930,0,2602,250,30,200,200,139
2020,310700241,13490,390,390,390,0,13100,4300,4300,0,0,8800,1300,0,7500,594,594,0,594,2804,220,130,108,180,8
2020,310700271,137220,12120,12120,12120,0,125100,124300,17300,107000,0,800,800,0,0,14000,10000,10000,0,2774,144,600,360,120,353
2020,310700351,22096,19676,9676,9676,10000,2420,0,0,0,0,2420,2300,120,0,0,0,0,0,3504,444,200,360,240,65
2020,310700361,32400,2000,2000,2000,0,30400,30000,30000,0,0,400,400,0,0,200,200,0,200,2800,300,24,540,96,72
2020,310700371,3600,1650,1350,1100,300,1950,0,0,0,0,1950,950,0,1000,300,300,0,300,1501,342,30,150,149,280
2020,310700381,45250,250,250,250,0,45000,45000,30000,15000,0,0,0,0,0,1000,0,0,0,1104,50,50,30,34,68
2020,310700391,70242,5242,5242,5242,0,65000,65000,30000,35000,0,0,0,0,0,45900,25400,12000,2200,3114,300,350,50,264,104
2020,310800101,95050,5050,5050,5050,0,90000,90000,85000,5000,0,0,0,0,0,0,0,0,0,1593,180,60,18,27,178
2020,310800141,7064,5064,4064,1164,1000,2000,2000,0,2000,0,0,0,0,0,7800,7300,0,0,2906,1000,38,72,96,3
2020,310800151,6030,6030,30,30,6000,0,0,0,0,0,0,0,0,0,0,0,0,0,622,72,200,20,30,1
2020,310800161,9390,9390,9390,9390,0,0,0,0,0,0,0,0,0,0,0,0,0,0,1294,220,20,160,84,2
2020,310800171,31710,27710,2710,1210,25000,4000,0,0,0,0,4000,2500,0,1500,6630,6630,6280,0,2375,300,180,480,110,31
2020,310800201,888,888,388,388,500,0,0,0,0,0,0,0,0,0,0,0,0,0,1120,396,0,120,70,1
2020,310800221,2090,2090,90,90,2000,0,0,0,0,0,0,0,0,0,0,0,0,0,550,260,15,40,15,0
2020,310800241,11095,11095,1095,1095,10000,0,0,0,0,0,0,0,0,0,0,0,0,0,892,72,300,15,56,1
2020,310800291,16767,4192,4192,3192,0,12575,11500,11000,500,0,1075,30,545,500,0,0,0,0,2820,240,100,240,240,205
2020,310800301,343824,11124,11124,11124,0,332700,330000,90000,240000,0,2700,2700,0,0,50000,0,0,0,2860,300,300,200,120,497
2020,310800311,7092,6492,3242,3242,3250,600,0,0,0,0,600,600,0,0,880,880,30,850,1970,150,50,120,50,51
2020,310800321,14360,12860,12360,12360,500,1500,0,0,0,0,1500,1500,0,0,0,0,0,0,2120,400,100,400,120,282
2020,310800331,16844,16344,2344,2344,14000,500,0,0,0,0,500,500,0,0,0,0,0,0,3820,700,300,400,180,31
2020,310800341,21570,18770,4770,4770,14000,2800,0,0,0,0,2800,2800,0,0,10800,10800,9000,1800,3028,468,200,600,120,948
2020,310800351,560,560,60,60,500,0,0,0,0,0,0,0,0,0,0,0,0,0,1040,480,60,20,60,1
2020,310800361,5105,5105,105,105,5000,0,0,0,0,0,0,0,0,0,0,0,0,0,1013,75,160,120,60,79
2020,310800371,11555,6655,5655,3655,1000,4900,0,0,0,0,4900,0,1200,3700,0,0,0,0,1924,166,300,96,208,2
2020,310800391,45164,9264,8264,8264,1000,35900,35600,0,35600,0,300,100,200,0,2500,0,0,0,5344,786,120,300,240,172
2020,310900111,30320,29920,9920,9920,20000,400,0,0,0,0,400,400,0,0,7000,7000,7000,0,3000,360,200,150,240,274
2020,310900121,10490,10490,490,490,10000,0,0,0,0,0,0,0,0,0,0,0,0,0,2000,400,100,150,150,1
2020,310900141,12025,11900,4900,4900,7000,125,0,0,0,0,125,0,125,0,240,240,240,0,753,60,18,14,18,34
2020,310900151,277529,185929,110929,110929,75000,91600,80000,0,80000,0,11600,3600,8000,0,0,0,0,0,5245,445,150,100,150,663
2020,310900181,102780,34480,9480,8480,25000,68300,60000,0,60000,0,8300,7000,300,1000,43040,3040,0,0,3730,240,120,480,240,149
2020,310900191,30726,5926,5926,5926,0,24800,23500,23500,0,0,1300,1200,100,0,6600,6600,6600,0,4174,180,60,384,360,126
2020,310900201,7308,1308,1308,1308,0,6000,6000,6000,0,0,0,0,0,0,0,0,0,0,1016,96,84,60,36,11
2020,310900211,3650,3550,3050,50,500,100,0,0,0,0,100,0,100,0,3000,3000,0,0,1410,480,50,70,180,110
2020,310900221,19140,2140,2140,2140,0,17000,17000,17000,0,0,0,0,0,0,0,0,0,0,1488,240,120,120,156,25
2020,310900231,120174,6492,6492,6492,0,113682,113000,63000,50000,0,682,600,82,0,28000,28000,28000,0,4970,600,100,240,360,425
2020,310900241,8111,111,111,111,0,8000,8000,8000,0,0,0,0,0,0,4500,4500,4000,0,2284,180,800,120,84,15
2020,310900261,64728,24748,24748,24748,0,39980,31000,21000,10000,0,8980,890,90,8000,2000,0,0,0,2120,360,200,250,120,126
2020,310900271,10200,200,200,200,0,10000,10000,10000,0,0,0,0,0,0,1000,0,0,0,1198,120,140,36,48,14
2020,310900281,30300,13300,9300,5700,4000,17000,0,0,0,0,17000,2000,1000,14000,9000,9000,0,9000,2415,180,80,600,60,54
2020,310900291,8770,8770,2770,2770,6000,0,0,0,0,0,0,0,0,0,0,0,0,0,820,240,10,120,60,84
2020,310900301,150450,17550,17550,17550,0,132900,130500,60500,70000,0,2400,0,2400,0,75900,32900,24000,8900,5100,360,160,780,240,373
2020,310900321,570,570,70,70,500,0,0,0,0,0,0,0,0,0,0,0,0,0,1180,600,20,40,120,4
2020,310900391,11510,10960,10960,10960,0,550,0,0,0,0,550,550,0,0,0,0,0,0,1882,240,60,324,120,6
2020,311000102,16116,16116,3116,3116,13000,0,0,0,0,0,0,0,0,0,12780,12780,0,12780,1642,72,10,120,240,89
2020,311000112,33020,1020,1020,1020,0,32000,30000,30000,0,0,2000,2000,0,0,22500,4000,4000,0,3830,280,100,360,360,121
2020,311000122,5750,5750,750,750,5000,0,0,0,0,0,0,0,0,0,0,0,0,0,1380,540,0,60,180,17
2020,311000132,76144,69144,69144,69144,0,7000,7000,0,0,7000,0,0,0,0,0,0,0,0,3524,840,20,240,144,2951
2020,311000142,780,780,280,280,500,0,0,0,0,0,0,0,0,0,30,30,0,0,2270,580,200,60,120,29
2020,311000152,74725,7225,25,25,7200,67500,67500,0,67500,0,0,0,0,0,51500,35000,35000,0,1390,500,50,120,200,77
2020,311000192,246350,131000,131000,131000,0,115350,115000,100000,15000,0,350,350,0,0,0,0,0,0,5690,480,2000,240,150,1350
2020,311000202,2,2,2,2,0,0,0,0,0,0,0,0,0,0,5000,5000,0,0,1088,120,96,144,96,46
2020,311000222,1795,995,995,995,0,800,0,0,0,0,800,800,0,0,0,0,0,0,2116,320,70,320,96,25
2020,311000232,102968,19628,19628,19628,0,83340,83000,83000,0,0,340,340,0,0,50,50,0,0,4168,360,180,600,180,2367
2020,311000242,111600,65600,15600,15600,50000,46000,38000,0,38000,0,8000,8000,0,0,27000,0,0,0,9760,600,120,240,600,5782
2020,311000252,24705,20265,20265,20265,0,4440,4440,4440,0,0,0,0,0,0,69,69,0,0,2300,100,150,150,100,40
2020,311000262,1231,1231,731,731,500,0,0,0,0,0,0,0,0,0,0,0,0,0,833,300,40,10,33,35
2020,311000282,15568,455,455,455,0,15113,15000,10000,5000,0,113,0,113,0,4500,4500,4500,0,2420,120,10,180,120,14
2020,311000302,7090,7090,2090,2090,5000,0,0,0,0,0,0,0,0,0,0,0,0,0,2596,96,1348,26,144,21
2020,311000332,40100,100,100,100,0,40000,40000,40000,0,0,0,0,0,0,0,0,0,0,813,168,130,10,15,19
2020,311000352,154700,1700,1700,1700,0,153000,149000,149000,0,0,4000,4000,0,0,0,0,0,0,6650,600,50,960,240,876
2020,311000362,2984,2984,284,284,2700,0,0,0,0,0,0,0,0,0,2000,2000,2000,0,2350,500,0,300,100,6
2020,311000382,74200,38500,8500,8500,30000,35700,30000,0,30000,0,5700,3200,2500,0,25950,950,0,950,4360,240,1000,360,300,81
2020,311000392,35500,34530,2530,2530,32000,970,0,0,0,0,970,970,0,0,10000,10000,10000,0,2376,120,0,192,144,25
2020,311600101,26100,15800,9800,9800,6000,10300,0,0,0,0,10300,3300,7000,0,130,130,0,0,4704,2700,50,260,144,336
2020,311600131,57190,5390,5390,4390,0,51800,46000,28000,18000,0,5800,4500,0,1300,16300,5300,0,0,3469,120,500,60,180,665
2020,311600141,55866,10226,10226,10126,0,45640,45000,43000,2000,0,640,500,140,0,200,200,0,0,2409,180,306,60,108,440
2020,311600151,11718,3718,3718,3718,0,8000,8000,0,8000,0,0,0,0,0,580,580,0,380,2259,180,3,200,96,6
2020,311600161,8153,5153,1953,1953,3200,3000,3000,0,3000,0,0,0,0,0,652,652,0,200,3328,300,72,180,320,232
2020,311600201,14435,10435,10435,10435,0,4000,4000,4000,0,0,0,0,0,0,300,300,0,0,2094,90,320,220,84,9
2020,311600231,9130,1130,1130,1130,0,8000,8000,8000,0,0,0,0,0,0,0,0,0,0,840,100,160,80,40,13
2020,311600251,36776,7564,7564,7564,0,29212,29000,29000,0,0,212,86,126,0,9067,9067,9067,0,3300,200,100,270,240,94
2020,311600261,30283,7170,7170,7170,0,23113,23000,23000,0,0,113,0,113,0,0,0,0,0,1806,264,350,60,72,21
2020,311600281,9452,4452,3452,3452,1000,5000,4500,0,0,4500,500,500,0,0,15500,15500,0,15500,3750,560,50,1000,180,37
2020,311600291,26845,745,745,745,0,26100,26000,16000,10000,0,100,100,0,0,7800,7800,7800,0,2130,100,10,200,250,105
2020,311600311,21060,860,860,860,0,20200,20000,20000,0,0,200,100,100,0,200,0,0,0,3080,300,900,400,90,67
2020,311600371,13050,12950,1450,1450,11500,100,0,0,0,0,100,100,0,0,9250,9250,9000,0,2640,360,240,480,240,17
2020,311700111,66438,15238,5238,5238,10000,51200,46000,0,46000,0,5200,4200,1000,0,19900,19900,18000,0,1380,240,50,240,120,79
2020,311700121,15100,3700,3200,3200,500,11400,10000,0,10000,0,1400,1400,0,0,546,546,0,0,2160,480,50,250,120,79
2020,311700131,88913,23513,23513,23513,0,65400,65000,65000,0,0,400,400,0,0,0,0,0,0,4980,300,60,360,240,878
2020,311700151,87900,38400,38400,38400,0,49500,48000,48000,0,0,1500,500,1000,0,8620,8620,8620,0,3900,250,500,600,150,602
2020,311700161,60922,9970,9970,9970,0,50952,50000,50000,0,0,952,500,452,0,0,0,0,0,4620,360,120,360,240,355
2020,311700191,30084,30084,12084,12084,18000,0,0,0,0,0,0,0,0,0,0,0,0,0,2400,180,120,120,120,89
2020,311700201,33730,7350,7350,7350,0,26380,26000,26000,0,0,380,350,30,0,65,65,0,0,3092,288,380,286,140,144
2020,311700211,13721,13721,11721,11721,2000,0,0,0,0,0,0,0,0,0,0,0,0,0,3386,380,620,224,172,22
2020,311700241,1045,1045,45,45,1000,0,0,0,0,0,0,0,0,0,0,0,0,0,886,101,90,60,45,0
2020,311700251,20045,1005,1005,1005,0,19040,19000,19000,0,0,40,40,0,0,0,0,0,0,989,168,200,65,36,38
2020,311700281,8800,4800,4800,4800,0,4000,4000,0,4000,0,0,0,0,0,200,0,0,0,3200,240,24,96,240,23
2020,311700291,40990,5540,5540,2040,0,35450,28000,16000,12000,0,7450,3400,4050,0,13100,13100,13000,100,4704,240,24,1200,180,101
2020,311700311,700,700,200,200,500,0,0,0,0,0,0,0,0,0,112,112,0,112,2914,960,60,240,144,590
2020,311700321,19480,980,980,980,0,18500,15000,15000,0,0,3500,3500,0,0,12070,12070,7950,4120,4190,240,20,240,200,183
2020,311700331,48506,10406,10406,10406,0,38100,38000,38000,0,0,100,100,0,0,1000,1000,0,1000,1205,240,30,330,85,137
2020,311700341,46660,11660,11660,11660,0,35000,35000,35000,0,0,0,0,0,0,0,0,0,0,1230,240,50,180,120,484
2020,311700381,88015,515,515,515,0,87500,85000,85000,0,0,2500,2500,0,0,3000,2000,0,2000,4480,290,200,500,450,854
2020,311700391,1700,1700,200,200,1500,0,0,0,0,0,0,0,0,0,0,0,0,0,1200,420,90,10,120,1
2020,311800101,271500,20100,20100,20100,0,251400,250000,250000,0,0,1400,1400,0,0,0,0,0,0,6561,1250,175,240,96,813
2020,311800111,32500,5500,5500,5500,0,27000,18000,18000,0,0,9000,1000,0,8000,0,0,0,0,2462,160,60,720,132,64
2020,311800131,120318,15818,15818,10818,0,104500,100000,75000,25000,0,4500,1000,0,3500,0,0,0,0,1950,150,160,100,80,143
2020,311800151,36900,1600,1600,1600,0,35300,35000,35000,0,0,300,0,300,0,0,0,0,0,5147,108,4156,0,93,29
2020,311800181,110540,40300,40300,40300,0,70240,70000,70000,0,0,240,0,240,0,0,0,0,0,1376,288,140,24,32,295
2020,311800211,46844,13194,13194,10994,0,33650,26000,26000,0,0,7650,2650,5000,0,21000,21000,18000,0,5050,300,300,450,200,512
2020,311800221,34500,16500,8500,8500,8000,18000,18000,0,18000,0,0,0,0,0,20800,6800,6800,0,3070,120,50,50,360,320
2020,311800231,93570,2970,2970,2970,0,90600,90000,54000,36000,0,600,350,250,0,27000,2000,0,2000,5444,300,255,270,204,811
2020,311800251,1130,1130,630,630,500,0,0,0,0,0,0,0,0,0,2645,2645,0,2645,1787,780,100,100,24,2
2020,311800281,191029,28699,28699,24699,0,162330,158000,50000,108000,0,4330,2500,830,1000,21800,7600,3000,4500,6600,240,360,600,600,406
2020,311800291,31229,5579,5579,5579,0,25650,25000,25000,0,0,650,150,500,0,16700,16700,13000,1900,3764,300,20,504,204,44
2020,311800301,11414,11414,6414,5414,5000,0,0,0,0,0,0,0,0,0,0,0,0,0,1227,75,180,36,36,1
2020,311800321,222091,111691,111691,111691,0,110400,110000,110000,0,0,400,400,0,0,0,0,0,0,2580,600,800,100,240,972
2020,311800331,115180,24180,24180,24180,0,91000,80000,80000,0,0,11000,8000,3000,0,0,0,0,0,6560,720,240,560,600,4919
2020,311800341,14801,14701,1841,1841,12860,100,0,0,0,0,100,0,100,0,11330,11330,11100,0,2476,228,50,288,360,55
2020,311800351,192625,127225,96163,96163,31062,65400,65000,0,65000,0,400,400,0,0,2000,0,0,0,8246,748,386,233,127,21620
2020,311800361,61930,61430,31430,31430,30000,500,0,0,0,0,500,500,0,0,0,0,0,0,5128,840,200,240,348,466
2020,311800371,46056,5956,5956,5956,0,40100,40000,10000,30000,0,100,0,100,0,10000,0,0,0,1125,250,140,30,70,41
2020,311800381,47011,11,11,11,0,47000,47000,47000,0,0,0,0,0,0,0,0,0,0,1150,160,230,80,70,50
2020,311800391,320,320,120,120,200,0,0,0,0,0,0,0,0,0,0,0,0,0,1054,370,20,120,84,7
2020,311900111,1764,1764,1764,1764,0,0,0,0,0,0,0,0,0,0,1000,1000,0,1000,1070,160,20,80,60,40
2020,311900131,250400,80260,80260,80260,0,170140,170000,170000,0,0,140,140,0,0,0,0,0,0,2050,600,240,200,120,569
2020,311900141,217150,34650,34650,34650,0,182500,172500,160000,12500,0,10000,10000,0,0,0,0,0,0,4270,480,50,960,360,1536
2020,311900161,54350,53750,33750,28750,20000,600,0,0,0,0,600,500,100,0,0,0,0,0,1520,250,150,100,100,95
2020,311900171,4810,2510,1510,1510,1000,2300,0,0,0,0,2300,2300,0,0,1880,1880,0,0,2670,460,80,190,240,25
2020,311900191,51553,51553,9553,9553,42000,0,0,0,0,0,0,0,0,0,0,0,0,0,6070,300,50,200,220,2061
2020,311900221,10100,100,100,100,0,10000,10000,10000,0,0,0,0,0,0,0,0,0,0,826,72,180,48,36,33
2020,311900231,14290,1800,1800,1800,0,12490,12400,12400,0,0,90,0,90,0,0,0,0,0,1390,120,130,50,60,5
2020,311900241,14524,2286,2286,2286,0,12238,12000,12000,0,0,238,238,0,0,9040,9040,7200,1820,2211,180,20,60,220,21
2020,311900251,54300,9300,9300,9300,0,45000,45000,45000,0,0,0,0,0,0,0,0,0,0,1767,390,180,150,39,72
2020,311900261,11930,630,630,630,0,11300,6000,6000,0,0,5300,2800,2500,0,4180,4180,1800,0,5400,60,200,360,360,102
2020,311900271,27900,12500,12500,11000,0,15400,15000,15000,0,0,400,400,0,0,466,466,466,0,2300,170,20,140,60,23
2020,311900281,62114,16900,16900,16900,0,45214,45000,45000,0,0,214,0,214,0,0,0,0,0,1486,264,20,12,60,87
2020,311900291,51220,400,400,400,0,50820,50700,50000,700,0,120,120,0,0,0,0,0,0,1982,312,50,120,0,76
2020,311900301,38610,1320,1320,1320,0,37290,34490,15000,19490,0,2800,2800,0,0,11405,10905,10650,0,1906,300,240,288,120,46
2020,311900311,25025,24225,10725,10725,13500,800,0,0,0,0,800,800,0,0,10900,10900,10700,200,4270,240,20,480,240,116
2020,311900341,57490,27460,460,460,27000,30030,30000,0,30000,0,30,30,0,0,3170,170,0,170,3200,210,40,230,180,62
2020,311900361,115300,300,300,300,0,115000,115000,95000,20000,0,0,0,0,0,2000,0,0,0,2400,360,960,120,240,149
2020,311900371,127310,20310,20310,10310,0,107000,106000,106000,0,0,1000,1000,0,0,0,0,0,0,1764,420,60,120,84,243
2020,311900381,515,515,15,15,500,0,0,0,0,0,0,0,0,0,0,0,0,0,763,202,120,0,36,0
2020,311900391,83083,1483,1483,1483,0,81600,79000,50000,29000,0,2600,2600,0,0,51000,27000,26000,1000,4066,240,450,420,180,285
2020,312000112,132805,24355,24355,21355,0,108450,105000,85000,20000,0,3450,220,3230,0,500,0,0,0,13660,360,240,780,360,953
2020,312000122,106930,16730,16730,16730,0,90200,90000,90000,0,0,200,200,0,0,2000,2000,1500,500,7940,240,50,350,240,1010
2020,312000132,9200,8700,1700,1700,7000,500,0,0,0,0,500,500,0,0,0,0,0,0,2616,240,36,360,180,55
2020,312000142,46050,2510,2510,2010,0,43540,42640,42640,0,0,900,900,0,0,2000,0,0,0,2496,276,120,360,60,47
2020,312000172,2800,2800,300,300,2500,0,0,0,0,0,0,0,0,0,0,0,0,0,824,324,100,10,10,1
2020,312000182,30050,50,50,50,0,30000,30000,30000,0,0,0,0,0,0,0,0,0,0,802,260,200,50,32,37
2020,312000202,29017,8917,8917,8917,0,20100,18500,16000,2500,0,1600,800,800,0,1100,1100,950,0,2444,270,30,270,240,58
2020,312000212,29195,7395,7395,5895,0,21800,20000,20000,0,0,1800,1000,800,0,0,0,0,0,2590,480,30,180,288,42
2020,312000222,430,420,420,420,0,10,0,0,0,0,10,10,0,0,0,0,0,0,2540,180,120,150,120,23
2020,312000242,1280,1250,250,250,1000,30,0,0,0,0,30,0,20,10,0,0,0,0,1415,780,150,30,25,1
2020,312000252,30140,3240,3240,3240,0,26900,23000,16000,7000,0,3900,1700,700,1500,0,0,0,0,3270,180,350,240,180,79
2020,312000272,20660,5660,5660,5660,0,15000,15000,15000,0,0,0,0,0,0,200,200,0,0,2239,360,272,432,131,17
2020,312000282,24850,1350,1350,1350,0,23500,23000,23000,0,0,500,500,0,0,4500,0,0,0,2390,120,960,180,120,369
2020,312000292,10388,9988,3988,3988,6000,400,0,0,0,0,400,300,100,0,10000,10000,4800,0,3935,485,90,550,360,81
2020,312000302,46266,1440,1440,1440,0,44826,44000,44000,0,0,826,600,226,0,18000,18000,18000,0,2886,420,150,300,120,736
2020,312000312,3432,3432,2507,2507,925,0,0,0,0,0,0,0,0,0,690,690,690,0,835,305,108,30,56,1
2020,312000322,22180,22180,4180,4180,18000,0,0,0,0,0,0,0,0,0,0,0,0,0,1466,216,250,120,120,50
2020,312000332,33350,23450,6450,6450,17000,9900,5700,0,0,5700,4200,4200,0,0,29500,29500,27500,2000,1770,240,200,300,100,532
2020,312000362,178460,34460,34460,34460,0,144000,140000,70000,70000,0,4000,4000,0,0,12000,0,0,0,5780,180,240,1200,360,4214
2020,312000392,10912,9662,1662,1662,8000,1250,1250,0,0,1250,0,0,0,0,6400,6400,6400,0,2716,300,12,36,48,123
2020,312600111,4521,4521,21,21,4500,0,0,0,0,0,0,0,0,0,0,0,0,0,2128,840,180,120,106,3
2020,312600121,9030,9030,30,30,9000,0,0,0,0,0,0,0,0,0,5000,5000,0,0,2990,1320,100,100,240,4
2020,312600131,8185,8185,185,185,8000,0,0,0,0,0,0,0,0,0,3800,3800,3800,0,2142,100,70,300,250,2
2020,312600141,12660,12660,5660,5660,7000,0,0,0,0,0,0,0,0,0,1000,1000,1000,0,3491,109,120,360,336,61
2020,312600161,20442,18442,6442,6442,12000,2000,1300,0,0,1300,700,300,400,0,11275,11275,0,11275,2983,336,130,396,240,1
2020,312600181,3252,3252,2752,2752,500,0,0,0,0,0,0,0,0,0,0,0,0,0,1926,600,30,216,180,82
2020,312600201,17130,1930,1930,1930,0,15200,15000,15000,0,0,200,200,0,0,0,0,0,0,3376,216,200,480,360,29
2020,312600211,60780,2230,2230,2230,0,58550,54000,34000,20000,0,4550,4100,450,0,21700,6700,1800,500,4524,288,40,540,134,379
2020,312600221,8600,100,100,100,0,8500,8500,8500,0,0,0,0,0,0,30,30,0,0,771,72,36,24,36,6
2020,312600231,94140,44840,44840,44840,0,49300,45000,45000,0,0,4300,4200,100,0,0,0,0,0,3580,360,240,480,120,947
2020,312600241,17485,970,970,970,0,16515,16500,16500,0,0,15,0,15,0,0,0,0,0,615,149,15,15,64,11
2020,312600251,600,600,100,100,500,0,0,0,0,0,0,0,0,0,1500,1500,0,650,1072,96,100,96,40,1
2020,312600271,8150,150,150,150,0,8000,8000,8000,0,0,0,0,0,0,110,0,0,0,585,120,50,10,25,11
2020,312600291,29390,27690,1690,1690,26000,1700,0,0,0,0,1700,1700,0,0,2000,2000,0,2000,4901,360,1000,300,120,117
2020,312600311,152680,12180,12180,12180,0,140500,137000,130000,7000,0,3500,3500,0,0,34500,4000,4000,0,3025,500,600,300,75,445
2020,312600351,63420,14220,14220,14220,0,49200,49000,25000,24000,0,200,200,0,0,11800,11800,11800,0,3880,360,1140,200,240,100
2020,312600371,28535,535,535,535,0,28000,28000,28000,0,0,0,0,0,0,900,0,0,0,540,190,18,10,24,21
2020,312600391,8772,8772,272,272,8500,0,0,0,0,0,0,0,0,0,32,32,0,0,1921,366,65,240,120,1
2020,312700111,8850,8850,2850,2850,6000,0,0,0,0,0,0,0,0,0,2680,2680,0,2500,3150,339,100,120,121,38
2020,312700131,11550,11550,4550,4550,7000,0,0,0,0,0,0,0,0,0,0,0,0,0,1439,108,50,120,96,32
2020,312700151,50230,1230,1230,1230,0,49000,49000,30000,19000,0,0,0,0,0,0,0,0,0,834,204,72,10,48,52
2020,312700161,95656,16656,16656,16656,0,79000,79000,68000,11000,0,0,0,0,0,500,0,0,0,2980,180,100,100,60,125
2020,312700171,152002,12302,12302,12302,0,139700,133500,81000,52500,0,6200,6200,0,0,52134,22634,11322,7850,6000,500,100,360,240,2417
2020,312700201,48130,830,830,830,0,47300,45000,32000,13000,0,2300,2300,0,0,8040,8040,4550,1000,1981,170,48,50,180,161
2020,312700231,20515,6335,6335,6335,0,14180,14000,14000,0,0,180,180,0,0,3780,3780,3780,0,2656,300,120,540,216,76
2020,312700241,30306,2226,2226,2226,0,28080,26000,16000,10000,0,2080,2080,0,0,6500,1500,0,0,1354,260,180,120,84,47
2020,312700261,99790,3790,3790,3790,0,96000,95000,33000,62000,0,1000,300,200,500,4007,1007,1007,0,3545,300,150,420,135,1756
2020,312700271,13224,2424,2424,2424,0,10800,10800,10800,0,0,0,0,0,0,0,0,0,0,607,86,36,30,25,7
2020,312700281,8610,2510,2510,2510,0,6100,5800,0,5800,0,300,0,300,0,0,0,0,0,1532,180,120,80,50,1108
2020,312700291,21640,6640,6640,6640,0,15000,15000,15000,0,0,0,0,0,0,0,0,0,0,2260,150,20,150,220,96
2020,312700301,4006,2206,686,686,1520,1800,0,0,0,0,1800,1800,0,0,1040,1040,1000,0,1330,396,40,70,72,8
2020,312700321,5479,4379,3929,3929,450,1100,0,0,0,0,1100,1100,0,0,5646,5646,380,4300,4030,238,10,264,240,20
2020,312700331,46769,21769,21769,21769,0,25000,25000,25000,0,0,0,0,0,0,0,0,0,0,660,178,10,10,158,29
2020,312700351,80080,13080,13080,13080,0,67000,65000,20000,45000,0,2000,2000,0,0,17000,0,0,0,7280,500,100,900,180,724
2020,312700371,77000,30700,30700,30700,0,46300,45000,45000,0,0,1300,1300,0,0,0,0,0,0,4440,300,100,180,200,963
2020,312700391,3050,3050,50,50,3000,0,0,0,0,0,0,0,0,0,0,0,0,0,485,70,100,20,15,1
2020,312800101,20810,710,710,710,0,20100,20000,20000,0,0,100,0,100,0,7050,7050,7050,0,1020,250,50,60,60,33
2020,312800121,64017,5791,5791,5791,0,58226,58000,48000,10000,0,226,0,226,0,4500,3500,3500,0,2641,201,60,360,120,214
2020,312800131,10,10,10,10,0,0,0,0,0,0,0,0,0,0,0,0,0,0,763,180,15,60,48,1
2020,312800161,117110,10110,10110,10110,0,107000,100000,60000,40000,0,7000,7000,0,0,16600,16600,14600,2000,5750,200,100,300,200,960
2020,312800171,94040,3690,3690,3690,0,90350,89000,59000,30000,0,1350,350,1000,0,15400,15400,15400,0,5620,1560,200,200,180,299
2020,312800221,13100,3100,3100,3100,0,10000,10000,10000,0,0,0,0,0,0,0,0,0,0,1225,170,240,60,24,12
2020,312800231,23010,10510,10510,9510,0,12500,11000,11000,0,0,1500,0,500,1000,2800,2800,0,2800,1820,240,200,50,60,186
2020,312800261,4615,4615,615,615,4000,0,0,0,0,0,0,0,0,0,0,0,0,0,1152,192,10,60,120,4
2020,312800291,70,70,10,10,60,0,0,0,0,0,0,0,0,0,1000,1000,0,0,830,192,20,120,108,0
2020,312800301,13636,11436,2436,2436,9000,2200,0,0,0,0,2200,2200,0,0,0,0,0,0,2060,180,40,180,180,32
2020,312800311,30211,3811,3811,3811,0,26400,26000,20000,0,6000,400,400,0,0,0,0,0,0,4067,300,180,650,252,166
2020,312800331,47846,44346,11846,11546,32500,3500,0,0,0,0,3500,3500,0,0,13670,13670,13670,0,6744,274,120,772,228,2759
2020,312800351,121512,6112,6112,6112,0,115400,115000,65000,50000,0,400,400,0,0,18000,11000,1000,10000,5010,450,50,480,360,736
2020,312800361,34184,9034,9034,9034,0,25150,25000,25000,0,0,150,150,0,0,3400,3400,3400,0,3662,240,50,360,180,109
2020,312800371,35300,300,300,300,0,35000,35000,35000,0,0,0,0,0,0,10000,0,0,0,1588,232,60,72,180,92
2020,312800391,24136,8886,8886,7386,0,15250,15000,15000,0,0,250,250,0,0,6000,6000,6000,0,2442,200,50,380,312,43
2020,312900111,38933,18733,18733,17033,0,20200,19000,19000,0,0,1200,1200,0,0,18,18,0,0,1651,156,60,120,85,142
2020,312900141,72170,2170,170,170,2000,70000,70000,0,70000,0,0,0,0,0,32000,0,0,0,5320,1200,200,240,360,80
2020,312900151,35600,600,600,600,0,35000,35000,35000,0,0,0,0,0,0,0,0,0,0,502,100,60,12,30,16
2020,312900181,12335,10935,235,235,10700,1400,0,0,0,0,1400,1400,0,0,7750,7750,0,7650,2156,150,20,250,86,26
2020,312900201,2475,2475,2275,2275,200,0,0,0,0,0,0,0,0,0,0,0,0,0,744,220,80,12,27,1
2020,312900231,64034,5034,3034,3034,2000,59000,55000,0,55000,0,4000,4000,0,0,1000,1000,0,0,4550,1700,120,350,280,413
2020,312900241,24485,3485,3485,3485,0,21000,21000,21000,0,0,0,0,0,0,900,0,0,0,1978,388,180,34,29,14
2020,312900251,43440,4940,4940,4940,0,38500,38000,25000,13000,0,500,100,400,0,3000,0,0,0,2630,240,50,300,180,52
2020,312900291,60456,10006,10006,10006,0,50450,50000,50000,0,0,450,400,50,0,70,70,0,0,3439,251,121,281,82,171
2020,312900301,37026,6026,6026,6026,0,31000,29000,29000,0,0,2000,2000,0,0,10100,10100,7900,0,2770,300,210,300,220,372
2020,312900311,680,530,330,330,200,150,0,0,0,0,150,150,0,0,0,0,0,0,1500,400,50,280,120,14
2020,312900381,600,600,100,100,500,0,0,0,0,0,0,0,0,0,404,404,0,404,2440,600,20,180,300,0
2020,312900391,61200,1050,1050,1050,0,60150,60000,60000,0,0,150,150,0,0,9700,9700,9300,400,5930,360,180,500,170,414
2020,313000132,1077,577,77,77,500,500,0,0,0,0,500,500,0,0,550,550,0,550,1844,940,50,180,84,25
2020,313000162,12098,2098,2098,2098,0,10000,10000,10000,0,0,0,0,0,0,3200,3200,2500,0,1085,200,50,100,120,18
2020,313000172,37410,36610,22610,2610,14000,800,0,0,0,0,800,800,0,0,11000,11000,10000,0,1032,180,12,240,120,61
2020,313000182,88740,9810,9810,9310,0,78930,77000,60000,17000,0,1930,1930,0,0,28941,14441,14441,0,3666,344,150,600,264,593
2020,313000192,61086,86,86,86,0,61000,61000,61000,0,0,0,0,0,0,0,0,0,0,889,288,100,36,72,61
2020,313000202,2345,2300,1300,1300,1000,45,0,0,0,0,45,0,45,0,0,0,0,0,1897,120,120,360,192,32
2020,313000222,24197,3030,3030,3030,0,21167,20000,20000,0,0,1167,1100,67,0,0,0,0,0,2367,180,15,276,192,98
2020,313000232,27125,125,125,125,0,27000,18000,18000,0,0,9000,9000,0,0,14400,14400,12000,2300,1338,234,40,280,74,134
2020,313000242,11160,9560,3560,3560,6000,1600,1500,0,0,1500,100,100,0,0,0,0,0,0,2774,160,50,600,144,102
2020,313000252,2710,2450,2150,2150,300,260,0,0,0,0,260,0,260,0,0,0,0,0,1581,390,40,180,54,3
2020,313000262,24970,270,270,270,0,24700,16400,16000,400,0,8300,800,0,7500,0,0,0,0,2397,180,400,420,132,34
2020,313000272,370,370,70,70,300,0,0,0,0,0,0,0,0,0,1066,1066,0,1066,1740,620,120,70,60,1
2020,313000282,298,298,23,23,275,0,0,0,0,0,0,0,0,0,0,0,0,0,528,105,20,10,45,20
2020,313000302,8376,376,376,376,0,8000,8000,8000,0,0,0,0,0,0,0,0,0,0,1009,124,240,30,120,15
2020,313000322,23700,400,400,400,0,23300,23300,23000,0,300,0,0,0,0,0,0,0,0,869,84,60,70,60,53
2020,313000332,38312,7012,7012,7012,0,31300,30500,26500,0,4000,800,800,0,0,29000,29000,0,29000,3310,240,10,120,240,205
2020,313000352,15690,13010,1010,1010,12000,2680,0,0,0,0,2680,2000,680,0,9100,9100,8400,0,2560,230,30,240,180,169
2020,313000362,25180,24380,7380,7380,17000,800,0,0,0,0,800,600,200,0,6400,6400,0,6400,4628,420,120,240,108,174
2020,313000392,13341,9015,15,15,9000,4326,3000,0,0,3000,1326,1100,226,0,5000,5000,5000,0,2277,75,300,360,360,169
2020,313600101,60586,24636,4636,4636,20000,35950,35000,0,35000,0,950,950,0,0,20050,7050,0,7000,4330,360,30,300,180,65
2020,313600111,64173,3128,3128,3128,0,61045,60000,60000,0,0,1045,1000,45,0,25240,25240,25000,0,3430,280,220,300,250,188
2020,313600121,14604,14104,7104,7104,7000,500,0,0,0,0,500,500,0,0,0,0,0,0,3008,880,30,50,276,59
2020,313600141,31510,810,810,810,0,30700,30000,30000,0,0,700,700,0,0,21910,21910,15450,500,4040,360,100,360,240,242
2020,313600161,1660,1360,360,360,1000,300,0,0,0,0,300,0,300,0,660,660,0,120,2396,240,60,180,96,1
2020,313600181,41138,738,738,738,0,40400,40000,40000,0,0,400,0,400,0,11000,11000,11000,0,1578,240,240,46,72,42
2020,313600201,26016,3316,3316,3316,0,22700,22000,22000,0,0,700,700,0,0,13700,13700,13700,0,2050,210,20,200,120,72
2020,313600211,3200,650,300,300,350,2550,2550,0,2550,0,0,0,0,0,0,0,0,0,731,73,0,35,38,3
2020,313600231,12882,4382,2882,2882,1500,8500,0,0,0,0,8500,1500,0,7000,50,50,0,0,1168,346,20,12,60,3
2020,313600251,42230,4230,4230,4230,0,38000,38000,0,38000,0,0,0,0,0,8000,0,0,0,848,144,120,60,24,53
2020,313600261,86540,20290,20290,20290,0,66250,65000,25000,40000,0,1250,750,500,0,21000,18000,18000,0,2671,240,130,350,96,148
2020,313600271,430,30,30,30,0,400,0,0,0,0,400,400,0,0,0,0,0,0,1730,150,20,240,190,23
2020,313600321,114845,38215,38215,38215,0,76630,75000,55000,20000,0,1630,950,680,0,6050,5650,5450,200,5791,420,336,550,450,1953
2020,313600341,6910,5310,1310,1310,4000,1600,0,0,0,0,1600,1600,0,0,2834,2834,300,2534,1484,360,144,240,180,44
2020,313600351,3390,3390,590,590,2800,0,0,0,0,0,0,0,0,0,0,0,0,0,2352,600,120,80,72,1
2020,313600361,31514,1514,1514,1514,0,30000,30000,30000,0,0,0,0,0,0,13788,13788,13788,0,2582,120,100,140,72,46
2020,313700101,12960,12960,460,460,12500,0,0,0,0,0,0,0,0,0,3000,3000,3000,0,1970,240,60,180,180,128
2020,313700121,29010,4010,4010,4010,0,25000,25000,25000,0,0,0,0,0,0,0,0,0,0,314,100,50,0,19,17
2020,313700141,35674,1674,1674,1674,0,34000,34000,34000,0,0,0,0,0,0,15000,15000,15000,0,3006,156,130,60,84,35
2020,313700151,19103,103,103,103,0,19000,19000,19000,0,0,0,0,0,0,0,0,0,0,1320,180,42,120,96,134
2020,313700161,30380,6120,6120,2120,0,24260,24000,24000,0,0,260,260,0,0,34600,34600,12600,0,3300,480,400,72,300,507
2020,313700181,746,676,676,676,0,70,0,0,0,0,70,70,0,0,3000,3000,0,0,1255,360,5,100,40,44
2020,313700201,26857,1857,1857,1857,0,25000,25000,0,25000,0,0,0,0,0,4620,3120,3000,0,1007,160,240,72,80,43
2020,313700211,101236,2310,2310,2310,0,98926,97000,25000,72000,0,1926,1700,226,0,26600,26600,26600,0,4120,240,60,240,240,125
2020,313700221,28490,7490,7490,7490,0,21000,20000,0,20000,0,1000,1000,0,0,0,0,0,0,2170,240,50,300,130,156
2020,313700231,38270,6470,6470,4470,0,31800,30000,30000,0,0,1800,1800,0,0,0,0,0,0,806,156,60,70,50,40
2020,313700241,26944,6944,6944,6944,0,20000,20000,20000,0,0,0,0,0,0,24,24,0,0,1382,180,30,60,48,31
2020,313700251,43810,14560,14560,14560,0,29250,25500,18000,7500,0,3750,250,500,3000,0,0,0,0,3288,240,24,480,264,134
2020,313700261,20100,100,100,100,0,20000,20000,20000,0,0,0,0,0,0,1700,0,0,0,584,60,50,10,24,13
2020,313700281,16690,11260,1260,1260,10000,5430,3000,0,0,3000,2430,2200,230,0,3000,3000,3000,0,2125,200,60,100,70,334
2020,313700301,41170,2130,2130,2130,0,39040,39000,9000,30000,0,40,40,0,0,10710,10710,9588,97,1767,135,20,120,314,64
2020,313700311,7238,6478,6478,6478,0,760,0,0,0,0,760,760,0,0,0,0,0,0,2176,276,80,420,132,14
2020,313700321,27892,6892,6892,6892,0,21000,18500,18500,0,0,2500,2500,0,0,6000,6000,6000,0,2480,240,10,120,300,309
2020,313700331,29270,10270,10270,10270,0,19000,19000,0,19000,0,0,0,0,0,9760,9760,9700,0,1730,100,100,60,100,375
2020,313700341,27120,1420,1420,1420,0,25700,25000,25000,0,0,700,700,0,0,300,300,0,300,2410,360,240,250,180,45
2020,313700361,12430,1430,1430,1430,0,11000,11000,11000,0,0,0,0,0,0,0,0,0,0,1880,156,420,240,77,13
2020,313700371,19940,1240,1240,1240,0,18700,18000,18000,0,0,700,700,0,0,10000,10000,10000,0,3628,156,12,420,204,30
2020,313700381,1010,1010,10,10,1000,0,0,0,0,0,0,0,0,0,0,0,0,0,528,300,12,36,48,1
2020,313800101,49862,4682,4682,4682,0,45180,42000,42000,0,0,3180,3180,0,0,8150,8150,6000,2150,2402,380,440,250,380,98
2020,313800111,90,90,40,40,50,0,0,0,0,0,0,0,0,0,7890,7890,0,0,785,390,12,3,0,1
2020,313800121,59036,3036,3036,3036,0,56000,56000,56000,0,0,0,0,0,0,5000,0,0,0,2030,530,200,50,80,92
2020,313800131,2418,1218,318,318,900,1200,0,0,0,0,1200,1200,0,0,0,0,0,0,1266,250,24,180,42,57
2020,313800161,24660,24560,560,560,24000,100,0,0,0,0,100,100,0,0,9450,9450,9400,0,4716,360,70,400,156,429
2020,313800181,14150,14150,150,150,14000,0,0,0,0,0,0,0,0,0,15000,15000,5000,10000,1860,600,300,100,100,102
2020,313800201,4210,3560,60,60,3500,650,0,0,0,0,650,650,0,0,9000,9000,0,0,2970,480,120,50,120,22
2020,313800211,100960,38920,38920,38920,0,62040,59820,27000,32820,0,2220,1300,920,0,300,0,0,0,2661,640,64,72,54,139
2020,313800221,30508,1310,1310,1310,0,29198,29000,29000,0,0,198,0,198,0,0,0,0,0,1116,210,320,70,36,11
2020,313800241,38494,8194,8194,8194,0,30300,29500,29500,0,0,800,700,100,0,3000,3000,3000,0,4010,450,900,390,240,136
2020,313800331,24057,2412,2412,2412,0,21645,20500,7500,13000,0,1145,1100,45,0,12800,12300,11000,1300,3454,264,60,425,300,94
2020,313800341,1253,1253,1253,1253,0,0,0,0,0,0,0,0,0,0,600,600,300,300,1390,180,130,80,70,1
2020,313800351,31798,3398,3398,3398,0,28400,26500,16500,10000,0,1900,1200,700,0,0,0,0,0,3206,288,480,288,180,87
2020,313800371,79042,4092,4092,4092,0,74950,72500,53000,19500,0,2450,2450,0,0,28815,23315,23315,0,5140,264,60,576,480,538
2020,313800381,5125,4025,625,625,3400,1100,0,0,0,0,1100,1100,0,0,90,90,0,0,3032,504,100,240,120,41
2020,313800391,5806,5310,1310,1310,4000,496,0,0,0,0,496,270,226,0,50,50,0,0,1670,300,30,120,0,31
2020,313900101,350,350,250,250,100,0,0,0,0,0,0,0,0,0,2280,2280,0,2280,1646,696,50,100,100,160
2020,313900111,8,8,8,8,0,0,0,0,0,0,0,0,0,0,0,0,0,0,1038,95,130,85,78,3
2020,313900171,22540,22540,1540,1540,21000,0,0,0,0,0,0,0,0,0,0,0,0,0,2126,150,30,156,200,176
2020,313900201,2694,2544,1144,1144,1400,150,0,0,0,0,150,150,0,0,100,100,0,0,1667,396,10,340,120,16
2020,313900211,137976,12976,12976,12976,0,125000,120000,95000,25000,0,5000,5000,0,0,1000,0,0,0,3832,600,10,276,216,1982
2020,313900221,20196,4496,4496,4496,0,15700,15700,13000,2700,0,0,0,0,0,0,0,0,0,875,90,10,50,50,14
2020,313900231,2090,2090,1290,1290,800,0,0,0,0,0,0,0,0,0,0,0,0,0,1085,60,15,20,20,1
2020,313900261,31670,4870,4870,4870,0,26800,23000,23000,0,0,3800,3800,0,0,13910,13910,13800,0,2700,240,50,400,140,78
2020,313900301,6179,679,679,679,0,5500,5500,5500,0,0,0,0,0,0,0,0,0,0,559,120,130,15,24,5
2020,313900311,7570,70,70,70,0,7500,7500,7500,0,0,0,0,0,0,4709,4709,3664,955,1464,144,140,60,30,20
2020,313900321,230,230,30,30,200,0,0,0,0,0,0,0,0,0,0,0,0,0,1246,300,180,180,84,35
2020,313900341,21980,14800,5800,5800,9000,7180,7000,0,7000,0,180,180,0,0,3900,3900,3600,0,2880,620,0,600,300,18
2020,313900351,9670,9480,6780,6780,2700,190,0,0,0,0,190,190,0,0,0,0,0,0,1908,48,12,240,84,27
2020,313900361,116000,12600,12600,12600,0,103400,98500,28500,70000,0,4900,4900,0,0,19900,14900,14880,0,2390,240,60,480,180,291
2020,313900381,400,400,100,100,300,0,0,0,0,0,0,0,0,0,10,10,0,0,973,96,36,12,96,0
2020,313900391,50250,4350,4350,4350,0,45900,45000,45000,0,0,900,900,0,0,12000,12000,7000,5000,3120,300,100,900,120,587
2020,314000102,10110,10110,110,110,10000,0,0,0,0,0,0,0,0,0,8500,8500,8500,0,1391,92,10,96,96,2
2020,314000122,59120,26120,120,120,26000,33000,30000,0,0,30000,3000,3000,0,0,11610,11610,11470,0,6490,1240,100,500,130,596
2020,314000132,2680,2680,1680,1680,1000,0,0,0,0,0,0,0,0,0,600,600,0,600,2250,1260,20,130,180,198
2020,314000142,123510,7310,7310,7310,0,116200,115000,115000,0,0,1200,1200,0,0,26752,26752,26152,100,3886,360,30,150,216,216
2020,314000162,38310,1610,1310,1310,300,36700,36000,0,36000,0,700,400,300,0,26000,26000,26000,0,1716,716,40,300,120,102
2020,314000172,26200,2600,1600,1600,1000,23600,19000,0,19000,0,4600,4600,0,0,24300,24300,0,20800,3490,1200,50,240,360,649
2020,314000182,11050,4550,1550,1550,3000,6500,5000,0,5000,0,1500,1500,0,0,1270,1270,0,1100,5470,850,100,300,240,116
2020,314000192,52098,6698,6698,6698,0,45400,44500,29500,15000,0,900,900,0,0,4100,4100,3000,0,6538,300,150,720,420,195
2020,314000302,12760,10530,2030,2030,8500,2230,0,0,0,0,2230,1700,530,0,3300,3300,0,3000,4535,804,12,840,300,3
2020,314000312,560,560,60,60,500,0,0,0,0,0,0,0,0,0,1000,1000,0,0,2713,840,40,480,276,17
2020,314000332,18400,7120,6120,3120,1000,11280,0,0,0,0,11280,3280,5000,3000,430,430,0,0,4249,1068,15,308,480,8970
2020,314000352,65730,20230,20230,20230,0,45500,45500,20500,25000,0,0,0,0,0,20000,0,0,0,667,159,24,12,24,153
2020,314000362,36240,5290,5290,5040,0,30950,30000,30000,0,0,950,950,0,0,9400,9400,9400,0,5900,180,60,300,240,240
2020,314000372,153535,11750,11750,10850,0,141785,138285,90000,3285,45000,3500,3500,0,0,63380,48380,48380,0,9800,330,120,720,360,1783
2020,314000382,25960,7960,4460,4460,3500,18000,18000,0,18000,0,0,0,0,0,13185,8185,8185,0,758,180,10,3,60,18
2020,314000392,32283,933,933,933,0,31350,31000,31000,0,0,350,350,0,0,8400,8400,8400,0,4516,301,178,336,241,103
2020,314600131,1070,1070,1070,1070,0,0,0,0,0,0,0,0,0,0,200,200,0,0,3490,1080,30,240,180,40
2020,314600161,51550,18550,3550,3550,15000,33000,30000,0,30000,0,3000,3000,0,0,37500,19500,500,16500,7176,744,480,120,432,429
2020,314600181,25562,24262,3262,3262,21000,1300,0,0,0,0,1300,800,500,0,0,0,0,0,3309,300,290,190,108,584
2020,314600301,40580,10580,10580,10580,0,30000,30000,30000,0,0,0,0,0,0,13140,13140,12640,0,2518,480,300,180,240,106
2020,314600311,70808,5908,5908,5908,0,64900,63000,55000,0,8000,1900,1900,0,0,40,40,0,0,3435,200,100,250,70,707
2020,314600321,70226,65646,20646,19946,45000,4580,3000,0,3000,0,1580,1080,500,0,33500,33500,32000,500,3496,420,20,144,156,241
2020,314600331,21280,280,280,280,0,21000,21000,21000,0,0,0,0,0,0,6350,6350,6350,0,967,260,12,40,36,21
2020,314600381,44760,4460,4460,4460,0,40300,40000,40000,0,0,300,300,0,0,15100,15100,14200,900,1700,276,24,360,240,472
2020,314600391,6005,155,155,155,0,5850,5500,5500,0,0,350,350,0,0,0,0,0,0,1470,160,150,280,100,77
2020,314700111,17192,17192,4192,4192,13000,0,0,0,0,0,0,0,0,0,8220,8220,8000,0,1560,310,100,150,200,36
2020,314700131,308895,7815,7815,7815,0,301080,260000,100000,160000,0,41080,1080,40000,0,14800,14800,13800,0,3680,250,100,180,150,191
2020,314700141,24160,3160,3160,3160,0,21000,21000,21000,0,0,0,0,0,0,0,0,0,0,1682,190,600,60,72,61
2020,314700171,13940,11440,1840,1840,9600,2500,0,0,0,0,2500,2500,0,0,0,0,0,0,2620,420,100,300,100,482
2020,314700181,66180,2680,2680,2680,0,63500,60000,60000,0,0,3500,3500,0,0,40000,40000,40000,0,3454,300,39,360,125,89
2020,314700331,259060,14960,14960,14960,0,244100,240000,70000,170000,0,4100,4100,0,0,99400,29400,29400,0,3714,480,120,480,144,662
2020,314700371,85500,1750,1750,1750,0,83750,80000,70000,10000,0,3750,3200,550,0,16533,16533,7833,8700,3288,280,300,900,276,429
2020,314700381,2380,1930,1930,1930,0,450,0,0,0,0,450,450,0,0,0,0,0,0,2102,360,100,300,72,21
2020,314800101,86360,4160,4160,4160,0,82200,78000,78000,0,0,4200,1700,2500,0,7880,7880,6500,0,2650,300,200,200,400,682
2020,314800111,105781,22781,22781,22781,0,83000,83000,71000,12000,0,0,0,0,0,12000,12000,8000,4000,3080,480,100,220,150,1341
2020,314800131,31262,30162,6162,6162,24000,1100,0,0,0,0,1100,300,800,0,12000,12000,12000,0,2688,480,60,60,240,58
2020,314800161,62622,11960,11960,11960,0,50662,50000,50000,0,0,662,210,452,0,800,800,800,0,4578,396,300,216,156,498
2020,314800171,86057,13057,13057,13057,0,73000,70000,0,70000,0,3000,3000,0,0,36000,6000,0,6000,2910,380,200,300,180,335
2020,314800181,96493,5293,5293,5293,0,91200,90000,90000,0,0,1200,1200,0,0,38723,38723,29653,8800,2570,240,140,120,168,1499
2020,314800191,500,500,0,0,500,0,0,0,0,0,0,0,0,0,7000,7000,0,5800,1561,600,1,100,60,1
2020,314800301,42613,1500,1500,1500,0,41113,34000,34000,0,0,7113,7000,113,0,19554,19554,16154,0,3878,198,20,360,360,103
2020,314800311,64244,3704,3704,3704,0,60540,59000,50000,9000,0,1540,1540,0,0,13840,7840,6640,1200,1931,294,18,489,125,93
2020,314800321,78591,24991,24991,24991,0,53600,53600,50000,400,3200,0,0,0,0,14600,14600,14100,0,5860,297,210,947,365,5404
2020,314800351,89300,18400,18400,13400,0,70900,70500,55000,15500,0,400,400,0,0,0,0,0,0,2610,420,240,400,120,547
2020,314800361,6491,2491,2491,2491,0,4000,4000,0,0,4000,0,0,0,0,1500,1500,1500,0,1452,60,20,72,120,809
2020,314800381,1015,1015,15,15,1000,0,0,0,0,0,0,0,0,0,0,0,0,0,1010,660,10,20,36,0
2020,314900101,4230,4230,3730,3730,500,0,0,0,0,0,0,0,0,0,0,0,0,0,1726,600,6,120,240,149
2020,314900141,630,630,130,130,500,0,0,0,0,0,0,0,0,0,0,0,0,0,546,216,36,6,12,1
2020,314900181,37976,36276,6276,6276,30000,1700,0,0,0,0,1700,1700,0,0,11820,11820,11800,0,4760,202,360,300,144,483
2020,314900191,30480,23980,6980,3980,17000,6500,0,0,0,0,6500,2000,1500,3000,15694,15694,13600,0,4667,502,96,120,247,58
2020,314900321,27270,25470,470,470,25000,1800,0,0,0,0,1800,1800,0,0,86,86,0,0,3728,260,10,290,300,42
2020,314900331,2513,2213,1713,1713,500,300,0,0,0,0,300,300,0,0,0,0,0,0,2433,619,25,127,82,417
2020,314900351,1719,1719,39,39,1680,0,0,0,0,0,0,0,0,0,0,0,0,0,876,572,12,24,25,1
2020,314900361,91020,170,170,170,0,90850,90000,0,90000,0,850,850,0,0,5000,5000,4000,1000,2090,420,80,168,264,161
2020,314900371,37260,2760,2760,2760,0,34500,34000,34000,0,0,500,500,0,0,0,0,0,0,3261,420,853,324,144,93
2020,314900381,1757,1257,757,757,500,500,0,0,0,0,500,500,0,0,19000,19000,19000,0,2420,300,30,480,400,150
2020,314900391,22116,21416,2416,2416,19000,700,0,0,0,0,700,500,200,0,16590,16590,15500,1000,2786,360,50,440,216,75
2020,315000102,6437,4437,1937,1937,2500,2000,0,0,0,0,2000,2000,0,0,200,200,0,0,4290,1080,72,222,132,4
2020,315000112,63468,21668,21668,21668,0,41800,38000,38000,0,0,3800,1800,0,2000,1000,1000,1000,0,2850,241,100,780,180,115
2020,315000142,87609,14125,14125,14125,0,73484,72000,61000,11000,0,1484,1484,0,0,38261,38261,37500,500,2828,480,10,120,56,176
2020,315000152,314,314,160,160,154,0,0,0,0,0,0,0,0,0,0,0,0,0,715,120,2,5,22,0
2020,315000162,170,170,10,10,160,0,0,0,0,0,0,0,0,0,50,50,0,0,425,60,5,10,90,1
2020,315000172,203070,2000,2000,2000,0,201070,200000,150000,50000,0,1070,1070,0,0,22500,20000,20000,0,2050,200,10,150,150,383
2020,315000182,3200,3200,1200,1200,2000,0,0,0,0,0,0,0,0,0,0,0,0,0,2558,1740,10,120,120,50
2020,315000192,23710,8010,8010,8010,0,15700,15700,15700,0,0,0,0,0,0,9031,9031,9031,0,3388,480,50,60,292,77
2020,315000302,46090,14290,14290,14290,0,31800,31000,25000,6000,0,800,800,0,0,7500,3000,3000,0,1748,324,60,324,180,306
2020,315000312,41560,60,60,60,0,41500,41000,21000,20000,0,500,500,0,0,0,0,0,0,932,180,30,240,72,33
2020,315000332,125100,10300,10300,10300,0,114800,105000,85000,20000,0,9800,9800,0,0,16476,5976,5000,0,4592,276,1700,384,72,137
2020,315000342,28470,2970,2970,2970,0,25500,25000,25000,0,0,500,500,0,0,4000,4000,4000,0,3156,110,190,309,87,91
2020,315000352,20917,3500,3500,3500,0,17417,15000,15000,0,0,2417,2417,0,0,7700,7700,7000,700,3540,250,150,200,300,246
2020,315000362,20721,2653,2653,2653,0,18068,18000,18000,0,0,68,0,68,0,8748,8748,8748,0,1992,210,150,160,264,92
2020,315000372,22800,1700,1700,1700,0,21100,20750,20750,0,0,350,350,0,0,60,60,0,0,1638,144,10,280,84,71
2020,315600101,267580,11080,11080,11080,0,256500,256000,250000,6000,0,500,500,0,0,300,0,0,0,6000,660,120,60,360,5185
2020,315600121,94663,13363,13363,6363,0,81300,70000,60000,10000,0,11300,4300,0,7000,20320,12320,11320,0,3910,240,1000,250,360,98
2020,315600161,294024,38724,38724,28724,0,255300,250000,250000,0,0,5300,1300,4000,0,154500,4500,2500,2000,3410,720,50,100,110,151
2020,315600311,26760,5060,5060,5060,0,21700,21500,21500,0,0,200,200,0,0,0,0,0,0,2424,168,50,960,96,60
2020,315600321,6490,6490,490,490,6000,0,0,0,0,0,0,0,0,0,30,30,0,0,574,95,155,12,48,2
2020,315600341,12420,12320,2320,2320,10000,100,0,0,0,0,100,100,0,0,9176,9176,7000,2000,3634,360,200,480,180,474
2020,315600371,9310,1810,1810,1810,0,7500,7500,7500,0,0,0,0,0,0,0,0,0,0,2374,156,123,187,142,60
2020,315600391,63780,18480,18480,8480,0,45300,45000,45000,0,0,300,300,0,0,10302,10302,8260,2000,3769,280,204,240,210,85
2020,315700111,16468,1468,1468,1468,0,15000,15000,15000,0,0,0,0,0,0,0,0,0,0,2080,200,500,150,100,27
2020,315700141,39561,35059,13059,13059,22000,4502,3172,0,0,3172,1330,1330,0,0,8300,8300,6000,1950,5900,400,500,800,400,185
2020,315700151,5670,5670,170,170,5500,0,0,0,0,0,0,0,0,0,1830,1830,0,1800,898,360,12,96,120,5
2020,315700161,41868,13868,13868,11868,0,28000,24000,24000,0,0,4000,1000,0,3000,11700,11700,11700,0,1870,156,100,108,162,34
2020,315700181,282908,17008,17008,17008,0,265900,265000,250000,15000,0,900,900,0,0,700,0,0,0,2950,480,120,100,180,625
2020,315700191,19242,15442,11842,11842,3600,3800,0,0,0,0,3800,1300,0,2500,0,0,0,0,1970,240,30,840,100,40
2020,315700301,16427,15662,1662,1662,14000,765,0,0,0,0,765,700,65,0,3015,3015,3000,0,4000,180,156,480,400,202
2020,315700341,50839,18239,18239,18239,0,32600,30000,30000,0,0,2600,2600,0,0,3880,3880,2880,1000,4800,300,1600,150,200,75
2020,315700381,6593,6593,1893,1893,4700,0,0,0,0,0,0,0,0,0,0,0,0,0,2534,408,60,180,144,4
2020,315800121,1909,1909,9,9,1900,0,0,0,0,0,0,0,0,0,1640,1640,1640,0,1512,324,10,120,168,1
2020,315800131,18438,18078,2078,2078,16000,360,0,0,0,0,360,360,0,0,14000,14000,14000,0,2247,63,50,300,480,119
2020,315800141,64000,9500,1000,1000,8500,54500,54000,0,54000,0,500,500,0,0,6000,6000,0,6000,2640,100,0,480,180,217
2020,315800171,58500,6200,6200,6200,0,52300,50000,50000,0,0,2300,2300,0,0,3100,1800,0,0,2627,240,120,87,185,236
2020,315800191,138500,18400,18400,18400,0,120100,120000,110000,10000,0,100,100,0,0,0,0,0,0,1670,360,60,180,40,484
2020,315900121,19025,25,25,25,0,19000,19000,19000,0,0,0,0,0,0,0,0,0,0,648,60,30,24,36,5
2020,315900131,18336,7336,7336,7336,0,11000,11000,11000,0,0,0,0,0,0,4900,4900,3500,0,1295,176,40,204,84,127
2020,315900141,41394,1394,1394,1394,0,40000,40000,40000,0,0,0,0,0,0,7030,3030,3000,0,1375,168,200,96,120,33
2020,315900171,873,873,47,47,826,0,0,0,0,0,0,0,0,0,0,0,0,0,693,240,12,0,15,1
2020,315900191,12840,11140,4140,4140,7000,1700,0,0,0,0,1700,1700,0,0,0,0,0,0,1213,150,100,55,72,138
2020,315900301,18120,300,300,300,0,17820,17700,5700,12000,0,120,120,0,0,7810,5810,5810,0,1687,180,20,300,12,34
2020,315900311,45171,16521,16521,16521,0,28650,26000,26000,0,0,2650,2650,0,0,13170,13170,11910,0,6560,400,240,1000,480,728
2020,315900321,59434,5534,5534,5534,0,53900,51000,26000,25000,0,2900,2900,0,0,770,770,0,0,5050,360,50,650,600,1029
2020,315900351,8300,8300,300,300,8000,0,0,0,0,0,0,0,0,0,80,80,0,0,1624,180,20,60,240,1
2020,315900361,46247,2747,2747,2747,0,43500,41000,16000,25000,0,2500,2500,0,0,3800,3800,3600,200,3762,200,140,140,300,176
2020,315900371,22930,19300,12300,12300,7000,3630,0,0,0,0,3630,3500,130,0,2300,2300,0,2300,1796,444,365,120,84,224
2020,315900381,5059,3059,3059,3059,0,2000,2000,0,0,2000,0,0,0,0,1598,1598,1190,0,2355,300,40,200,360,18
2020,315900391,12620,12620,120,120,12500,0,0,0,0,0,0,0,0,0,0,0,0,0,1800,192,0,10,84,29
2020,316000112,52560,460,460,460,0,52100,52000,52000,0,0,100,0,100,0,23000,0,0,0,611,139,120,20,20,75
2020,316000142,13890,13890,890,890,13000,0,0,0,0,0,0,0,0,0,0,0,0,0,1183,283,10,60,120,6
2020,316000152,78003,3,3,3,0,78000,78000,38000,40000,0,0,0,0,0,51000,16000,12800,1400,2100,120,180,120,204,129
2020,316000162,19200,19200,10200,7200,9000,0,0,0,0,0,0,0,0,0,2280,2280,0,2280,1090,60,10,144,72,127
2020,316000172,20230,230,230,230,0,20000,20000,20000,0,0,0,0,0,0,0,0,0,0,1298,120,20,30,72,12
2020,316000182,55300,5300,5300,300,0,50000,50000,50000,0,0,0,0,0,0,0,0,0,0,1830,120,20,120,96,79
2020,316000302,2730,230,230,230,0,2500,0,0,0,0,2500,2500,0,0,4040,4040,4000,0,1035,300,24,120,96,148
2020,316000322,149500,29400,400,400,29000,120100,120000,0,120000,0,100,100,0,0,6000,0,0,0,2910,600,800,200,60,779
2020,316000332,54411,7271,7271,7271,0,47140,46000,46000,0,0,1140,1140,0,0,16500,16500,16500,0,2796,216,20,480,240,668
2020,316000342,46000,500,500,500,0,45500,45000,45000,0,0,500,500,0,0,2000,2000,0,2000,2430,300,200,500,200,138
2020,316000362,85580,9430,9430,9430,0,76150,75500,52000,21000,2500,650,650,0,0,26900,26900,26000,0,3482,408,100,480,300,177
2020,316000372,172808,16408,16408,16408,0,156400,150000,60000,90000,0,6400,6400,0,0,53000,18000,18000,0,9288,515,30,264,240,4967
2020,316000392,11590,10,10,10,0,11580,9720,9720,0,0,1860,1860,0,0,0,0,0,0,884,108,24,156,96,35
2020,316600121,19060,18250,2250,2250,16000,810,0,0,0,0,810,810,0,0,6000,6000,6000,0,1270,180,30,200,180,28
2020,316600131,53993,925,925,925,0,53068,50000,40000,10000,0,3068,3000,68,0,8900,8900,8500,250,2797,224,60,474,139,147
2020,316600151,100450,1050,1050,1050,0,99400,98000,85000,13000,0,1400,1400,0,0,9000,9000,9000,0,3840,240,60,60,120,137
2020,316600161,110458,19958,19958,19958,0,90500,86000,80000,6000,0,4500,2500,2000,0,0,0,0,0,2331,408,30,432,96,330
2020,316600171,102310,11110,11110,11110,0,91200,90000,90000,0,0,1200,1200,0,0,12300,12300,12000,300,4108,240,50,240,240,642
2020,316600181,7550,6850,1850,1850,5000,700,0,0,0,0,700,700,0,0,3140,3140,0,2140,7717,1800,700,500,400,81
2020,316600191,95991,55191,22191,22191,33000,40800,40000,0,40000,0,800,800,0,0,37000,7000,0,0,4470,250,100,50,120,1192
2020,316600301,86200,1000,1000,0,0,85200,83000,48000,35000,0,2200,1000,1200,0,50000,30000,27000,3000,3600,216,100,370,228,514
2020,316600311,76037,75142,48142,48142,27000,895,0,0,0,0,895,382,513,0,2190,2190,0,2190,4924,450,60,240,456,2604
2020,316600371,56109,4309,4309,4309,0,51800,50000,50000,0,0,1800,1500,300,0,2500,2500,2500,0,7160,360,100,500,300,1285
2020,316700111,16556,13056,9056,9056,4000,3500,0,0,0,0,3500,3500,0,0,3652,3652,350,0,1863,130,65,300,148,61
2020,316700131,49825,3525,3525,3525,0,46300,45000,25000,20000,0,1300,1300,0,0,556,556,0,0,2310,200,100,360,120,71
2020,316700141,3620,3620,2620,2620,1000,0,0,0,0,0,0,0,0,0,0,0,0,0,1933,744,60,120,156,11
2020,316700161,227450,7450,7450,7450,0,220000,220000,220000,0,0,0,0,0,0,3000,0,0,0,974,84,48,12,62,137
2020,316700171,24872,24722,6222,6222,18500,150,0,0,0,0,150,150,0,0,15150,15150,14800,300,3181,182,125,120,241,131
2020,316700181,23220,21620,21620,8620,0,1600,0,0,0,0,1600,1600,0,0,0,0,0,0,2699,120,160,240,109,76
2020,316700191,160655,4655,4655,4655,0,156000,155000,100000,55000,0,1000,1000,0,0,44360,19360,19360,0,3720,420,120,180,240,399
2020,316700301,64804,15704,15704,15704,0,49100,47600,38000,9600,0,1500,1500,0,0,0,0,0,0,3496,192,300,480,300,442
2020,316700311,88804,2604,2604,2604,0,86200,85000,85000,0,0,1200,1200,0,0,42000,42000,41400,600,4110,360,50,300,200,230
2020,316700321,95288,7988,7988,7988,0,87300,87000,80000,7000,0,300,300,0,0,700,700,0,700,3144,264,20,240,240,92
2020,316700341,52550,1550,1550,1550,0,51000,50000,50000,0,0,1000,1000,0,0,20139,20139,20139,0,3430,360,340,310,180,135
2020,316700371,1700,1700,1400,1400,300,0,0,0,0,0,0,0,0,0,0,0,0,0,580,120,120,50,20,1
2020,316700381,362800,27200,27200,27200,0,335600,335000,100000,235000,0,600,600,0,0,32000,19000,0,19000,3900,250,50,600,240,2817
2020,316800101,4050,4050,50,50,4000,0,0,0,0,0,0,0,0,0,5000,5000,0,0,1872,1080,240,120,72,6
2020,316800141,21152,18852,852,852,18000,2300,0,0,0,0,2300,2200,100,0,1744,1744,0,1600,2113,216,180,288,324,138
2020,316800161,2666,2666,166,166,2500,0,0,0,0,0,0,0,0,0,0,0,0,0,1196,480,10,120,60,20
2020,316800181,6680,6680,680,680,6000,0,0,0,0,0,0,0,0,0,3480,3480,3000,480,1330,516,36,48,60,1
2020,316800301,78620,120,120,120,0,78500,76000,58000,18000,0,2500,2500,0,0,38600,25600,25000,0,5984,300,200,600,400,412
2020,316800321,1915,1915,1015,1015,900,0,0,0,0,0,0,0,0,0,0,0,0,0,507,240,24,36,15,1
2020,316800341,20102,1172,1172,1172,0,18930,18600,6000,12600,0,330,180,150,0,0,0,0,0,1250,350,60,240,156,136
2020,316800361,35432,2432,2432,2432,0,33000,30000,30000,0,0,3000,2800,200,0,19770,19770,16170,3600,2208,216,24,432,288,115
2020,316800391,25318,2918,2918,2918,0,22400,20500,20500,0,0,1900,1900,0,0,400,400,400,0,2190,360,150,210,120,112
2020,316900111,22676,676,676,676,0,22000,22000,22000,0,0,0,0,0,0,86,86,0,0,1860,120,80,216,168,31
2020,316900121,2130,667,517,517,150,1463,0,0,0,0,1463,1407,56,0,50,50,0,0,584,53,0,120,23,0
2020,316900131,43593,593,593,593,0,43000,43000,43000,0,0,0,0,0,0,0,0,0,0,877,192,60,10,43,37
2020,316900141,72911,28911,3911,3911,25000,44000,43000,0,43000,0,1000,500,500,0,42252,16252,16252,0,2956,324,781,204,132,86
2020,316900151,13542,1542,1542,1542,0,12000,12000,12000,0,0,0,0,0,0,0,0,0,0,573,100,60,10,52,23
2020,316900161,413848,2548,2548,2548,0,411300,410000,210000,200000,0,1300,1300,0,0,236000,209000,129000,80000,6760,840,0,700,180,2690
2020,316900171,8162,8162,162,162,8000,0,0,0,0,0,0,0,0,0,170,170,0,0,2159,120,350,156,96,7
2020,316900181,200330,5330,5330,5330,0,195000,195000,35000,160000,0,0,0,0,0,21175,175,0,150,2112,240,660,36,72,759
2020,316900311,9212,8712,3712,3712,5000,500,0,0,0,0,500,500,0,0,1150,1150,1150,0,3423,300,700,180,133,33
2020,316900321,33180,2180,2180,2180,0,31000,25000,25000,0,0,6000,6000,0,0,16000,16000,13000,0,3210,300,300,100,180,834
2020,316900331,1100,1100,100,100,1000,0,0,0,0,0,0,0,0,0,11000,11000,0,10000,2424,960,60,300,120,1
2020,316900341,9471,1281,281,281,1000,8190,0,0,0,0,8190,2190,6000,0,2040,2040,0,0,2520,1140,20,100,100,7
2020,316900361,70915,6620,6620,6620,0,64295,63000,63000,0,0,1295,795,500,0,28000,28000,15000,13000,3908,420,30,100,108,1105
2020,317000112,14050,4050,2050,2050,2000,10000,10000,0,10000,0,0,0,0,0,0,0,0,0,2916,1200,300,60,120,22
2020,317000122,1196,796,496,496,300,400,0,0,0,0,400,400,0,0,400,400,0,0,1034,396,25,28,150,1473
2020,317000132,7040,7040,40,40,7000,0,0,0,0,0,0,0,0,0,300,300,0,300,1968,480,120,60,180,2
2020,317000142,120110,110,110,110,0,120000,120000,120000,0,0,0,0,0,0,0,0,0,0,2330,400,500,30,30,1625
2020,317000152,75100,14100,14100,14100,0,61000,60000,60000,0,0,1000,1000,0,0,24580,24580,19580,5000,1140,120,60,120,120,431
2020,317000162,32710,32210,9210,9210,23000,500,0,0,0,0,500,300,200,0,450,450,0,300,3133,172,20,340,320,51
2020,317000182,50050,50,50,50,0,50000,50000,50000,0,0,0,0,0,0,0,0,0,0,1011,180,100,120,48,102
2020,317000192,6380,6380,5880,5880,500,0,0,0,0,0,0,0,0,0,0,0,0,0,2782,960,10,192,240,1
2020,317000302,17156,12466,2466,2466,10000,4690,3000,0,3000,0,1690,1690,0,0,0,0,0,0,3774,744,120,600,360,464
2020,317000312,7751,7511,11,11,7500,240,0,0,0,0,240,240,0,0,8035,8035,8000,0,3176,576,150,420,120,17
2020,317000332,3305,1505,505,505,1000,1800,0,0,0,0,1800,1800,0,0,1590,1590,0,0,1268,360,36,80,60,1
2020,317000352,53946,6246,6246,6246,0,47700,43400,30900,12500,0,4300,3800,500,0,29100,17100,17100,0,2800,300,200,300,400,91
2020,317000372,22400,21950,1950,1950,20000,450,0,0,0,0,450,450,0,0,1700,1700,0,1700,3036,396,24,240,240,105
2020,317000382,49790,500,500,500,0,49290,48000,48000,0,0,1290,1290,0,0,0,0,0,0,5942,360,150,720,300,4322
2020,317000392,61600,6300,6300,2300,0,55300,52000,16000,36000,0,3300,300,3000,0,0,0,0,0,3812,384,180,240,180,187
2020,317600131,82170,700,700,700,0,81470,80000,80000,0,0,1470,1470,0,0,18740,18740,17940,800,2256,240,36,120,240,102
2020,317600141,84820,9320,9320,9320,0,75500,75000,75000,0,0,500,500,0,0,4000,4000,4000,0,5390,380,90,400,280,1845
2020,317600151,33100,2900,2900,2900,0,30200,30000,30000,0,0,200,200,0,0,5300,5300,4600,700,2913,200,75,420,288,73
2020,317600171,152759,759,759,759,0,152000,150000,150000,0,0,2000,2000,0,0,26130,26130,25850,0,3280,800,250,300,150,527
2020,317600181,246800,6300,300,300,6000,240500,240000,0,240000,0,500,500,0,0,28000,0,0,0,1870,300,100,30,200,1414
2020,317600301,30440,1640,1640,1640,0,28800,28000,28000,0,0,800,800,0,0,0,0,0,0,1148,312,140,60,42,66
2020,317600311,29300,12100,12100,12100,0,17200,16500,16500,0,0,700,700,0,0,0,0,0,0,1460,250,350,200,120,140
2020,317600341,1811,1811,11,11,1800,0,0,0,0,0,0,0,0,0,1200,1200,1200,0,852,138,350,40,24,1
2020,317600351,104632,22132,22132,22132,0,82500,79000,23000,56000,0,3500,3500,0,0,15400,15400,15400,0,3720,300,100,240,240,131
2020,317600371,48978,578,578,578,0,48400,48000,48000,0,0,400,400,0,0,0,0,0,0,3040,420,100,300,240,498
2020,317600381,181360,3420,3420,3420,0,177940,163000,35000,128000,0,14940,940,14000,0,16500,16000,16000,0,2355,310,52,273,70,189
2020,317600391,60180,10630,10630,10630,0,49550,48000,48000,0,0,1550,1550,0,0,13600,13600,13600,0,1955,145,200,250,84,205
2020,317700101,27470,27470,13470,13470,14000,0,0,0,0,0,0,0,0,0,4000,4000,4000,0,1150,120,20,100,150,1
2020,317700111,18123,18123,2123,2123,16000,0,0,0,0,0,0,0,0,0,13664,13664,4000,9654,2066,96,12,84,84,427
2020,317700131,13970,13970,1970,1970,12000,0,0,0,0,0,0,0,0,0,5050,5050,5000,0,2851,93,12,120,190,11
2020,317700141,2500,2500,500,500,2000,0,0,0,0,0,0,0,0,0,0,0,0,0,1336,456,10,108,78,1
2020,317700161,23570,3570,3570,3570,0,20000,20000,8000,12000,0,0,0,0,0,6101,101,0,0,2164,129,350,72,46,13
2020,317700181,59270,270,270,270,0,59000,59000,47000,12000,0,0,0,0,0,1000,0,0,0,1960,620,60,100,100,124
2020,317700321,22133,3483,3483,3483,0,18650,15800,15800,0,0,2850,2850,0,0,60,60,0,0,3757,360,135,215,132,356
2020,317700341,1085,35,35,35,0,1050,0,0,0,0,1050,1050,0,0,0,0,0,0,2250,370,100,600,240,64
2020,317700351,1200,400,400,400,0,800,0,0,0,0,800,800,0,0,0,0,0,0,2876,600,60,360,240,47
2020,317700381,29450,150,150,150,0,29300,26000,26000,0,0,3300,3300,0,0,13880,13880,13500,0,3873,936,500,480,540,88
2020,317700391,29000,1000,1000,1000,0,28000,26000,26000,0,0,2000,2000,0,0,39300,39300,14000,25000,3300,480,240,360,180,283
2020,317800101,11700,11700,4700,4700,7000,0,0,0,0,0,0,0,0,0,180,180,0,0,2550,400,100,110,120,33
2020,317800121,935740,63240,63240,58240,0,872500,850000,250000,600000,0,22500,11500,11000,0,326000,301000,300000,0,8352,480,60,72,240,25666
2020,317800131,138200,130200,10200,10200,120000,8000,0,0,0,0,8000,8000,0,0,5000,5000,0,4000,13980,800,400,500,480,2046
2020,317800151,149370,14470,14470,14470,0,134900,130000,130000,0,0,4900,4900,0,0,18000,18000,0,18000,5300,400,100,300,200,2187
2020,317800171,12010,12010,10,10,12000,0,0,0,0,0,0,0,0,0,11400,11400,11400,0,2685,204,216,300,300,15
2020,317800191,50,50,50,50,0,0,0,0,0,0,0,0,0,0,0,0,0,0,506,60,50,48,18,1
2020,317800301,1934,1834,834,834,1000,100,0,0,0,0,100,100,0,0,36,36,0,0,3906,660,240,480,186,96
2020,317800321,145180,4980,4980,4980,0,140200,140000,33000,107000,0,200,200,0,0,98000,98000,48000,5000,3600,520,250,680,180,3198
2020,317800331,19980,1880,1880,1880,0,18100,16000,16000,0,0,2100,1900,200,0,600,600,600,0,1811,920,100,50,60,59
2020,317800361,19175,1175,1175,1175,0,18000,18000,18000,0,0,0,0,0,0,0,0,0,0,1480,180,450,60,36,38
2020,317800371,55100,100,100,100,0,55000,55000,25000,30000,0,0,0,0,0,13900,13900,13900,0,845,365,36,12,36,33
2020,317800381,50048,2548,2548,2548,0,47500,46000,46000,0,0,1500,1500,0,0,2700,0,0,0,1971,320,80,240,96,212
2020,317900111,77100,6450,6450,6450,0,70650,70000,70000,0,0,650,650,0,0,4410,4410,4230,0,3070,200,500,120,120,52
2020,317900141,27000,27000,11000,11000,16000,0,0,0,0,0,0,0,0,0,2000,2000,0,2000,1362,144,30,60,48,390
2020,317900151,831,831,331,331,500,0,0,0,0,0,0,0,0,0,0,0,0,0,939,120,1,180,180,0
2020,317900161,3440,3440,2440,2440,1000,0,0,0,0,0,0,0,0,0,0,0,0,0,594,240,72,12,48,9
2020,317900171,108524,4524,4524,4524,0,104000,104000,90000,14000,0,0,0,0,0,1000,0,0,0,2080,600,100,50,60,255
2020,317900191,134648,2648,2648,2648,0,132000,130000,130000,0,0,2000,2000,0,0,0,0,0,0,4200,360,90,200,100,1320
2020,317900311,45380,7080,7080,7080,0,38300,30000,15000,15000,0,8300,8300,0,0,0,0,0,0,2225,140,15,360,180,69
2020,317900351,383055,80905,80905,80905,0,302150,300000,50000,250000,0,2150,850,1300,0,5000,0,0,0,4906,550,750,310,130,2160
2020,317900361,51080,15330,15330,13330,0,35750,32000,22000,10000,0,3750,2750,1000,0,24600,17100,14600,0,3470,420,550,420,240,112
2020,317900371,44260,3860,3860,3860,0,40400,36000,36000,0,0,4400,4400,0,0,0,0,0,0,6800,480,60,600,360,3007
2020,317900381,32192,7592,7592,7592,0,24600,17000,17000,0,0,7600,7600,0,0,7700,7700,7700,0,3600,260,120,580,192,144
2020,317900391,15362,14762,14762,14762,0,600,0,0,0,0,600,600,0,0,2070,2070,0,1270,4014,180,50,420,300,114
2020,318000102,20850,550,550,550,0,20300,20300,20300,0,0,0,0,0,0,0,0,0,0,1260,120,120,120,120,16
2020,318000112,5470,5350,5000,5000,350,120,0,0,0,0,120,120,0,0,0,0,0,0,2999,243,300,408,174,262
2020,318000132,1210,510,10,10,500,700,0,0,0,0,700,700,0,0,9176,9176,2800,2776,3440,500,300,1000,200,87
2020,318000182,315000,23000,23000,2500,0,292000,290500,270000,20500,0,1500,1000,500,0,3000,0,0,0,3980,840,400,240,100,6301
2020,318000312,6447,5797,4197,4197,1600,650,0,0,0,0,650,650,0,0,540,540,0,0,1610,290,70,180,120,64
2020,318000322,31250,11700,11700,10700,0,19550,12000,12000,0,0,7550,7550,0,0,4300,4300,0,0,3126,300,36,360,240,1055
2020,318600151,51236,15986,15986,15986,0,35250,35000,35000,0,0,250,250,0,0,6600,6500,6500,0,2160,200,100,240,120,283
2020,318600301,4500,4400,900,900,3500,100,0,0,0,0,100,100,0,0,0,0,0,0,768,84,6,100,18,27
2020,318600311,91260,1760,1760,1760,0,89500,69000,15000,54000,0,20500,500,20000,0,36800,36800,36800,0,1608,240,12,300,96,72
2020,318600351,7466,7266,3266,3266,4000,200,0,0,0,0,200,200,0,0,40,40,0,0,994,120,10,150,84,101
2020,318700101,14752,14752,1752,1752,13000,0,0,0,0,0,0,0,0,0,0,0,0,0,1070,644,40,10,72,1
2020,318700111,997550,412350,412350,412350,0,585200,580000,310000,270000,0,5200,4200,1000,0,120000,0,0,0,11190,1080,20,860,480,2695
2020,318700121,464050,53050,53050,53050,0,411000,390000,280000,110000,0,21000,9000,12000,0,8000,0,0,0,4544,620,500,300,160,1637
2020,318700181,82300,2100,2100,2100,0,80200,80000,80000,0,0,200,200,0,0,6630,6630,6630,0,3448,420,1000,360,268,690
2020,318700311,32318,8318,8318,8318,0,24000,20000,20000,0,0,4000,4000,0,0,0,0,0,0,3510,260,150,380,120,115
2020,318700321,38326,2834,2834,2834,0,35492,23900,23900,0,0,11592,9592,0,2000,1100,1100,0,1100,2274,324,50,360,180,48
2020,318700331,22304,17704,17704,17704,0,4600,0,0,0,0,4600,4600,0,0,3000,3000,0,3000,4460,600,240,600,360,1949
2020,318700371,40900,35400,400,400,35000,5500,0,0,0,0,5500,5500,0,0,34500,34500,32000,0,2900,240,50,600,240,62
2020,318800121,6795,1795,295,295,1500,5000,5000,0,5000,0,0,0,0,0,0,0,0,0,738,72,240,12,42,22
2020,318800131,47232,44514,6514,6514,38000,2718,2500,0,2500,0,218,150,68,0,18500,18500,16000,2500,2360,300,20,240,180,839
2020,318800141,501,501,1,1,500,0,0,0,0,0,0,0,0,0,0,0,0,0,1680,1080,20,180,60,1
2020,318800161,2720,2720,2720,2720,0,0,0,0,0,0,0,0,0,0,0,0,0,0,1342,360,10,120,120,54
2020,318800311,50194,3394,3394,3394,0,46800,30000,25000,5000,0,16800,300,16500,0,16600,16600,6000,10000,1124,200,10,150,84,61
2020,318800321,33900,7400,7400,400,0,26500,24500,24500,0,0,2000,2000,0,0,15390,15390,13500,0,1209,132,5,360,72,145
2020,318900111,13134,13134,3134,3134,10000,0,0,0,0,0,0,0,0,0,0,0,0,0,2050,500,30,150,170,3
2020,318900131,160,160,10,10,150,0,0,0,0,0,0,0,0,0,500,500,0,0,600,108,50,10,42,1
2020,318900151,404707,2007,2007,2007,0,402700,400000,400000,0,0,2700,2500,200,0,0,0,0,0,3132,600,600,100,72,911
2020,318900171,38400,35900,19900,16900,16000,2500,0,0,0,0,2500,2500,0,0,0,0,0,0,6120,180,400,400,240,426
2020,318900191,137260,160,160,160,0,137100,137000,87000,50000,0,100,0,100,0,12000,10000,10000,0,2846,200,100,30,70,224
2020,318900301,28836,5736,5736,5736,0,23100,20000,20000,0,0,3100,3100,0,0,0,0,0,0,2040,240,60,360,240,75
2020,318900311,4100,4100,4100,4100,0,0,0,0,0,0,0,0,0,0,0,0,0,0,568,84,50,50,24,18
2020,318900321,35268,5768,5768,5768,0,29500,27000,20000,7000,0,2500,2500,0,0,0,0,0,0,1200,270,10,200,80,58
2020,319000102,86000,2500,2500,2500,0,83500,80000,80000,0,0,3500,3500,0,0,30100,30100,30000,0,4660,600,100,500,400,270
2020,319000122,4960,4960,1960,1960,3000,0,0,0,0,0,0,0,0,0,0,0,0,0,2484,816,0,600,108,10
2020,319000142,29720,29570,4570,4570,25000,150,0,0,0,0,150,100,50,0,500,500,0,500,4200,360,60,100,180,161
2020,319000162,159000,39000,4000,4000,35000,120000,120000,0,120000,0,0,0,0,0,25000,0,0,0,2400,216,50,36,64,232
2020,319000172,71100,100,100,100,0,71000,71000,71000,0,0,0,0,0,0,0,0,0,0,950,348,100,12,0,86
2020,319000182,1520,320,20,20,300,1200,0,0,0,0,1200,1200,0,0,0,0,0,0,2100,420,180,180,240,88
2020,319000192,5140,4690,690,690,4000,450,0,0,0,0,450,450,0,0,3200,3200,3200,0,1314,50,3,360,180,15
2020,319600111,300095,80095,20095,20095,60000,220000,215000,0,215000,0,5000,2000,3000,0,95000,13000,13000,0,4174,360,50,200,144,1165
2020,319600181,118470,5180,5180,5180,0,113290,110000,90000,20000,0,3290,3290,0,0,9300,9000,0,9000,7660,720,300,600,420,1850
2020,319600191,121500,1200,1200,1200,0,120300,120000,100000,20000,0,300,300,0,0,5000,0,0,0,2374,300,360,360,96,5743
2020,319700101,200,200,200,200,0,0,0,0,0,0,0,0,0,0,0,0,0,0,1800,132,120,100,60,1
2020,319700141,122000,2000,2000,2000,0,120000,120000,120000,0,0,0,0,0,0,680,180,0,0,6020,480,1800,0,120,145
2020,319700181,1120,1120,420,420,700,0,0,0,0,0,0,0,0,0,0,0,0,0,1917,192,240,239,310,24
2020,319800111,73464,5244,5244,5244,0,68220,68000,68000,0,0,220,220,0,0,0,0,0,0,2925,325,50,280,20,1329
2020,319800121,138400,3400,3400,3400,0,135000,130000,75000,55000,0,5000,1500,3500,0,34300,3300,3300,0,3330,240,100,50,60,182
2020,319800141,7002,7002,2,2,7000,0,0,0,0,0,0,0,0,0,0,0,0,0,2372,240,10,120,156,21
2020,319800151,39580,3580,3580,3580,0,36000,36000,36000,0,0,0,0,0,0,0,0,0,0,3257,1240,300,20,60,61
2020,319800161,11621,11121,121,121,11000,500,0,0,0,0,500,500,0,0,0,0,0,0,2146,120,120,90,180,27
2020,319900111,1500,1500,1000,1000,500,0,0,0,0,0,0,0,0,0,0,0,0,0,1960,240,120,100,120,1
2020,319900131,13046,12046,2046,2046,10000,1000,0,0,0,0,1000,1000,0,0,0,0,0,0,3145,115,700,60,240,20
2020,319900141,20800,20450,450,450,20000,350,0,0,0,0,350,350,0,0,5570,5570,5170,0,1917,125,40,180,72,358
2020,319900161,9050,9050,50,50,9000,0,0,0,0,0,0,0,0,0,0,0,0,0,312,120,36,0,24,1
2020,320000202,33186,186,186,186,0,33000,23000,23000,0,0,10000,0,10000,0,10000,10000,10000,0,1140,144,140,15,20,15
2020,320000222,42030,29530,29530,29530,0,12500,12000,12000,0,0,500,500,0,0,0,0,0,0,5084,210,100,800,204,167
2020,320000232,330,330,30,30,300,0,0,0,0,0,0,0,0,0,0,0,0,0,1460,400,150,10,40,1
2020,320000242,33840,10440,10440,10440,0,23400,22000,0,22000,0,1400,1300,100,0,16500,8000,8000,0,2800,220,100,200,100,701
2020,320000252,5900,3800,800,800,3000,2100,0,0,0,0,2100,1300,800,0,300,300,0,300,3252,1100,10,380,216,86
2020,320000272,32624,4024,4024,4024,0,28600,27800,27800,0,0,800,800,0,0,2000,0,0,0,1530,200,150,200,60,82
2020,320000292,43344,42344,22344,22344,20000,1000,0,0,0,0,1000,1000,0,0,0,0,0,0,1652,400,200,130,80,51
2020,320000302,11740,10240,7740,7740,2500,1500,0,0,0,0,1500,1500,0,0,1300,1300,0,1300,1987,396,60,360,96,67
2020,320000312,9756,8456,2456,2456,6000,1300,0,0,0,0,1300,1300,0,0,5000,5000,5000,0,2372,234,60,384,174,57
2020,320000322,28115,8315,8315,8315,0,19800,18000,18000,0,0,1800,1800,0,0,0,0,0,0,1117,222,120,126,48,47
2020,320000332,25128,7778,7778,7778,0,17350,17000,17000,0,0,350,350,0,0,6960,6960,5000,1900,4548,540,50,480,360,329
2020,320000342,3130,3130,130,130,3000,0,0,0,0,0,0,0,0,0,0,0,0,0,1135,660,10,10,20,1
2020,320000352,28750,3150,3150,3150,0,25600,25000,25000,0,0,600,600,0,0,0,0,0,0,1300,300,50,100,60,41
2020,320000362,10661,735,735,735,0,9926,9500,9500,0,0,426,200,226,0,4500,4500,4000,0,2440,310,100,120,300,20
2020,320000372,31614,8414,8414,8414,0,23200,22000,12000,10000,0,1200,1200,0,0,7500,7500,5000,0,1328,180,30,240,180,238
2020,320600211,40,40,40,40,0,0,0,0,0,0,0,0,0,0,0,0,0,0,465,180,60,11,24,1
2020,320600221,25943,10883,10883,10883,0,15060,15000,15000,0,0,60,0,60,0,0,0,0,0,1310,120,150,100,40,43
2020,320600241,4062,3162,2162,2162,1000,900,0,0,0,0,900,900,0,0,515,515,0,500,1680,500,20,120,180,13
2020,320600251,19833,4673,4673,4673,0,15160,13000,13000,0,0,2160,2000,160,0,200,200,0,0,5260,180,100,300,280,70
2020,320600271,41349,1209,1209,1209,0,40140,40000,30000,10000,0,140,80,60,0,4000,0,0,0,2290,240,490,360,180,78
2020,320600281,310,310,310,310,0,0,0,0,0,0,0,0,0,0,0,0,0,0,589,250,30,10,24,0
2020,320600291,13266,4182,4182,4182,0,9084,9000,9000,0,0,84,0,84,0,0,0,0,0,1155,210,75,180,48,13
2020,320600301,22410,4610,4610,4610,0,17800,16000,16000,0,0,1800,1800,0,0,10366,10366,9916,0,3370,180,100,540,480,56
2020,320600311,33365,9090,9090,9090,0,24275,16000,16000,0,0,8275,4900,375,3000,7250,7250,5000,1500,3050,264,120,400,216,75
2020,320600321,64780,21780,21780,21780,0,43000,40000,25000,15000,0,3000,2500,500,0,8000,0,0,0,3106,420,500,720,96,433
2020,320600351,28002,8033,8033,8033,0,19969,19000,19000,0,0,969,900,69,0,0,0,0,0,2870,240,100,250,100,91
2020,320700211,42450,1300,1300,1300,0,41150,41000,29000,12000,0,150,150,0,0,0,0,0,0,950,250,200,80,20,125
2020,320700221,1720,1720,20,20,1700,0,0,0,0,0,0,0,0,0,3400,3400,1200,0,954,240,24,12,20,9
2020,320700241,50177,2807,2807,2807,0,47370,41990,25000,16990,0,5380,200,180,5000,2236,2236,2236,0,1568,84,50,70,144,47
2020,320700281,200,200,200,200,0,0,0,0,0,0,0,0,0,0,0,0,0,0,1782,300,20,20,42,1
2020,320700291,24150,7870,7870,7870,0,16280,15600,15600,0,0,680,680,0,0,11150,11150,8000,3000,2380,250,170,600,60,71
2020,320700301,2275,775,275,275,500,1500,0,0,0,0,1500,1500,0,0,1033,1033,0,100,2150,420,10,240,200,43
2020,320700311,166136,1710,1710,1710,0,164426,130000,20000,110000,0,34426,10200,20226,4000,8400,8400,5000,2700,3778,360,200,600,360,61
2020,320700321,61930,14930,14930,14930,0,47000,43500,31500,12000,0,3500,3500,0,0,11650,11650,11000,650,3396,336,120,420,360,978
2020,320700341,36703,7503,7503,7503,0,29200,28600,28600,0,0,600,600,0,0,44,44,0,0,2573,279,30,72,120,116
2020,320700351,3412,1812,1312,312,500,1600,0,0,0,0,1600,100,500,1000,3900,3900,0,3900,1914,324,10,360,300,66
2020,320700361,24000,22500,21500,21100,1000,1500,0,0,0,0,1500,1500,0,0,490,490,0,0,3077,500,150,12,55,1935
2020,320700371,65700,24140,24140,24140,0,41560,39000,17000,22000,0,2560,2560,0,0,0,0,0,0,3466,264,10,240,192,565
2020,320700391,2090,2090,1290,1290,800,0,0,0,0,0,0,0,0,0,0,0,0,0,535,60,215,20,30,7
2020,320800201,8140,90,90,90,0,8050,8000,8000,0,0,50,50,0,0,0,0,0,0,1279,120,180,150,84,19
2020,320800211,35940,460,460,460,0,35480,35000,14000,21000,0,480,200,280,0,5000,0,0,0,2800,250,600,320,175,66
2020,320800221,20298,4448,4448,3948,0,15850,11000,11000,0,0,4850,700,3150,1000,4080,4080,2700,0,1620,240,250,300,130,48
2020,320800231,41567,3674,3674,3674,0,37893,35000,35000,0,0,2893,2830,63,0,10000,10000,10000,0,2704,260,15,390,204,89
2020,320800251,8316,3716,3716,3716,0,4600,4000,0,4000,0,600,600,0,0,0,0,0,0,1130,420,10,150,100,35
2020,320800271,31735,100,100,100,0,31635,31000,31000,0,0,635,600,35,0,11023,11023,11000,0,1890,185,25,210,240,47
2020,320800281,187241,3941,3941,3941,0,183300,160000,40000,120000,0,23300,8300,15000,0,6500,6500,5500,1000,3115,200,80,300,200,311
2020,320800291,68047,33947,30947,27947,3000,34100,22000,0,22000,0,12100,2600,4500,5000,14500,1500,0,1500,4080,900,80,140,80,50
2020,320800301,10920,3900,3900,3900,0,7020,7000,7000,0,0,20,0,20,0,0,0,0,0,1584,144,240,180,96,3
2020,320800311,42940,17940,17940,17940,0,25000,25000,25000,0,0,0,0,0,0,300,0,0,0,1130,240,120,0,30,84
2020,320800321,20110,8010,8010,8010,0,12100,10000,10000,0,0,2100,1800,300,0,1060,1060,0,0,1630,300,180,120,120,57
2020,320800331,30788,688,688,688,0,30100,14000,14000,0,0,16100,600,0,15500,0,0,0,0,2540,320,360,500,300,96
2020,320800341,23700,15160,15160,15160,0,8540,7500,7500,0,0,1040,40,0,1000,0,0,0,0,2456,216,1000,360,180,34
2020,320800351,90360,10,10,10,0,90350,90000,90000,0,0,350,350,0,0,16700,16000,16000,0,1128,204,60,300,14,166
2020,320800361,30670,1520,1520,520,0,29150,27000,19000,8000,0,2150,1650,0,500,19300,19300,15700,1500,1907,300,120,240,240,41
2020,320800371,260056,24456,24456,24456,0,235600,227000,72000,155000,0,8600,8600,0,0,24500,10000,10000,0,2830,100,20,330,120,646
2020,320800381,116820,6520,6520,6520,0,110300,108500,45000,63500,0,1800,1500,300,0,63200,44700,11700,33000,2192,320,100,60,360,543
2020,320900211,34350,1400,1400,1400,0,32950,30700,30000,700,0,2250,2000,250,0,8500,8500,8000,500,4184,350,800,300,130,574
2020,320900231,420,420,120,120,300,0,0,0,0,0,0,0,0,0,0,0,0,0,523,200,15,10,18,0
2020,320900241,28081,4515,4515,4515,0,23566,23000,23000,0,0,566,260,306,0,150,150,0,0,2267,150,370,100,130,73
2020,320900251,3960,3930,930,930,3000,30,0,0,0,0,30,0,30,0,100,100,0,0,2750,250,200,200,150,32
2020,320900271,11590,260,260,260,0,11330,10000,10000,0,0,1330,1300,30,0,4000,1000,0,0,2480,180,180,370,180,120
2020,320900281,9380,300,300,300,0,9080,9000,9000,0,0,80,0,80,0,0,0,0,0,873,180,240,15,38,17
2020,320900301,6934,4334,4334,4334,0,2600,0,0,0,0,2600,2600,0,0,0,0,0,0,1306,204,60,360,132,140
2020,320900321,28765,4765,4765,4265,0,24000,20500,10500,10000,0,3500,1500,1000,1000,4850,4850,4850,0,2612,180,60,270,480,53
2020,320900331,32500,800,800,800,0,31700,31000,31000,0,0,700,700,0,0,0,0,0,0,1580,336,240,120,84,237
2020,320900351,58280,280,280,280,0,58000,57600,33800,23800,0,400,400,0,0,42540,41540,33640,5600,4099,516,40,712,540,112
2020,320900361,207340,340,340,340,0,207000,207000,7000,200000,0,0,0,0,0,15000,15000,15000,0,790,150,240,50,60,53
2020,320900381,29960,7460,7460,7460,0,22500,20000,20000,0,0,2500,2500,0,0,590,590,590,0,2704,324,40,200,300,233
2020,320900391,49250,8000,8000,8000,0,41250,30000,17000,13000,0,11250,1250,0,10000,0,0,0,0,1804,172,140,650,92,80
2020,321000202,30386,4736,4736,4736,0,25650,25000,25000,0,0,650,650,0,0,70,70,0,0,1443,300,50,120,120,158
2020,321000212,210,210,10,10,200,0,0,0,0,0,0,0,0,0,470,470,0,420,634,260,0,70,24,0
2020,321000222,80,20,20,20,0,60,0,0,0,0,60,60,0,0,0,0,0,0,1231,276,350,120,55,17
2020,321000252,150,150,150,150,0,0,0,0,0,0,0,0,0,0,0,0,0,0,242,54,10,5,48,0
2020,321000312,41348,4448,4448,4448,0,36900,35000,35000,0,0,1900,1400,500,0,19924,19924,19924,0,4616,284,420,150,150,468
2020,321000332,11988,11708,8408,8408,3300,280,0,0,0,0,280,280,0,0,0,0,0,0,1476,216,30,340,60,61
2020,321000352,40831,5981,5981,5981,0,34850,32000,22000,10000,0,2850,2850,0,0,11082,11082,10022,0,3146,264,160,300,282,588
2020,321000372,22170,15470,15470,15470,0,6700,6000,6000,0,0,700,700,0,0,0,0,0,0,5048,328,310,230,240,89
2020,321000382,13400,3400,3400,3400,0,10000,10000,10000,0,0,0,0,0,0,100,100,0,0,1363,168,24,96,60,84
2020,321600201,15890,5400,5400,5400,0,10490,10000,10000,0,0,490,240,250,0,3228,3228,0,1538,2626,200,450,300,76,219
2020,321600211,203240,62440,62440,62440,0,140800,120000,120000,0,0,20800,7500,13300,0,0,0,0,0,10150,500,120,370,360,994
2020,321600231,31357,7155,7155,5155,0,24202,20300,17000,0,3300,3902,1950,1952,0,24004,24004,7004,17000,6106,240,240,2020,276,131
2020,321600241,9280,1280,1280,1280,0,8000,8000,8000,0,0,0,0,0,0,0,0,0,0,620,148,80,12,34,8
2020,321600251,36391,2791,2791,1791,0,33600,33000,14000,19000,0,600,350,250,0,4500,4500,3000,0,3670,300,200,250,260,52
2020,321600261,15963,5963,3963,3963,2000,10000,10000,0,10000,0,0,0,0,0,1013,13,0,0,759,120,60,24,30,9
2020,321600291,55688,12138,12138,11138,0,43550,41000,30000,11000,0,2550,2050,500,0,19160,19160,19000,160,3522,1200,100,390,222,292
2020,321600301,126500,26200,1200,1200,25000,100300,100000,0,100000,0,300,300,0,0,70000,0,0,0,4480,250,50,100,120,225
2020,321600311,2060,1360,1130,1130,230,700,0,0,0,0,700,700,0,0,0,0,0,0,542,160,2,80,30,1
2020,321600321,13450,5200,5200,5200,0,8250,8000,8000,0,0,250,250,0,0,1300,1300,1300,0,1100,200,0,120,100,40
2020,321600331,45680,9080,9080,9080,0,36600,33300,24000,6700,2600,3300,3000,300,0,0,0,0,0,1647,284,167,120,96,2001
2020,321600341,57680,17280,17280,17280,0,40400,39400,13600,15800,10000,1000,600,400,0,0,0,0,0,4840,180,300,700,460,386
2020,321600351,14600,8150,8150,7650,0,6450,4500,4500,0,0,1950,350,600,1000,0,0,0,0,2303,172,335,176,120,24
2020,321600361,7440,5140,2140,1640,3000,2300,0,0,0,0,2300,1300,1000,0,2500,2500,0,2000,1740,573,5,156,216,57
2020,321600371,145272,78820,78820,73820,0,66452,42000,32000,10000,0,24452,1000,13452,10000,500,0,0,0,4320,450,30,300,360,679
2020,321600381,21870,10870,10870,10870,0,11000,11000,11000,0,0,0,0,0,0,0,0,0,0,1834,240,480,84,120,18
2020,321600391,5623,5623,1923,1923,3700,0,0,0,0,0,0,0,0,0,3700,3700,3700,0,3860,280,70,135,275,113
2020,321700201,15100,4900,4900,4900,0,10200,10000,10000,0,0,200,200,0,0,3100,3100,2500,300,2345,200,20,360,128,56
2020,321700231,21650,750,750,750,0,20900,20000,20000,0,0,900,900,0,0,2000,2000,2000,0,2400,144,30,360,204,117
2020,321700241,40844,1944,1444,944,500,38900,35000,0,35000,0,3900,300,2100,1500,28100,7100,7000,0,3640,570,30,360,380,118
2020,321700261,24240,3390,3390,3390,0,20850,20000,20000,0,0,850,850,0,0,7000,7000,7000,0,3056,365,1000,400,250,90
2020,321700271,30890,800,800,800,0,30090,30000,30000,0,0,90,0,90,0,0,0,0,0,1580,120,1000,20,40,32
2020,321700281,71290,4340,4340,4340,0,66950,66000,66000,0,0,950,900,50,0,10000,10000,10000,0,3100,500,0,100,200,148
2020,321700291,54392,6592,6592,6592,0,47800,46000,46000,0,0,1800,1300,500,0,0,0,0,0,5180,300,50,400,160,249
2020,321700321,24350,5998,5998,5998,0,18352,13000,3000,10000,0,5352,900,4452,0,550,550,0,0,1186,66,150,120,96,33
2020,321700331,75452,28000,28000,28000,0,47452,34000,9000,25000,0,13452,5000,8452,0,9000,9000,9000,0,5646,336,220,240,360,1838
2020,321700341,1493,880,880,880,0,613,0,0,0,0,613,500,113,0,0,0,0,0,1533,288,342,115,88,38
2020,321700351,18880,18480,9480,7880,9000,400,0,0,0,0,400,400,0,0,5200,5200,0,5000,4769,214,835,440,240,62
2020,321700371,1926,1126,626,626,500,800,0,0,0,0,800,800,0,0,5390,5390,0,0,1786,540,120,120,96,15
2020,321700381,5167,3167,2867,2867,300,2000,2000,0,2000,0,0,0,0,0,0,0,0,0,1310,500,100,85,65,3
2020,321700391,3376,976,976,976,0,2400,0,0,0,0,2400,2400,0,0,1608,1608,0,0,3510,150,80,400,180,55
2020,321800211,19184,13704,12704,11904,1000,5480,0,0,0,0,5480,1400,4080,0,0,0,0,0,3290,606,24,420,170,58
2020,321800231,83280,22400,4400,4200,18000,60880,60000,0,60000,0,880,250,630,0,1650,150,0,0,1477,260,50,250,85,101
2020,321800251,1736,636,436,436,200,1100,0,0,0,0,1100,1000,100,0,500,500,0,0,1706,486,0,120,300,27
2020,321800261,37002,4621,4621,4621,0,32381,31000,31000,0,0,1381,1200,181,0,5820,5820,3800,2000,2520,330,50,240,180,472
2020,321800271,38900,13400,10400,5400,3000,25500,0,0,0,0,25500,900,5500,19100,10000,10000,0,0,3264,360,40,480,144,275
2020,321800291,35100,100,100,100,0,35000,35000,35000,0,0,0,0,0,0,3500,0,0,0,1125,142,240,10,33,17
2020,321800301,5450,400,400,400,0,5050,5000,5000,0,0,50,0,50,0,0,0,0,0,868,366,184,84,84,3
2020,321800311,49316,5916,5916,5916,0,43400,41000,9000,32000,0,2400,2400,0,0,2000,0,0,0,996,120,120,60,36,173
2020,321800331,100875,22397,6497,6497,15900,78478,74000,0,74000,0,4478,3800,678,0,24000,24000,24000,0,4140,276,50,180,180,1161
2020,321800341,10735,8555,8555,8555,0,2180,1800,1800,0,0,380,380,0,0,0,0,0,0,1790,150,500,370,90,92
2020,321800351,18040,1040,1040,1040,0,17000,17000,17000,0,0,0,0,0,0,12460,12460,12000,60,1593,250,40,180,168,15
2020,321800361,8848,5648,4348,4348,1300,3200,0,0,0,0,3200,3200,0,0,3300,3300,0,0,3346,540,240,270,440,220
2020,321800371,6088,238,238,238,0,5850,4000,4000,0,0,1850,350,1500,0,0,0,0,0,1070,190,12,120,78,41
2020,321800381,100,100,100,100,0,0,0,0,0,0,0,0,0,0,0,0,0,0,1002,96,120,36,30,1
2020,321800391,1126,1056,1056,1056,0,70,0,0,0,0,70,70,0,0,0,0,0,0,2433,295,60,268,360,43
2020,321900221,130948,39148,39148,35648,0,91800,85000,85000,0,0,6800,1800,5000,0,22000,22000,22000,0,4091,420,100,215,240,213
2020,321900271,5520,1300,1300,1300,0,4220,0,0,0,0,4220,4000,220,0,220,220,0,0,3380,200,200,450,300,481
2020,321900291,14100,3400,3400,3400,0,10700,10000,10000,0,0,700,700,0,0,6600,0,0,0,2335,150,50,400,235,456
2020,321900301,28650,1940,1940,1940,0,26710,26700,9000,17700,0,10,0,10,0,0,0,0,0,899,172,148,27,52,9
2020,321900331,4500,3300,3300,3300,0,1200,1200,1200,0,0,0,0,0,0,0,0,0,0,1370,438,100,72,30,1
2020,321900351,13370,170,170,170,0,13200,12000,12000,0,0,1200,1200,0,0,6360,6360,6000,0,3342,944,75,174,219,35
2020,321900361,22200,15800,3800,3800,12000,6400,2000,0,0,2000,4400,4400,0,0,6720,6720,2000,0,3374,200,350,420,204,515
2020,321900371,1774,774,774,774,0,1000,1000,1000,0,0,0,0,0,0,0,0,0,0,1766,238,95,90,73,33
2020,321900381,4320,2820,2820,2820,0,1500,0,0,0,0,1500,1500,0,0,0,0,0,0,1754,200,20,200,144,46
2020,322000202,32810,31960,15960,15960,16000,850,0,0,0,0,850,800,50,0,6300,6300,6000,300,1442,240,120,200,72,74
2020,322000212,505,505,5,5,500,0,0,0,0,0,0,0,0,0,0,0,0,0,1030,600,30,10,30,1
2020,322000232,48900,1600,1600,1600,0,47300,45000,40000,0,5000,2300,2300,0,0,36040,36040,21000,10000,3780,360,400,300,160,289
2020,322000242,39280,5680,5680,5680,0,33600,31500,31500,0,0,2100,2100,0,0,0,0,0,0,3927,295,55,450,175,527
2020,322000252,42076,6346,6346,6346,0,35730,35000,35000,0,0,730,730,0,0,18300,18300,18300,0,2512,150,400,200,180,94
2020,322000262,48191,47565,13565,13565,34000,626,0,0,0,0,626,400,226,0,2350,2350,2350,0,2577,340,64,200,158,131
2020,322000272,4000,4000,3000,3000,1000,0,0,0,0,0,0,0,0,0,0,0,0,0,667,280,12,24,36,2
2020,322000282,10050,50,50,50,0,10000,10000,10000,0,0,0,0,0,0,0,0,0,0,665,216,24,24,36,14
2020,322000292,27700,3000,3000,1000,0,24700,21000,13000,8000,0,3700,500,3200,0,2000,2000,0,2000,1896,228,240,600,96,44
2020,322000302,18604,8604,8604,8604,0,10000,0,0,0,0,10000,2000,8000,0,0,0,0,0,1720,130,360,400,120,25
2020,322000312,3110,110,110,110,0,3000,3000,0,3000,0,0,0,0,0,0,0,0,0,1084,195,65,58,38,6
2020,322000322,14574,1094,1094,1094,0,13480,12000,12000,0,0,1480,1480,0,0,0,0,0,0,1430,240,20,160,72,227
2020,322000332,50,50,50,50,0,0,0,0,0,0,0,0,0,0,0,0,0,0,684,482,40,5,13,20
2020,322000342,156038,12560,12560,12560,0,143478,134200,5000,129200,0,9278,3600,5678,0,3500,3500,1000,0,2470,800,250,140,240,83
2020,322000352,4030,30,30,30,0,4000,4000,4000,0,0,0,0,0,0,0,0,0,0,1372,45,500,90,52,1
2020,322600211,78580,7880,7880,7880,0,70700,70000,70000,0,0,700,700,0,0,0,0,0,0,3645,310,500,240,240,999
2020,322600251,79670,19120,19120,14120,0,60550,60000,60000,0,0,550,100,450,0,27950,27950,26800,0,4230,350,100,200,130,269
2020,322600261,272,272,22,22,250,0,0,0,0,0,0,0,0,0,0,0,0,0,801,120,30,100,36,0
2020,322600281,72260,39060,39060,36660,0,33200,33000,30000,3000,0,200,0,200,0,0,0,0,0,2100,400,300,50,100,267
2020,322600291,14157,675,675,675,0,13482,13360,13150,210,0,122,0,122,0,0,0,0,0,693,155,10,14,23,16
2020,322600301,18270,8270,8270,8270,0,10000,10000,10000,0,0,0,0,0,0,0,0,0,0,945,200,15,10,50,36
2020,322600311,2640,440,440,440,0,2200,2200,2200,0,0,0,0,0,0,0,0,0,0,1053,180,270,60,60,4
2020,322600321,21400,1200,1200,400,0,20200,18000,18000,0,0,2200,2200,0,0,12390,12390,12000,0,1237,264,50,180,63,139
2020,322600331,530,30,30,30,0,500,500,500,0,0,0,0,0,0,0,0,0,0,618,89,0,125,12,1
2020,322600351,45726,10226,10226,10226,0,35500,30000,10000,20000,0,5500,3500,2000,0,7000,7000,5000,2000,1120,240,60,240,180,146
2020,322600361,43908,2108,2108,2108,0,41800,34000,4000,30000,0,7800,800,7000,0,2000,2000,0,2000,1142,180,120,360,72,89
2020,322700201,21100,100,100,100,0,21000,11000,11000,0,0,10000,3000,0,7000,4000,4000,4000,0,1351,150,200,100,96,60
2020,322700261,40265,29475,12475,12475,17000,10790,10000,0,10000,0,790,740,50,0,13000,13000,13000,0,2030,180,10,300,100,36
2020,322700281,34460,70,70,70,0,34390,33000,33000,0,0,1390,1290,100,0,11565,11565,11565,0,2973,263,30,370,180,79
2020,322700301,18331,3555,3555,3555,0,14776,13000,13000,0,0,1776,598,1178,0,7480,7480,6180,1000,3152,192,10,210,240,105
2020,322700311,27424,10424,10424,10424,0,17000,17000,17000,0,0,0,0,0,0,0,0,0,0,1966,410,60,60,156,26
2020,322700321,8020,400,400,400,0,7620,6000,6000,0,0,1620,620,1000,0,0,0,0,0,1143,189,60,120,215,15
2020,322700361,51412,4686,4686,4686,0,46726,42000,12000,30000,0,4726,3500,1226,0,0,0,0,0,1550,300,10,220,90,144
2020,322800201,1518417,6500,3500,3500,3000,1511917,1500000,0,1500000,0,11917,1917,10000,0,674650,556650,556650,0,6012,2022,560,340,250,2828
2020,322800221,93,93,93,93,0,0,0,0,0,0,0,0,0,0,0,0,0,0,557,64,84,10,72,1
2020,322800231,1588,1588,1588,1588,0,0,0,0,0,0,0,0,0,0,0,0,0,0,2940,350,60,360,200,20
2020,322800251,20000,19700,2700,2700,17000,300,0,0,0,0,300,300,0,0,13100,13100,13000,0,2150,180,60,300,120,340
2020,322800271,285,240,10,10,230,45,0,0,0,0,45,0,45,0,0,0,0,0,709,110,35,35,24,0
2020,322800281,50126,8926,8926,8726,0,41200,38500,28500,10000,0,2700,2400,300,0,15640,15640,15640,0,4130,420,100,540,300,284
2020,322800291,35760,6260,6260,6260,0,29500,27000,27000,0,0,2500,2500,0,0,4040,4040,2040,2000,2680,250,100,280,200,303
2020,322800311,36560,22010,22010,22010,0,14550,13000,1000,12000,0,1550,1500,50,0,0,0,0,0,3747,299,105,320,138,1161
2020,322800321,131306,16406,16406,16406,0,114900,113000,40000,73000,0,1900,1900,0,0,22000,0,0,0,3120,200,420,350,180,134
2020,322800331,5779,2825,2825,2525,0,2954,2500,2500,0,0,454,360,94,0,0,0,0,0,4160,400,420,420,200,239
2020,322800351,44230,730,730,730,0,43500,43000,20000,23000,0,500,0,500,0,10600,3600,2600,1000,2374,352,560,24,120,21
2020,322900201,40810,710,710,710,0,40100,40000,40000,0,0,100,100,0,0,13000,0,0,0,2147,420,200,240,72,63
2020,322900211,850,850,850,850,0,0,0,0,0,0,0,0,0,0,0,0,0,0,757,156,200,36,24,1
2020,322900231,160,160,60,60,100,0,0,0,0,0,0,0,0,0,1200,1200,0,500,1119,480,120,180,48,1
2020,322900251,63896,1095,1095,1095,0,62801,61750,58750,3000,0,1051,861,190,0,3000,0,0,0,2383,152,443,117,125,190
2020,322900271,7166,6916,4916,4916,2000,250,0,0,0,0,250,250,0,0,30,30,0,0,4370,1320,50,500,200,83
2020,322900281,27021,11741,11741,9741,0,15280,15000,15000,0,0,280,150,130,0,12802,12802,12652,0,2657,240,70,240,157,48
2020,322900301,31712,2112,2112,2112,0,29600,25000,15000,10000,0,4600,1600,0,3000,3000,3000,3000,0,2070,300,30,480,120,47
2020,322900311,19328,1715,1715,1415,0,17613,5500,5500,0,0,12113,2000,10113,0,1664,1664,0,1000,4020,250,50,360,350,61
2020,322900321,6198,248,248,248,0,5950,5500,5500,0,0,450,450,0,0,2000,2000,0,2000,2005,135,240,180,60,17
2020,322900331,17280,1280,1280,1280,0,16000,15000,15000,0,0,1000,1000,0,0,360,360,360,0,3900,180,100,500,250,370
2020,322900341,11765,725,725,725,0,11040,10000,10000,0,0,1040,1040,0,0,0,0,0,0,1792,65,100,290,85,144
2020,322900351,150,150,150,150,0,0,0,0,0,0,0,0,0,0,0,0,0,0,635,165,120,3,48,7
2020,323000202,13660,660,660,660,0,13000,13000,13000,0,0,0,0,0,0,5000,5000,5000,0,2376,288,240,120,144,599
2020,323000212,55330,20240,20240,20240,0,35090,33000,33000,0,0,2090,2000,90,0,0,0,0,0,2387,480,41,155,114,288
2020,323000222,20918,2460,2460,2460,0,18458,17000,17000,0,0,1458,1360,98,0,0,0,0,0,4226,200,360,500,150,357
2020,323600211,28770,1770,1770,1770,0,27000,27000,27000,0,0,0,0,0,0,0,0,0,0,1026,180,210,60,36,54
2020,323600221,54851,14161,14161,14161,0,40690,40000,40000,0,0,690,600,90,0,30355,30355,22340,0,2762,240,10,360,192,134
2020,323600231,59908,21098,21098,21098,0,38810,35000,35000,0,0,3810,3350,460,0,13590,13590,10694,1000,4115,300,60,590,265,287
2020,323600251,2600,2570,210,210,2360,30,0,0,0,0,30,0,30,0,1400,1400,1200,0,905,300,60,65,130,0
2020,323700211,25300,300,300,300,0,25000,25000,25000,0,0,0,0,0,0,300,0,0,0,540,60,50,20,20,43
2020,323700221,24028,7478,7478,5478,0,16550,14000,14000,0,0,2550,2300,250,0,2530,2530,2400,0,2050,140,30,230,180,63
2020,323700231,24494,5744,5744,5744,0,18750,18000,14000,4000,0,750,500,250,0,6000,6000,6000,0,3084,240,100,360,264,134
2020,323700241,25566,25566,6566,6566,19000,0,0,0,0,0,0,0,0,0,0,0,0,0,3692,360,12,60,336,336
2020,323800201,12170,170,170,170,0,12000,12000,12000,0,0,0,0,0,0,0,0,0,0,4020,300,150,300,280,553
2020,323800211,301620,78620,78620,78620,0,223000,220500,0,220500,0,2500,2500,0,0,124000,97000,97000,0,5200,700,200,600,250,805
2020,323800231,22400,2400,2400,2400,0,20000,20000,20000,0,0,0,0,0,0,0,0,0,0,1020,200,200,80,50,31
2020,323800241,62100,4000,4000,4000,0,58100,49000,19000,30000,0,9100,4100,5000,0,0,0,0,0,2110,300,170,150,90,171
2020,323800251,4700,200,200,200,0,4500,4500,0,4500,0,0,0,0,0,0,0,0,0,3429,100,3000,20,24,21
2020,323900211,41380,980,980,980,0,40400,36000,36000,0,0,4400,3900,500,0,60,60,0,0,5030,360,200,950,240,350
2020,323900221,13193,13170,7170,7170,6000,23,0,0,0,0,23,0,23,0,650,650,0,650,1455,120,5,130,120,365
2020,323900231,2379,2379,879,879,1500,0,0,0,0,0,0,0,0,0,0,0,0,0,2207,805,5,153,91,2
2020,323900241,22860,1610,1610,1610,0,21250,21000,21000,0,0,250,250,0,0,4000,4000,4000,0,1500,180,500,60,60,44
2020,330000202,23330,2080,2080,2080,0,21250,20000,12000,8000,0,1250,1150,100,0,4401,401,0,0,2915,360,1068,180,97,74
2020,330000222,32220,20220,220,220,20000,12000,12000,0,0,12000,0,0,0,0,7000,7000,0,7000,1403,0,18,360,60,69
2020,330000242,30996,5996,5996,5996,0,25000,25000,25000,0,0,0,0,0,0,8000,8000,8000,0,1448,400,150,84,84,56
2020,330000252,48160,12410,12410,10410,0,35750,24950,12500,12450,0,10800,5800,5000,0,5600,5600,4500,0,1765,87,600,228,240,14
2020,330000262,2160,2160,960,960,1200,0,0,0,0,0,0,0,0,0,0,0,0,0,4458,864,200,360,204,34
2020,330000282,33075,6700,6700,6700,0,26375,24000,24000,0,0,2375,2375,0,0,300,300,300,0,2788,312,240,300,336,575
2020,330000302,3250,250,250,250,0,3000,3000,3000,0,0,0,0,0,0,0,0,0,0,1195,133,760,20,12,3
2020,330000312,6870,50,50,50,0,6820,6700,6700,0,0,120,0,120,0,0,0,0,0,416,114,80,18,42,10
2020,330000332,19503,6203,6203,6203,0,13300,12000,12000,0,0,1300,1300,0,0,7510,7510,7510,0,1794,153,78,144,228,70
2020,330000342,7700,7510,7010,7010,500,190,0,0,0,0,190,190,0,0,0,0,0,0,2953,630,535,144,122,147
2020,330000352,28788,1288,1288,1288,0,27500,27500,7500,20000,0,0,0,0,0,18030,1030,0,0,2709,64,5,48,120,255
2020,330000362,17580,10100,100,100,10000,7480,7000,0,7000,0,480,480,0,0,9779,3779,0,3500,3832,540,150,240,240,292
2020,330000372,136190,47700,47700,40400,0,88490,83000,43000,40000,0,5490,5490,0,0,0,0,0,0,9322,796,100,900,276,7072
2020,330000382,39940,12540,12540,12540,0,27400,25000,15000,10000,0,2400,2400,0,0,0,0,0,0,1548,240,60,120,48,553
2020,330000392,27000,10000,10000,10000,0,17000,17000,17000,0,0,0,0,0,0,0,0,0,0,1048,336,250,12,30,51
2020,330600211,21553,2153,2153,2153,0,19400,19400,19400,0,0,0,0,0,0,0,0,0,0,2656,300,600,200,240,24
2020,330600241,13930,4930,430,430,4500,9000,9000,0,9000,0,0,0,0,0,10000,4000,4000,0,735,120,30,36,25,11
2020,330600251,44280,20152,10152,10152,10000,24128,23090,0,0,23090,1038,1038,0,0,18090,18090,0,18090,3894,240,60,360,240,210
2020,330600261,22508,8060,8060,8060,0,14448,13500,13500,0,0,948,900,48,0,308,308,282,0,3337,230,120,480,300,137
2020,330600271,84905,2815,2815,2815,0,82090,81000,48000,33000,0,1090,750,340,0,42840,42840,42840,0,3960,400,220,120,480,105
2020,330600281,13274,8274,5274,4774,3000,5000,0,0,0,0,5000,4000,1000,0,2304,2304,0,0,3016,756,100,300,300,61
2020,330600311,16488,14588,1588,588,13000,1900,0,0,0,0,1900,1700,200,0,12200,12200,11700,0,2220,264,96,120,240,132
2020,330600321,56882,14382,14382,14382,0,42500,42000,40000,2000,0,500,500,0,0,14400,12600,12600,0,5942,508,600,530,154,451
2020,330600331,2840,2000,2000,2000,0,840,0,0,0,0,840,840,0,0,731,731,0,0,1941,405,20,240,78,55
2020,330600341,3152,3152,652,652,2500,0,0,0,0,0,0,0,0,0,0,0,0,0,828,36,2,30,20,18
2020,330600351,74200,31900,31900,31900,0,42300,38000,18000,20000,0,4300,3300,1000,0,0,0,0,0,7368,264,100,500,204,150
2020,330600361,1194,1194,1094,1094,100,0,0,0,0,0,0,0,0,0,0,0,0,0,1582,840,100,96,48,1
2020,330600371,14103,7453,5453,3453,2000,6650,0,0,0,0,6650,2700,950,3000,2400,2400,0,2400,6572,360,480,570,222,61
2020,330600381,38794,22494,22494,18494,0,16300,16000,16000,0,0,300,300,0,0,3000,3000,3000,0,3776,320,30,180,216,40
2020,330700211,10,10,10,10,0,0,0,0,0,0,0,0,0,0,0,0,0,0,1104,624,0,0,120,0
2020,330700231,2998,2938,1378,1378,1560,60,0,0,0,0,60,60,0,0,300,300,300,0,1027,224,30,130,30,6
2020,330700241,24190,2710,2710,2710,0,21480,19000,19000,0,0,2480,2250,230,0,4262,4262,2200,0,3118,174,400,360,204,79
2020,330700271,2915,2915,415,415,2500,0,0,0,0,0,0,0,0,0,0,0,0,0,1930,180,30,60,60,189
2020,330700281,31070,3242,3242,3242,0,27828,20000,20000,0,0,7828,600,228,7000,100,100,0,0,1862,180,80,400,72,11
2020,330700291,52950,18950,18950,14950,0,34000,26000,26000,0,0,8000,1500,1500,5000,8081,8081,8081,0,2966,240,36,600,120,219
2020,330700301,18000,6200,6200,6200,0,11800,11800,6800,5000,0,0,0,0,0,0,0,0,0,1242,260,450,36,36,18
2020,330700311,41339,17533,17533,16033,0,23806,20000,20000,0,0,3806,3500,306,0,0,0,0,0,2509,292,90,452,144,140
2020,330700321,49010,1010,560,560,450,48000,40000,0,40000,0,8000,8000,0,0,12680,12680,11680,0,3456,86,10,480,240,372
2020,330700331,15459,7633,7633,7633,0,7826,5000,5000,0,0,2826,1200,1626,0,2050,2050,0,2050,3246,261,900,490,200,177
2020,330700341,26198,4509,4509,3509,0,21689,21000,21000,0,0,689,350,339,0,1000,800,0,800,2795,135,120,400,180,210
2020,330700351,300,300,300,300,0,0,0,0,0,0,0,0,0,0,0,0,0,0,778,230,50,50,48,1
2020,330700361,7166,4440,3480,3480,960,2726,500,0,500,0,2226,1000,426,800,0,0,0,0,2002,280,520,300,72,88
2020,330700371,77051,19238,19238,14238,0,57813,54000,12000,42000,0,3813,3700,113,0,500,0,0,0,5380,360,20,480,240,745
2020,330700391,15,15,15,15,0,0,0,0,0,0,0,0,0,0,0,0,0,0,856,120,6,20,60,1
2020,330800221,8222,6820,2820,2820,4000,1402,0,0,0,0,1402,1402,0,0,0,0,0,0,2003,117,100,420,300,113
2020,330800251,5750,750,750,750,0,5000,5000,5000,0,0,0,0,0,0,0,0,0,0,540,73,18,0,49,7
2020,330800271,76680,13680,13680,13680,0,63000,63000,58000,5000,0,0,0,0,0,0,0,0,0,4230,480,500,20,120,108
2020,330800281,11211,1211,1211,1211,0,10000,10000,10000,0,0,0,0,0,0,3080,3080,3000,0,1834,216,360,120,48,15
2020,330800291,9060,8060,60,60,8000,1000,0,0,0,0,1000,1000,0,0,260,260,0,260,2976,240,360,360,96,38
2020,330800301,10300,4600,4600,4600,0,5700,5000,5000,0,0,700,700,0,0,0,0,0,0,1334,184,10,240,120,110
2020,330800311,8851,2388,2388,2388,0,6463,5000,5000,0,0,1463,1350,113,0,0,0,0,0,1597,129,400,240,180,66
2020,330800321,13151,151,151,151,0,13000,13000,13000,0,0,0,0,0,0,10100,6500,0,0,2440,360,240,120,120,39
2020,330800341,28657,7057,7057,6757,0,21600,20000,10000,10000,0,1600,1500,100,0,0,0,0,0,3140,780,100,590,180,414
2020,330800351,20346,8446,8446,8446,0,11900,10000,10000,0,0,1900,1800,100,0,0,0,0,0,1986,536,40,180,120,66
2020,330800361,3001,1,1,1,0,3000,3000,3000,0,0,0,0,0,0,0,0,0,0,443,80,24,12,24,3
2020,330800371,17050,13850,2850,2850,11000,3200,0,0,0,0,3200,3200,0,0,0,0,0,0,2320,360,50,210,240,782
2020,330800381,12884,10431,10431,10431,0,2453,0,0,0,0,2453,2400,53,0,0,0,0,0,2962,432,80,420,180,399
2020,330800391,18346,17496,1996,1996,15500,850,0,0,0,0,850,850,0,0,10000,10000,10000,0,2884,400,60,360,360,151
2020,330900201,77480,10280,10280,8280,0,67200,57000,22000,35000,0,10200,2000,8200,0,34000,13000,13000,0,2254,408,10,120,180,247
2020,330900251,32226,2226,2226,2226,0,30000,28000,28000,0,0,2000,2000,0,0,14400,14400,12900,1500,4405,360,300,240,325,386
2020,330900271,182991,5000,5000,5000,0,177991,170000,70000,100000,0,7991,1991,6000,0,52500,40500,39000,0,5082,480,0,500,252,1183
2020,330900301,19631,4131,4131,4131,0,15500,15500,14500,1000,0,0,0,0,0,300,0,0,0,2197,179,1238,50,15,37
2020,330900321,1195,1150,1150,1150,0,45,0,0,0,0,45,0,45,0,0,0,0,0,627,139,42,10,19,1
2020,330900351,7826,400,400,400,0,7426,7000,7000,0,0,426,200,226,0,0,0,0,0,2032,208,84,300,96,17
2020,330900371,4262,3562,562,562,3000,700,0,0,0,0,700,700,0,0,0,0,0,0,1936,240,250,360,240,89
2020,330900391,9260,560,560,560,0,8700,7800,7800,0,0,900,900,0,0,2400,2400,0,2400,1656,340,50,300,96,53
2020,331000202,128729,26329,26329,26329,0,102400,101000,81000,20000,0,1400,1200,200,0,20000,20000,16930,3070,9535,340,130,440,325,4877
2020,331000282,29100,2600,2600,2600,0,26500,26500,26500,0,0,0,0,0,0,12,12,0,0,1831,216,300,96,64,58
2020,331000292,138170,53370,53370,53370,0,84800,84300,30000,0,54300,500,0,500,0,4500,4500,4500,0,6353,1200,400,96,336,175
2020,331000302,15110,1110,1110,1110,0,14000,14000,14000,0,0,0,0,0,0,0,0,0,0,1172,424,30,36,24,19
2020,331000312,91579,4629,4629,4629,0,86950,85000,20000,65000,0,1950,1450,500,0,50000,50000,48000,2000,3906,326,100,360,240,681
2020,331000332,7582,5002,4002,4002,1000,2580,880,0,0,880,1700,1700,0,0,2000,2000,0,0,3317,360,307,360,240,107
2020,331000342,38610,15240,15240,15240,0,23370,20600,16600,4000,0,2770,2770,0,0,0,0,0,0,2205,240,50,310,96,872
2020,331000352,18246,7450,7450,7450,0,10796,9500,7000,2500,0,1296,1070,226,0,0,0,0,0,2521,300,120,600,216,144
2020,331000372,4578,4578,3410,2310,1168,0,0,0,0,0,0,0,0,0,0,0,0,0,1000,188,10,12,120,13
2020,331000382,3271,2971,571,571,2400,300,0,0,0,0,300,300,0,0,1400,1400,1400,0,1600,312,0,300,168,7
2020,331000392,8230,6830,5330,5330,1500,1400,0,0,0,0,1400,1400,0,0,0,0,0,0,3414,312,30,192,240,46
2020,331600201,18608,7163,7163,7163,0,11445,10000,10000,0,0,1445,325,1120,0,4700,4700,4700,0,1190,120,320,360,120,41
2020,331600221,43324,1324,1324,1324,0,42000,42000,42000,0,0,0,0,0,0,3638,3638,3638,0,2959,389,50,120,300,474
2020,331600231,1454,1454,1454,1454,0,0,0,0,0,0,0,0,0,0,0,0,0,0,1427,240,95,92,120,1
2020,331600281,40836,2936,2936,2936,0,37900,36000,10000,26000,0,1900,1900,0,0,3363,3363,63,3300,6224,280,120,240,180,864
2020,331600311,39118,7730,7730,7730,0,31388,29200,15000,14200,0,2188,2100,88,0,2460,2060,0,0,3000,250,500,360,60,20
2020,331600321,1680,180,180,180,0,1500,1500,1500,0,0,0,0,0,0,0,0,0,0,678,62,75,15,24,1
2020,331600331,10300,1300,1300,1300,0,9000,9000,9000,0,0,0,0,0,0,0,0,0,0,446,140,36,20,30,62
2020,331600341,11660,1260,1260,1260,0,10400,10400,3800,6600,0,0,0,0,0,0,0,0,0,1252,160,600,72,13,5
2020,331600371,25988,2375,2375,2375,0,23613,22000,22000,0,0,1613,1500,113,0,9030,9030,9030,0,4100,300,120,480,180,216
2020,331600391,1560,10,10,10,0,1550,1200,1200,0,0,350,0,350,0,0,0,0,0,562,60,0,48,24,0
2020,331700211,42456,12556,12556,12556,0,29900,26500,26500,0,0,3400,3400,0,0,0,0,0,0,1551,156,30,225,216,388
2020,331700221,29392,4892,4892,4892,0,24500,21500,11500,10000,0,3000,1000,2000,0,11100,11100,9100,0,3196,180,108,150,348,247
2020,331700241,3543,930,930,930,0,2613,2500,2500,0,0,113,0,113,0,0,0,0,0,798,64,75,24,57,14
2020,331700251,13137,137,137,137,0,13000,13000,13000,0,0,0,0,0,0,0,0,0,0,772,144,60,10,41,8
2020,331700261,48653,6293,6293,6293,0,42360,40000,40000,0,0,2360,2000,360,0,16444,16444,16000,0,5538,360,50,600,360,401
2020,331700281,11672,6472,3472,3472,3000,5200,3000,0,0,3000,2200,2200,0,0,150,150,0,150,1775,135,180,276,144,122
2020,331700321,30832,17132,14632,14132,2500,13700,0,0,0,0,13700,3200,5500,5000,0,0,0,0,4630,360,60,960,600,129
2020,331700341,22540,7540,540,540,7000,15000,15000,0,15000,0,0,0,0,0,15000,3000,0,0,580,180,84,24,36,27
2020,331700351,82638,43638,43638,43638,0,39000,35000,35000,0,0,4000,4000,0,0,9500,9500,9500,0,6622,372,38,350,250,681
2020,331700361,53150,18350,18350,18350,0,34800,30000,30000,0,0,4800,4800,0,0,12500,0,0,0,3800,630,420,520,133,1401
2020,331700381,24630,13230,13230,13230,0,11400,10000,10000,0,0,1400,1400,0,0,1500,1500,1500,0,1550,400,100,150,100,139
2020,331700391,2,2,2,2,0,0,0,0,0,0,0,0,0,0,0,0,0,0,560,120,200,30,10,1
2020,331800201,867400,20600,20600,20600,0,846800,843000,53000,790000,0,3800,3800,0,0,23900,2900,0,0,8070,300,2000,50,150,3098
2020,331800221,42574,10490,10490,10490,0,32084,30000,20000,0,10000,2084,1400,684,0,6000,6000,6000,0,4150,360,100,360,240,161
2020,331800231,19454,1288,1288,1288,0,18166,17800,17800,0,0,366,350,16,0,0,0,0,0,917,210,10,30,67,30
2020,331800241,16630,9630,9630,9630,0,7000,7000,7000,0,0,0,0,0,0,0,0,0,0,1462,80,720,60,72,34
2020,331800261,150,150,50,50,100,0,0,0,0,0,0,0,0,0,0,0,0,0,920,280,240,0,20,34
2020,331800301,77480,5300,5300,4300,0,72180,55000,55000,0,0,17180,180,10000,7000,16600,6600,1600,5000,3386,395,250,410,306,180
2020,331800311,34886,30186,11186,9186,19000,4700,0,0,0,0,4700,4200,500,0,2580,2580,0,0,6250,670,100,300,210,377
2020,331800321,65030,3980,3980,2980,0,61050,42700,4700,38000,0,18350,2250,14100,2000,13500,13500,12000,1500,1807,200,20,240,216,59
2020,331800341,75242,41042,41042,41042,0,34200,28000,28000,0,0,6200,6200,0,0,0,0,0,0,6050,390,120,400,200,248
2020,331800361,45860,12060,12060,12060,0,33800,32000,32000,0,0,1800,1800,0,0,7456,7456,7456,0,4140,420,110,240,240,452
2020,331800381,1190,1130,1130,1130,0,60,0,0,0,0,60,0,60,0,0,0,0,0,960,200,60,30,40,17
2020,331800391,12258,145,145,145,0,12113,12000,2000,10000,0,113,0,113,0,0,0,0,0,631,189,186,50,18,8
2020,331900221,20529,19379,8379,8379,11000,1150,0,0,0,0,1150,950,200,0,7000,7000,7000,0,2920,300,200,400,240,208
2020,331900231,3278,3192,2192,2192,1000,86,0,0,0,0,86,0,86,0,1400,1400,0,0,2794,960,120,120,144,5
2020,331900241,4420,4420,20,20,4400,0,0,0,0,0,0,0,0,0,0,0,0,0,1180,240,50,120,120,1
2020,331900251,23160,10640,640,640,10000,12520,12000,0,0,12000,520,520,0,0,12000,12000,0,12000,1554,296,10,300,216,37
2020,331900261,191800,500,500,500,0,191300,190000,130000,60000,0,1300,1300,0,0,103000,70000,70000,0,3796,720,240,120,300,1555
2020,331900281,21045,45,45,45,0,21000,21000,21000,0,0,0,0,0,0,4926,4926,4926,0,1298,240,60,58,260,28
2020,331900291,29990,28190,4190,4190,24000,1800,0,0,0,0,1800,1800,0,0,0,0,0,0,3010,300,200,430,210,266
2020,331900301,14584,2434,2434,2434,0,12150,11500,11500,0,0,650,650,0,0,0,0,0,0,3210,180,40,120,276,232
2020,331900311,56664,6114,6114,6114,0,50550,50000,35000,15000,0,550,550,0,0,15800,9000,9000,0,3425,200,70,480,180,447
2020,331900321,75358,5158,5158,5158,0,70200,55000,23000,32000,0,15200,2500,700,12000,2000,0,0,0,3532,480,150,240,222,277
2020,331900331,29500,200,200,200,0,29300,29000,25000,4000,0,300,300,0,0,0,0,0,0,1774,200,250,240,84,68
2020,331900341,17656,6456,6456,6456,0,11200,10000,10000,0,0,1200,850,350,0,0,0,0,0,3460,420,70,180,180,43
2020,331900361,18377,10577,10577,10577,0,7800,7000,7000,0,0,800,800,0,0,1308,1308,1160,0,3850,430,100,350,100,96
2020,331900371,66378,14728,14728,14728,0,51650,35000,23000,12000,0,16650,5650,0,11000,0,0,0,0,4493,360,60,500,350,201
2020,331900381,163744,19144,19144,19144,0,144600,144000,39000,105000,0,600,0,600,0,10500,0,0,0,3245,490,230,5,150,1222
2020,332000202,20950,3450,3450,3450,0,17500,17500,17500,0,0,0,0,0,0,11000,11000,11000,0,1820,180,100,240,180,268
2020,332000212,18540,2040,2040,2040,0,16500,16500,16500,0,0,0,0,0,0,0,0,0,0,2955,169,700,144,138,13
2020,332000232,25977,4213,4213,4213,0,21764,20650,12000,0,8650,1114,1114,0,0,2000,2000,0,0,4395,149,440,300,240,112
2020,332000242,42698,6098,6098,6098,0,36600,35000,35000,0,0,1600,1600,0,0,0,0,0,0,2110,360,30,200,140,63
2020,332000252,36444,1444,1444,1444,0,35000,35000,35000,0,0,0,0,0,0,0,0,0,0,1740,540,300,20,90,3391
2020,332000262,13046,13010,10,10,13000,36,0,0,0,0,36,0,36,0,11305,11305,10400,875,2073,288,40,120,180,17
2020,332000272,1652,1652,1352,1352,300,0,0,0,0,0,0,0,0,0,0,0,0,0,1403,330,200,120,138,1
2020,332000292,28521,5921,5921,5921,0,22600,21000,20000,1000,0,1600,1600,0,0,0,0,0,0,1966,180,10,420,96,276
2020,332000302,1000,1000,1000,1000,0,0,0,0,0,0,0,0,0,0,0,0,0,0,638,78,100,10,36,1
2020,332000312,4930,2600,2600,2600,0,2330,2330,2330,0,0,0,0,0,0,0,0,0,0,1202,155,835,20,23,3
2020,332000322,3635,2785,2785,2785,0,850,0,0,0,0,850,850,0,0,0,0,0,0,810,153,10,144,50,27
2020,332000332,27400,5000,5000,5000,0,22400,21000,17000,4000,0,1400,1400,0,0,9000,9000,9000,0,4192,250,170,580,240,171
2020,332600201,24709,4469,4469,4469,0,20240,20000,20000,0,0,240,240,0,0,40,40,0,0,2558,168,50,300,120,65
2020,332600231,12232,1532,1532,1532,0,10700,10000,10000,0,0,700,700,0,0,2797,2797,2797,0,1741,853,180,110,93,120
2020,332600271,9230,830,830,830,0,8400,8000,8000,0,0,400,400,0,0,3700,3700,3700,0,2360,120,0,220,180,226
2020,332600301,95148,22148,9148,9148,13000,73000,70000,0,70000,0,3000,3000,0,0,54476,31876,29660,0,4816,270,1100,230,96,278
2020,332600321,360,360,360,360,0,0,0,0,0,0,0,0,0,0,0,0,0,0,671,192,210,24,30,1
2020,332600341,1275,1275,1275,1275,0,0,0,0,0,0,0,0,0,0,0,0,0,0,1448,240,180,60,48,1
2020,332700201,16219,4218,4218,4218,0,12001,11000,11000,0,0,1001,911,90,0,0,0,0,0,3412,225,400,472,235,121
2020,332700211,15486,4486,4486,4486,0,11000,11000,11000,0,0,0,0,0,0,7109,7109,6409,0,665,100,20,60,60,13
2020,332700221,51720,17770,17770,7770,0,33950,28000,28000,0,0,5950,4950,1000,0,14970,14970,14970,0,5142,276,50,300,192,919
2020,332700231,2489,2489,489,489,2000,0,0,0,0,0,0,0,0,0,0,0,0,0,1088,26,240,2,12,0
2020,332700251,24240,9620,9620,9620,0,14620,11000,11000,0,0,3620,2680,440,500,5200,5200,5000,0,2651,168,160,130,240,67
2020,332700291,29550,8850,8850,8850,0,20700,20000,20000,0,0,700,700,0,0,3000,0,0,0,2710,156,30,240,176,1122
2020,332700301,46550,14850,14850,14850,0,31700,31000,5000,26000,0,700,500,200,0,0,0,0,0,1020,270,120,70,70,128
2020,332700311,2870,620,620,620,0,2250,1700,1700,0,0,550,550,0,0,0,0,0,0,1290,250,50,150,60,37
2020,332700321,12110,6310,6310,6310,0,5800,5800,4000,1800,0,0,0,0,0,0,0,0,0,390,100,30,20,30,3
2020,332800221,48500,3500,3000,3000,500,45000,45000,0,45000,0,0,0,0,0,0,0,0,0,1940,550,190,120,70,116
2020,332800241,41750,100,100,100,0,41650,40000,40000,0,0,1650,1650,0,0,0,0,0,0,1130,204,50,120,36,96
2020,332800261,60900,31000,31000,31000,0,29900,29900,29900,0,0,0,0,0,0,0,0,0,0,877,198,220,36,18,232
2020,332800271,70070,7870,7870,7870,0,62200,58000,30000,28000,0,4200,4200,0,0,2639,2639,0,0,2990,234,200,120,300,2290
2020,332800281,17670,4520,4520,4520,0,13150,12800,12800,0,0,350,350,0,0,4000,4000,4000,0,3090,180,30,360,300,82
2020,332800291,20100,0,0,0,0,20100,19000,19000,0,0,1100,600,500,0,12950,12950,10500,2450,3274,360,1000,400,130,326
2020,332800311,18178,6678,6678,6678,0,11500,5000,5000,0,0,6500,5000,0,1500,0,0,0,0,1559,174,50,160,48,16
2020,332800321,1959,459,459,459,0,1500,1500,1500,0,0,0,0,0,0,0,0,0,0,830,244,240,36,30,3
2020,332800331,3699,3699,3699,3699,0,0,0,0,0,0,0,0,0,0,0,0,0,0,643,202,10,15,24,1
2020,332900211,27256,3956,3956,3956,0,23300,23000,23000,0,0,300,300,0,0,4500,4500,4500,0,4362,324,200,300,228,135
2020,332900221,31388,3638,1838,1838,1800,27750,24900,0,24900,0,2850,2850,0,0,23190,2290,0,2010,3670,420,160,1200,264,70
2020,332900241,19720,920,920,920,0,18800,10100,9000,1100,0,8700,1700,0,7000,2172,2172,1320,0,1000,192,10,100,96,96
2020,332900251,57424,5924,5924,5924,0,51500,49000,49000,0,0,2500,2500,0,0,28500,22500,21500,1000,2550,480,30,300,500,329
2020,332900271,2819,2803,1303,1303,1500,16,0,0,0,0,16,0,16,0,938,938,0,938,1561,590,3,228,156,1
2020,332900301,24500,6550,6550,6550,0,17950,17000,11000,6000,0,950,500,450,0,500,0,0,0,1760,240,180,240,60,106
2020,332900311,24450,750,750,750,0,23700,22800,2800,20000,0,900,0,900,0,3000,3000,0,3000,1484,100,150,200,96,6
2020,332900321,60830,1250,1250,1250,0,59580,57700,1700,56000,0,1880,80,1800,0,3300,3300,0,2300,1283,160,98,170,85,18
2020,332900331,81368,4368,4368,4368,0,77000,77000,0,77000,0,0,0,0,0,1200,0,0,0,4917,4195,100,40,100,103
2020,333000202,10470,10070,70,70,10000,400,0,0,0,0,400,400,0,0,5020,5020,5000,0,949,180,35,36,48,47
2020,333000212,22047,20980,6480,6480,14500,1067,0,0,0,0,1067,1000,67,0,200,200,0,0,1878,240,20,180,96,32
2020,333600201,66030,15030,15030,15030,0,51000,50000,50000,0,0,1000,1000,0,0,29800,29800,23800,6000,4810,360,240,600,360,1193
2020,333600211,77435,5562,5562,5562,0,71873,70000,59000,11000,0,1873,1873,0,0,7960,1960,0,1960,9225,420,105,420,300,1408
2020,333700201,21147,20374,3374,3374,17000,773,0,0,0,0,773,659,114,0,14600,14600,12000,2500,2458,226,180,240,120,28
2020,333800211,150,150,50,50,100,0,0,0,0,0,0,0,0,0,0,0,0,0,754,444,10,10,90,0
2020,333900201,39170,220,220,220,0,38950,37250,7000,30250,0,1700,1700,0,0,29900,7900,6200,1700,1110,170,30,90,60,39
2020,333900211,450,400,400,400,0,50,0,0,0,0,50,0,50,0,0,0,0,0,294,80,30,12,12,1
2020,340000202,21163,4091,4091,4091,0,17072,15000,15000,0,0,2072,520,1552,0,53,53,0,0,3648,240,55,425,120,81
2020,340000212,36682,21432,21432,21432,0,15250,14800,14800,0,0,450,450,0,0,0,0,0,0,2003,276,500,200,72,203
2020,340000222,21063,63,63,63,0,21000,21000,21000,0,0,0,0,0,0,0,0,0,0,421,181,33,12,15,23
2020,340000232,99328,16528,16528,16528,0,82800,80300,20300,60000,0,2500,2500,0,0,56000,56000,56000,0,4041,281,68,304,154,402
2020,340000252,325,260,60,60,200,65,0,0,0,0,65,0,65,0,0,0,0,0,812,91,63,144,107,0
2020,340000262,24211,2662,2662,2662,0,21549,21500,21500,0,0,49,0,49,0,5774,2774,2749,0,1392,96,84,144,132,21
2020,340000272,4456,4065,65,65,4000,391,0,0,0,0,391,350,41,0,0,0,0,0,961,54,66,180,42,48
2020,340000282,449564,6974,6974,6974,0,442590,441000,21000,420000,0,1590,1590,0,0,320300,320300,300000,0,3906,312,90,396,90,1001
2020,340000302,226310,149610,149610,144610,0,76700,55000,30000,25000,0,21700,16700,5000,0,19500,1500,0,0,9250,700,800,800,200,4285
2020,340000312,21260,10,10,10,0,21250,20000,20000,0,0,1250,1250,0,0,11175,11175,11175,0,2310,360,10,360,360,81
2020,340000342,5720,1620,1120,620,500,4100,0,0,0,0,4100,600,1500,2000,1300,1300,0,1300,3025,720,20,600,300,44
2020,340000352,12530,1830,1830,1830,0,10700,10500,10500,0,0,200,200,0,0,0,0,0,0,603,130,12,150,50,38
2020,340000362,7260,7260,1760,1760,5500,0,0,0,0,0,0,0,0,0,5900,5900,4400,1500,2004,420,10,50,120,23
2020,340000372,37390,4410,4410,4410,0,32980,32000,32000,0,0,980,300,680,0,86,86,0,0,4810,230,130,350,190,217
2020,340000382,10018,9918,6418,6418,3500,100,0,0,0,0,100,100,0,0,0,0,0,0,3127,132,30,204,168,233
2020,340000392,9810,8860,8760,8760,100,950,0,0,0,0,950,950,0,0,300,300,0,0,1440,456,30,60,144,97
2020,340600201,95870,20909,20909,15509,0,74961,69800,19800,50000,0,5161,4460,701,0,1200,1200,0,0,3163,360,121,635,349,308
2020,340600221,6653,153,153,153,0,6500,6500,6500,0,0,0,0,0,0,0,0,0,0,815,132,86,48,66,4
2020,340600241,96392,15970,15970,15970,0,80422,79000,36000,43000,0,1422,1160,262,0,5000,0,0,0,4240,550,70,720,600,378
2020,340600271,93279,39479,39479,36479,0,53800,45000,28000,17000,0,8800,7700,1100,0,1000,0,0,0,6368,430,74,660,340,1473
2020,340600291,18590,4164,4164,4164,0,14426,12000,12000,0,0,2426,2200,226,0,500,0,0,0,3393,264,238,438,240,92
2020,340600361,57540,13040,13040,10040,0,44500,40000,28000,12000,0,4500,1500,0,3000,0,0,0,0,3220,160,300,300,240,384
2020,340600371,82618,2818,2818,818,0,79800,77000,25000,52000,0,2800,2500,300,0,53964,47964,47564,400,2210,240,80,50,190,295
2020,340600381,17700,1000,1000,1000,0,16700,15000,15000,0,0,1700,1700,0,0,1450,1450,1450,0,2075,480,250,360,85,75
2020,340600391,35945,9157,9157,2157,0,26788,24938,24938,0,0,1850,1850,0,0,1500,0,0,0,4608,192,820,630,225,1491
2020,340700201,10910,458,458,458,0,10452,10000,10000,0,0,452,0,452,0,0,0,0,0,1538,183,607,126,96,24
2020,340700221,78060,12534,12534,12534,0,65526,59000,59000,0,0,6526,4300,2226,0,22230,22230,18300,3800,4351,312,180,1200,180,1096
2020,340700241,25312,9444,9444,9444,0,15868,11300,11300,0,0,4568,3416,1152,0,2300,2300,2300,0,4496,318,240,480,383,167
2020,340700251,25559,7734,7734,7734,0,17825,15000,15000,0,0,2825,2800,25,0,1561,1561,1000,500,4404,180,156,540,264,102
2020,340700261,33311,4401,4401,4401,0,28910,28000,28000,0,0,910,520,390,0,18140,18140,16040,2000,2672,287,32,151,259,109
2020,340700271,31536,2784,2784,2784,0,28752,28000,28000,0,0,752,300,452,0,5940,5940,5940,0,1662,238,302,189,60,43
2020,340700281,53367,11950,11950,11950,0,41417,39900,22900,17000,0,1517,1500,17,0,11000,10000,0,10000,4490,160,180,480,240,781
2020,340700321,4712,4712,4212,4212,500,0,0,0,0,0,0,0,0,0,3500,3500,0,0,2300,600,200,200,300,23
2020,340700331,12510,5010,5010,5010,0,7500,7000,7000,0,0,500,500,0,0,5000,5000,5000,0,2640,300,100,200,180,81
2020,340800221,45311,18536,18536,18536,0,26775,22000,22000,0,0,4775,4600,175,0,10000,4000,0,4000,6969,180,308,630,363,1061
2020,340800231,91186,4960,4960,4960,0,86226,85000,50000,35000,0,1226,0,1226,0,4000,0,0,0,4997,860,74,360,600,240
2020,340800251,4805,4725,4525,4525,200,80,0,0,0,0,80,0,80,0,6060,6060,0,1060,1464,450,100,120,144,16
2020,340800261,25832,6825,6825,6825,0,19007,18000,18000,0,0,1007,910,97,0,14,14,0,0,2430,252,250,252,96,80
2020,340800271,40,40,40,40,0,0,0,0,0,0,0,0,0,0,0,0,0,0,571,110,75,12,30,4
2020,340800281,46134,23544,10044,10044,13500,22590,20000,0,0,20000,2590,2390,200,0,0,0,0,0,4136,180,20,360,180,445
2020,340800291,33923,20048,20048,17048,0,13875,10000,10000,0,0,3875,2310,1565,0,0,0,0,0,2081,384,124,302,204,97
2020,340800301,109562,4110,4110,4110,0,105452,105000,105000,0,0,452,0,452,0,3000,0,0,0,1132,102,64,15,88,227
2020,340800311,660,60,60,60,0,600,0,0,0,0,600,600,0,0,420,420,0,420,1535,251,0,120,120,10
2020,340800321,31801,2349,2349,2349,0,29452,26300,10500,15800,0,3152,2700,452,0,12300,3300,2800,500,4260,300,250,650,240,357
2020,340800331,52597,6347,6347,6347,0,46250,45000,26000,19000,0,1250,1250,0,0,4000,0,0,0,6470,530,240,780,180,1436
2020,340800341,28252,8052,8052,8052,0,20200,20000,20000,0,0,200,200,0,0,16250,16250,13850,2400,1970,250,200,200,120,43
2020,340800351,97320,29620,29620,29620,0,67700,64000,24000,40000,0,3700,3700,0,0,14500,1500,1500,0,5380,700,80,500,400,2464
2020,340800361,450,300,300,300,0,150,0,0,0,0,150,150,0,0,0,0,0,0,1178,280,80,180,58,36
2020,340800391,62530,25030,25030,25030,0,37500,35000,15000,20000,0,2500,2500,0,0,0,0,0,0,6300,300,1000,300,300,1155
2020,340900221,10910,5294,5294,5294,0,5616,5300,5300,0,0,316,300,16,0,0,0,0,0,1898,151,241,264,226,17
2020,340900241,18405,18405,18205,18205,200,0,0,0,0,0,0,0,0,0,0,0,0,0,1719,325,600,160,60,7
2020,340900251,21028,2657,2657,2657,0,18371,18000,13000,5000,0,371,273,98,0,15200,9700,7500,200,3270,288,72,360,360,115
2020,340900261,840,820,820,820,0,20,0,0,0,0,20,0,20,0,0,0,0,0,519,93,37,13,15,1
2020,340900271,26897,9997,9997,9997,0,16900,16000,16000,0,0,900,900,0,0,0,0,0,0,1949,186,350,300,84,487
2020,340900281,25210,7968,7968,7968,0,17242,17000,17000,0,0,242,160,82,0,0,0,0,0,3160,310,250,550,450,97
2020,340900301,22823,10123,10123,7123,0,12700,10000,10000,0,0,2700,1700,1000,0,7800,7800,7000,800,2000,200,150,350,200,62
2020,340900321,14730,530,530,530,0,14200,14000,14000,0,0,200,200,0,0,0,0,0,0,1890,200,50,200,180,160
2020,340900331,38800,400,400,400,0,38400,22000,22000,0,0,16400,9400,6000,1000,8520,8520,8520,0,4900,400,70,400,260,70
2020,340900341,13380,80,80,80,0,13300,4000,4000,0,0,9300,6300,0,3000,7575,7575,1875,0,2348,192,200,60,156,6
2020,340900351,201590,400,400,400,0,201190,198000,50000,148000,0,3190,3100,90,0,163200,88200,86700,1500,3600,760,130,220,90,210
2020,340900361,1006,306,306,306,0,700,0,0,0,0,700,700,0,0,0,0,0,0,1980,420,30,250,180,27
2020,340900371,16620,4620,4620,4620,0,12000,11000,11000,0,0,1000,1000,0,0,6200,6200,6200,0,1970,150,40,200,80,144
2020,340900381,44622,4852,4852,4852,0,39770,39500,25000,14500,0,270,270,0,0,1333,1333,0,0,2660,276,200,420,150,467
2020,340900391,1310,1310,1210,1210,100,0,0,0,0,0,0,0,0,0,0,0,0,0,3040,420,100,30,50,6
2020,341000212,126,126,26,26,100,0,0,0,0,0,0,0,0,0,0,0,0,0,1272,305,125,12,18,1
2020,341000222,931,395,195,195,200,536,0,0,0,0,536,490,46,0,0,0,0,0,2565,439,22,251,308,82
2020,341000232,7883,653,653,653,0,7230,7230,7230,0,0,0,0,0,0,0,0,0,0,1567,88,107,89,66,9
2020,341000242,2626,726,726,726,0,1900,0,0,0,0,1900,1400,500,0,10000,10000,0,0,731,84,120,120,36,30
2020,341000252,8837,337,337,337,0,8500,8500,7000,1500,0,0,0,0,0,0,0,0,0,3619,1712,1545,53,38,12
2020,341000272,60870,16167,16167,16167,0,44703,43000,38000,5000,0,1703,1500,203,0,0,0,0,0,4764,384,54,744,228,262
2020,341000282,3161,3161,661,661,2500,0,0,0,0,0,0,0,0,0,0,0,0,0,828,60,360,120,24,0
2020,341000292,2250,2250,2050,2000,200,0,0,0,0,0,0,0,0,0,0,0,0,0,2604,600,20,120,60,8
2020,341000302,8680,80,80,80,0,8600,8000,8000,0,0,600,100,500,0,4000,4000,4000,0,1510,200,150,200,100,14
2020,341000312,7856,6,6,6,0,7850,6000,0,6000,0,1850,1300,0,550,1540,1540,0,1500,2230,75,500,120,120,63
2020,341000322,29100,11900,11900,11900,0,17200,15000,8000,7000,0,2200,2200,0,0,15000,10000,0,0,2472,200,100,400,140,404
2020,341000332,1425,145,45,45,100,1280,1280,0,1280,0,0,0,0,0,0,0,0,0,1179,420,35,20,120,1
2020,341000342,20490,1190,1190,1190,0,19300,17000,12000,5000,0,2300,2300,0,0,3000,3000,3000,0,4080,400,100,240,300,37
2020,341000352,500,400,400,400,0,100,0,0,0,0,100,100,0,0,0,0,0,0,856,264,120,120,36,21
2020,341000362,4820,720,720,720,0,4100,3000,3000,0,0,1100,1100,0,0,0,0,0,0,1341,84,245,216,156,73
2020,341000372,32556,8356,8356,8356,0,24200,21600,1600,20000,0,2600,1600,1000,0,0,0,0,0,3220,360,420,600,240,53
2020,341600201,27403,11290,11290,11290,0,16113,16000,16000,0,0,113,0,113,0,0,0,0,0,889,113,205,58,24,43
2020,341600211,21779,130,130,130,0,21649,19700,19700,0,0,1949,1900,49,0,4496,4496,4496,0,2210,300,240,480,210,107
2020,341600221,561,528,28,28,500,33,0,0,0,0,33,0,33,0,0,0,0,0,849,132,184,22,34,0
2020,341600231,332,332,332,332,0,0,0,0,0,0,0,0,0,0,0,0,0,0,831,306,47,43,38,0
2020,341600241,46421,5073,5073,5073,0,41348,38500,18500,20000,0,2848,2350,498,0,10000,10000,10000,0,3346,243,125,481,244,85
2020,341600251,155836,60636,37636,37636,23000,95200,85000,0,85000,0,10200,4400,5800,0,0,0,0,0,3713,362,118,482,252,1183
2020,341600281,6507,5077,1577,1577,3500,1430,0,0,0,0,1430,1430,0,0,671,671,0,0,2525,156,301,241,108,51
2020,341600291,14481,13968,12768,12768,1200,513,0,0,0,0,513,400,113,0,216,216,0,0,2347,265,84,203,221,70
2020,341600311,2065,65,65,65,0,2000,2000,2000,0,0,0,0,0,0,0,0,0,0,553,143,60,5,30,7
2020,341600321,29070,3340,3340,3340,0,25730,25000,25000,0,0,730,650,80,0,13000,13000,13000,0,4270,660,250,300,110,147
2020,341600331,21540,17340,5340,5340,12000,4200,2300,0,0,2300,1900,1900,0,0,0,0,0,0,3980,200,300,300,180,608
2020,341600351,56565,11715,11715,11715,0,44850,44000,24000,20000,0,850,850,0,0,11000,10000,10000,0,2720,300,20,300,300,173
2020,341600361,37030,30,30,30,0,37000,37000,500,36500,0,0,0,0,0,0,0,0,0,352,100,50,20,18,15
2020,341600371,48546,26446,26446,8446,0,22100,19950,15000,4950,0,2150,2150,0,0,4156,4156,3956,0,10962,420,120,480,192,86
2020,341600381,69457,7010,7010,7010,0,62447,62000,14000,48000,0,447,447,0,0,2400,1900,0,1900,3620,300,1000,480,360,240
2020,341600391,47667,2932,2932,2932,0,44735,43000,25000,18000,0,1735,1285,450,0,36090,20090,20090,0,2046,218,40,200,148,244
2020,341700211,302,302,59,59,243,0,0,0,0,0,0,0,0,0,0,0,0,0,424,60,32,10,15,0
2020,341700221,14110,2062,2062,2062,0,12048,12000,12000,0,0,48,0,48,0,0,0,0,0,1720,1082,180,10,16,15
2020,341700231,22358,5498,5498,5498,0,16860,16000,12000,4000,0,860,780,80,0,4692,4692,1300,3200,2357,192,135,230,228,241
2020,341700241,27276,25913,2913,2913,23000,1363,0,0,0,0,1363,1200,163,0,20000,20000,20000,0,3244,260,30,365,192,244
2020,341700251,14852,2102,2102,2102,0,12750,0,0,0,0,12750,750,0,12000,140,140,0,0,1550,127,35,342,96,1
2020,341700261,26580,44,44,44,0,26536,26500,26500,0,0,36,0,36,0,0,0,0,0,862,95,129,64,15,8
2020,341700271,14582,5962,5962,5962,0,8620,7200,6000,0,1200,1420,1420,0,0,200,200,0,200,3139,173,282,423,156,496
2020,341700281,32723,4223,4223,4223,0,28500,23000,0,23000,0,5500,5500,0,0,7800,7500,5800,0,2422,104,29,407,288,71
2020,341700291,105847,30171,9171,9171,21000,75676,75000,0,75000,0,676,450,226,0,6000,1500,0,1500,2955,300,120,420,228,167
2020,341700301,493,493,493,193,0,0,0,0,0,0,0,0,0,0,100,100,0,0,766,100,30,96,60,3
2020,341700311,55039,9939,9939,9939,0,45100,40000,40000,0,0,5100,4700,400,0,0,0,0,0,2920,240,100,100,120,361
2020,341700351,10494,6494,1494,1494,5000,4000,0,0,0,0,4000,4000,0,0,2868,2868,0,0,1572,120,25,360,120,209
2020,341700361,109347,13797,13797,13497,0,95550,85000,85000,0,0,10550,520,10030,0,5500,500,0,0,3625,180,10,210,302,117
2020,341700371,1500,500,500,500,0,1000,1000,1000,0,0,0,0,0,0,0,0,0,0,711,192,130,10,24,3
2020,341700381,53558,10058,10058,10058,0,43500,40000,40000,0,0,3500,3500,0,0,350,350,0,0,3956,386,150,420,240,371
2020,341800201,82303,27329,27329,27329,0,54974,52000,27000,25000,0,2974,2950,24,0,15000,15000,0,15000,5850,400,300,600,250,1009
2020,341800221,48207,27139,27139,27139,0,21068,21000,21000,0,0,68,0,68,0,0,0,0,0,1582,192,268,82,70,89
2020,341800231,207727,32047,32047,32047,0,175680,173500,72000,95000,6500,2180,1650,530,0,6052,6052,6052,0,6713,648,500,900,155,189
2020,341800261,1110,1110,110,110,1000,0,0,0,0,0,0,0,0,0,0,0,0,0,1299,588,90,48,108,1
2020,341800271,3620,3584,3384,3384,200,36,0,0,0,0,36,36,0,0,0,0,0,0,919,350,10,180,96,44
2020,341800301,124557,7366,7366,7366,0,117191,115000,14000,101000,0,2191,1400,791,0,31000,10000,10000,0,2980,100,50,450,380,738
2020,341800311,52370,2670,2670,2670,0,49700,48000,48000,0,0,1700,1700,0,0,10112,10112,9224,0,3660,440,200,300,480,80
2020,341800321,572300,2200,2200,2200,0,570100,405000,5000,400000,0,165100,100,10000,155000,100000,100000,100000,0,2660,540,100,400,150,206
2020,341800341,51560,10210,10210,10210,0,41350,39000,15000,24000,0,2350,1000,1350,0,140,140,0,0,3300,400,400,300,150,108
2020,341800351,15174,8824,8824,8824,0,6350,5000,5000,0,0,1350,0,1350,0,0,0,0,0,1248,150,360,10,25,6
2020,341800361,6131,1655,1655,1655,0,4476,3800,2000,1800,0,676,450,226,0,120,120,0,0,2001,202,110,292,120,143
2020,341800371,2664,464,264,264,200,2200,0,0,0,0,2200,2200,0,0,760,760,0,0,2908,480,100,500,480,87
2020,341900211,400,127,77,77,50,273,0,0,0,0,273,180,93,0,120,120,0,0,1996,402,342,481,36,13
2020,341900221,153939,24900,24900,24900,0,129039,120000,90000,30000,0,9039,8000,1039,0,68120,44120,31000,10000,7900,1000,500,500,120,6680
2020,341900271,62097,12197,12197,12197,0,49900,49000,30000,19000,0,900,900,0,0,15200,200,0,0,5394,567,128,305,214,6694
2020,341900281,190826,10716,10716,10716,0,180110,178000,28000,150000,0,2110,1910,200,0,10000,2000,2000,0,5936,361,295,585,302,1529
2020,341900291,12245,10860,7260,7080,3600,1385,0,0,0,0,1385,970,415,0,0,0,0,0,1725,348,200,250,72,54
2020,341900301,15750,3410,3410,3410,0,12340,4340,4340,0,0,8000,1000,7000,0,0,0,0,0,3280,350,200,1000,180,97
2020,341900311,29100,1000,1000,1000,0,28100,27000,12000,15000,0,1100,0,1100,0,0,0,0,0,1420,170,400,30,40,16
2020,341900321,12982,756,256,256,500,12226,12000,0,12000,0,226,0,226,0,4030,4030,4000,0,575,120,17,86,42,124
2020,341900331,6642,642,642,642,0,6000,6000,6000,0,0,0,0,0,0,0,0,0,0,938,140,92,36,41,8
2020,341900341,9106,8806,2806,2806,6000,300,0,0,0,0,300,300,0,0,1070,1070,1000,0,1860,200,60,180,120,576
2020,341900351,5600,5600,100,100,5500,0,0,0,0,0,0,0,0,0,4080,4080,4080,0,550,80,10,30,120,1
2020,341900361,94770,9570,9570,9570,0,85200,84300,45000,35000,4300,900,800,100,0,22000,0,0,0,6520,480,160,360,300,230
2020,341900381,80400,15100,15100,15100,0,65300,61400,8400,53000,0,3900,3800,100,0,4800,1300,0,1300,1920,300,100,70,120,301
2020,342000202,97198,16748,16748,15748,0,80450,79000,29000,50000,0,1450,450,1000,0,257,257,0,0,5628,895,413,400,360,1237
2020,342000212,9767,8045,2045,2045,6000,1722,0,0,0,0,1722,1270,452,0,32,32,0,0,3071,204,274,420,180,141
2020,342000222,17330,2330,2330,2330,0,15000,15000,15000,0,0,0,0,0,0,500,500,500,0,1664,216,62,64,36,10
2020,342000232,10757,7557,7107,7107,450,3200,0,0,0,0,3200,3200,0,0,3020,3020,0,2850,2590,421,51,481,121,55
2020,342000242,115,115,15,15,100,0,0,0,0,0,0,0,0,0,1800,1800,0,0,741,396,10,70,60,5
2020,342000302,44950,1650,1650,1650,0,43300,43000,35000,8000,0,300,300,0,0,7150,6150,0,1000,6450,240,620,360,240,100
2020,342000322,9390,1000,1000,1000,0,8390,8390,3000,5390,0,0,0,0,0,0,0,0,0,450,76,20,10,35,4
2020,342000332,38679,16715,16715,16715,0,21964,15084,1500,13584,0,6880,4767,2113,0,1552,1552,0,500,1660,200,50,240,210,231
2020,342000342,26934,5364,5364,5364,0,21570,20720,8820,11900,0,850,700,150,0,6000,6000,6000,0,1166,90,120,150,66,19
2020,342000352,48018,6448,6448,6448,0,41570,37000,25000,12000,0,4570,4470,100,0,2200,2200,0,0,6934,312,1000,418,504,1340
2020,342000372,7802,3802,1802,1802,2000,4000,0,0,0,0,4000,2000,0,2000,4530,4530,0,4500,2249,396,760,180,204,40
2020,342000382,5111,5011,3211,3141,1800,100,0,0,0,0,100,0,100,0,1125,1125,1015,0,2068,372,100,120,216,1
2020,342600201,51233,7594,7594,7594,0,43639,43000,43000,0,0,639,300,339,0,3918,3918,3918,0,4020,320,180,240,120,788
2020,342600211,33520,6912,6912,6912,0,26608,25000,23000,2000,0,1608,1300,308,0,0,0,0,0,2747,214,84,247,108,185
2020,342600301,20810,1660,1660,1660,0,19150,19000,7000,12000,0,150,0,150,0,120,0,0,0,857,150,120,20,20,16
2020,342600311,100674,5874,5874,5874,0,94800,45500,3500,42000,0,49300,2300,47000,0,46676,46676,45000,0,2246,222,20,480,246,155
2020,342600321,29412,5062,5062,5062,0,24350,18250,1000,17250,0,6100,1800,4300,0,600,600,0,600,2168,160,400,300,168,88
2020,342600331,29253,11308,11308,7708,0,17945,16280,6780,9500,0,1665,1100,565,0,0,0,0,0,2734,242,30,237,254,183
2020,342600341,13260,5260,5260,5260,0,8000,8000,4000,4000,0,0,0,0,0,0,0,0,0,2264,720,60,24,120,52
2020,342700301,2500,100,100,100,0,2400,2400,2400,0,0,0,0,0,0,0,0,0,0,554,140,135,1,7,4
2020,342700311,13540,40,40,40,0,13500,13500,5000,8500,0,0,0,0,0,0,0,0,0,1600,360,240,10,60,6
2020,342700331,10077,4977,4977,4677,0,5100,5000,5000,0,0,100,0,100,0,0,0,0,0,1244,185,360,120,72,4
2020,342800201,286270,37970,37970,37970,0,248300,220500,28000,182500,10000,27800,3300,24500,0,148520,137520,137520,0,6860,260,50,800,400,3795
2020,342800211,53720,12360,12360,11360,0,41360,38000,38000,0,0,3360,3200,160,0,0,0,0,0,5053,948,179,675,219,787
2020,342800231,10297,10242,6642,6642,3600,55,0,0,0,0,55,0,55,0,0,0,0,0,626,208,35,41,36,5
2020,342800301,4103,3403,3,3,3400,700,0,0,0,0,700,700,0,0,3000,3000,0,3000,2116,220,36,360,300,45
2020,342800311,11420,20,20,20,0,11400,11400,2000,9400,0,0,0,0,0,0,0,0,0,704,180,52,50,32,11
2020,342800331,44010,610,610,610,0,43400,33000,8000,25000,0,10400,1900,0,8500,0,0,0,0,1618,150,30,204,108,99
2020,342800341,37500,2200,2200,2200,0,35300,20500,10000,10500,0,14800,800,14000,0,8680,8680,8000,0,1837,600,120,50,77,17
2020,342800351,103303,5900,5900,5900,0,97403,57790,9790,48000,0,39613,3900,15713,20000,37500,37500,20000,16000,5083,540,64,864,200,129
2020,342800371,36927,8907,8907,8907,0,28020,23000,8000,15000,0,5020,1900,3120,0,0,0,0,0,2610,162,600,300,84,39
2020,342900201,2006,706,276,276,430,1300,0,0,0,0,1300,1300,0,0,2496,2496,0,2496,2555,361,61,72,312,56
2020,342900211,8321,298,298,298,0,8023,8000,8000,0,0,23,0,23,0,0,0,0,0,764,162,126,54,24,9
2020,342900221,9033,33,33,33,0,9000,9000,9000,0,0,0,0,0,0,0,0,0,0,745,166,200,12,18,9
2020,342900231,29018,20898,8898,8898,12000,8120,5000,0,0,5000,3120,1900,1220,0,500,500,0,500,4262,446,66,486,144,707
2020,342900241,45209,8283,8283,2283,0,36926,33000,25000,8000,0,3926,3700,226,0,16220,16220,12700,3400,2718,180,20,360,204,242
2020,342900301,7243,1153,100,100,1053,6090,6000,0,6000,0,90,90,0,0,0,0,0,0,795,264,15,60,15,26
2020,342900311,26210,16410,16410,16410,0,9800,9000,0,9000,0,800,800,0,0,0,0,0,0,1435,120,50,240,60,60
2020,342900331,1010,10,10,10,0,1000,1000,1000,0,0,0,0,0,0,0,0,0,0,443,60,120,20,48,4
2020,342900341,17335,235,235,235,0,17100,16000,9000,7000,0,1100,1100,0,0,1155,1155,700,455,2084,204,120,450,180,49
2020,342900351,13978,3050,3050,3050,0,10928,10000,10000,0,0,928,770,158,0,0,0,0,0,1637,216,30,240,72,585
2020,342900361,13223,2645,2645,2645,0,10578,6200,6200,0,0,4378,700,3678,0,0,0,0,0,3307,120,2060,360,89,23
2020,342900371,5683,13,13,13,0,5670,5570,5570,0,0,100,0,100,0,0,0,0,0,447,120,120,10,36,3
2020,342900381,22083,13972,13972,13972,0,8111,6815,1500,5315,0,1296,500,796,0,617,617,0,617,1619,120,100,360,140,39
2020,343000302,15530,200,200,200,0,15330,15300,15300,0,0,30,0,30,0,3000,3000,3000,0,1064,348,120,0,36,41
2020,343000312,8371,371,371,371,0,8000,8000,8000,0,0,0,0,0,0,0,0,0,0,1722,346,120,240,156,7
2020,343000322,23639,3360,3360,3360,0,20279,20092,0,20092,0,187,0,187,0,500,500,0,500,615,112,120,72,60,11
2020,350000202,136072,83372,83372,83372,0,52700,48200,35000,13200,0,4500,4500,0,0,0,0,0,0,4870,360,800,600,240,1195
2020,350000212,40100,7330,7330,1330,0,32770,25000,25000,0,0,7770,700,70,7000,7800,7800,0,5800,4000,615,145,500,240,261
2020,350000222,10850,1250,1250,1250,0,9600,7500,7500,0,0,2100,1900,200,0,30,30,0,0,1944,192,48,240,180,56
2020,350000242,13108,5808,5808,4308,0,7300,6000,6000,0,0,1300,1300,0,0,1000,1000,0,0,2470,360,60,180,120,40
2020,350000272,1,1,1,1,0,0,0,0,0,0,0,0,0,0,0,0,0,0,402,147,24,0,48,1
2020,350000282,20100,100,100,100,0,20000,20000,20000,0,0,0,0,0,0,0,0,0,0,889,418,120,2,36,13
2020,350000292,27750,0,0,0,0,27750,25000,25000,0,0,2750,2750,0,0,8000,8000,8000,0,2850,250,50,200,150,61
2020,350000312,19046,7356,7356,7356,0,11690,9500,9500,0,0,2190,2190,0,0,1620,1620,0,0,2500,240,60,360,160,46
2020,350000322,23382,3982,3982,3982,0,19400,14000,14000,0,0,5400,5400,0,0,12725,12725,12700,0,2816,260,250,276,180,364
2020,350000352,22885,22085,11085,11085,11000,800,0,0,0,0,800,800,0,0,0,0,0,0,2386,250,40,240,96,238
2020,350000362,1026,1026,1026,1026,0,0,0,0,0,0,0,0,0,0,0,0,0,0,1007,100,5,20,72,5
2020,350000372,23777,5777,5777,5777,0,18000,17000,17000,0,0,1000,1000,0,0,22000,22000,10000,12000,4434,360,20,180,360,649
2020,350000392,81905,28350,28350,28350,0,53555,50000,50000,0,0,3555,3555,0,0,0,0,0,0,3365,390,300,280,145,929
2020,350600211,18936,2356,2356,2356,0,16580,15800,15800,0,0,780,480,300,0,0,0,0,0,1896,160,30,264,72,74
2020,350600221,270,270,20,20,250,0,0,0,0,0,0,0,0,0,0,0,0,0,617,156,0,10,36,0
2020,350600291,15751,151,151,151,0,15600,15500,15500,0,0,100,100,0,0,10133,10133,9751,0,3851,324,300,108,266,23
2020,350600321,31650,12290,12290,12290,0,19360,16000,16000,0,0,3360,3000,360,0,2132,2132,0,0,2430,300,200,500,70,102
2020,350600371,150,150,150,150,0,0,0,0,0,0,0,0,0,0,0,0,0,0,985,180,140,70,60,1
2020,350600381,32860,4060,4060,4060,0,28800,25000,25000,0,0,3800,3500,300,0,3500,3500,1500,0,6761,480,36,840,480,962
2020,350600391,60,60,60,60,0,0,0,0,0,0,0,0,0,0,0,0,0,0,1138,216,240,24,36,1
2020,350700231,4750,4350,1150,1150,3200,400,0,0,0,0,400,400,0,0,4500,4500,2700,1500,1964,524,60,300,180,9
2020,350700241,7550,50,50,50,0,7500,7500,7500,0,0,0,0,0,0,0,0,0,0,350,100,60,10,30,13
2020,350700251,15070,4070,4070,3770,0,11000,8500,8500,0,0,2500,2000,500,0,322,322,0,0,1907,255,185,369,130,210
2020,350700261,16484,6184,6184,4684,0,10300,6000,6000,0,0,4300,300,2500,1500,1495,1495,1095,400,1830,120,100,240,240,172
2020,350700311,46538,8680,8680,6380,0,37858,34730,8230,26500,0,3128,700,1728,700,200,200,0,200,2311,740,24,120,156,47
2020,350700321,8910,8910,5510,5510,3400,0,0,0,0,0,0,0,0,0,0,0,0,0,863,84,10,20,84,14
2020,350700341,2740,2540,2540,2540,0,200,0,0,0,0,200,200,0,0,0,0,0,0,1033,200,90,120,48,9
2020,350700351,10744,8944,5944,4944,3000,1800,0,0,0,0,1800,1800,0,0,800,800,0,0,1751,498,27,108,120,51
2020,350700361,370,150,150,150,0,220,0,0,0,0,220,220,0,0,0,0,0,0,2355,125,30,240,180,4
2020,350700391,120386,44986,44986,44986,0,75400,75000,40000,35000,0,400,400,0,0,0,0,0,0,3280,300,30,500,300,1797
2020,350800201,23300,3300,3300,3300,0,20000,20000,20000,0,0,0,0,0,0,200,0,0,0,1221,180,300,36,15,19
2020,350800211,155,155,55,55,100,0,0,0,0,0,0,0,0,0,2500,2500,0,0,1480,500,10,60,120,7
2020,350800221,2860,2760,2760,2760,0,100,0,0,0,0,100,100,0,0,0,0,0,0,1710,300,300,240,290,224
2020,350800231,357,357,125,125,232,0,0,0,0,0,0,0,0,0,1700,1700,0,0,1190,150,50,120,20,54
2020,350800241,13664,9834,2834,2834,7000,3830,0,0,0,0,3830,3500,330,0,30,30,0,0,4890,530,30,780,250,64
2020,350800261,14010,5940,5940,4940,0,8070,6500,6500,0,0,1570,1570,0,0,2000,2000,2000,0,6974,850,100,960,384,394
2020,350800271,45930,930,930,930,0,45000,45000,45000,0,0,0,0,0,0,639,639,0,639,1502,300,120,120,126,69
2020,350800281,24788,2788,2488,2488,300,22000,22000,0,22000,0,0,0,0,0,14700,14700,12200,0,2587,150,1500,96,36,30
2020,350800291,20353,16763,7763,7763,9000,3590,3000,0,0,3000,590,390,200,0,21000,21000,21000,0,2634,360,150,750,520,244
2020,350800311,27640,6040,6040,6040,0,21600,19000,19000,0,0,2600,2600,0,0,0,0,0,0,3910,300,180,540,240,159
2020,350800321,28689,6189,6189,6189,0,22500,17000,17000,0,0,5500,5500,0,0,2800,2800,1800,0,5930,460,600,1300,480,1109
2020,350800331,17141,4841,4841,4841,0,12300,12000,12000,0,0,300,300,0,0,6340,6340,4000,2340,2280,220,60,240,192,155
2020,350800341,25500,6420,6420,1420,0,19080,19000,16000,3000,0,80,80,0,0,3000,3000,3000,0,3299,255,180,480,144,56
2020,350800361,65670,16670,16670,16670,0,49000,47000,27000,20000,0,2000,1700,300,0,30900,30900,15900,15000,4219,480,120,360,300,167
2020,350800371,2544,2094,1794,1794,300,450,0,0,0,0,450,450,0,0,0,0,0,0,1330,470,110,160,90,27
2020,350800381,17651,6551,6551,6551,0,11100,9000,9000,0,0,2100,2100,0,0,2543,2543,0,2500,2240,200,230,120,40,187
2020,350900221,5705,1205,1205,1205,0,4500,4500,4500,0,0,0,0,0,0,0,0,0,0,956,132,180,60,60,5
2020,350900231,17645,15845,5845,5645,10000,1800,0,0,0,0,1800,800,1000,0,7400,7400,7000,400,3290,480,30,100,360,298
2020,350900241,7140,7140,640,640,6500,0,0,0,0,0,0,0,0,0,577,577,0,0,1047,132,12,120,15,1
2020,350900251,21020,8020,8020,8020,0,13000,13000,13000,0,0,0,0,0,0,0,0,0,0,1174,240,240,96,108,41
2020,350900261,1300,1300,1000,1000,300,0,0,0,0,0,0,0,0,0,0,0,0,0,1388,420,60,80,48,1
2020,350900281,9020,20,20,20,0,9000,9000,9000,0,0,0,0,0,0,0,0,0,0,628,156,60,24,36,9
2020,350900291,1350,1350,350,350,1000,0,0,0,0,0,0,0,0,0,0,0,0,0,1464,540,30,144,180,27
2020,350900301,6300,5800,300,300,5500,500,0,0,0,0,500,500,0,0,0,0,0,0,2706,192,20,400,204,21
2020,350900331,11100,11100,5100,5100,6000,0,0,0,0,0,0,0,0,0,0,0,0,0,447,120,150,15,12,6
2020,350900351,102152,16252,16252,16252,0,85900,80000,80000,0,0,5900,5900,0,0,21800,16800,16800,0,4220,600,100,360,360,969
2020,350900361,15145,15065,8065,8065,7000,80,0,0,0,0,80,80,0,0,0,0,0,0,2625,200,220,500,125,64
2020,350900381,20769,3769,3769,3769,0,17000,16000,16000,0,0,1000,1000,0,0,9450,9450,9450,0,2340,280,120,300,150,88
2020,351000202,10672,6472,1972,1972,4500,4200,0,0,0,0,4200,4200,0,0,5300,5300,0,2000,2071,360,5,240,300,26
2020,351000212,18716,1116,1116,1116,0,17600,15000,15000,0,0,2600,1500,1100,0,10700,2700,2700,0,2312,620,60,240,192,78
2020,351000222,1100,1100,100,100,1000,0,0,0,0,0,0,0,0,0,0,0,0,0,1005,408,60,15,66,1
2020,351000232,7780,200,200,200,0,7580,6800,6800,0,0,780,780,0,0,7000,7000,5000,2000,948,168,30,120,100,39
2020,351000242,9700,9500,9000,5000,500,200,0,0,0,0,200,200,0,0,0,0,0,0,2150,500,50,300,120,33
2020,351000252,71302,35352,11352,11352,24000,35950,35000,0,35000,0,950,700,250,0,3000,2000,0,2000,6922,300,1600,422,180,324
2020,351000262,13100,1100,1100,1100,0,12000,11000,11000,0,0,1000,1000,0,0,0,0,0,0,2312,348,60,720,144,18
2020,351000282,42800,12800,12800,12800,0,30000,30000,30000,0,0,0,0,0,0,0,0,0,0,4130,240,50,150,240,388
2020,351000292,84280,23680,23680,23680,0,60600,58000,15000,43000,0,2600,2600,0,0,0,0,0,0,2607,326,100,720,117,379
2020,351000312,24700,11100,11100,11100,0,13600,12100,11500,600,0,1500,1500,0,0,2000,2000,2000,0,4194,224,40,240,300,41
2020,351000322,13534,11034,1294,1294,9740,2500,0,0,0,0,2500,2500,0,0,6000,6000,6000,0,2770,480,120,250,360,51
2020,351000352,11980,1180,1180,1180,0,10800,10800,2800,8000,0,0,0,0,0,0,0,0,0,456,110,60,30,36,7
2020,351000362,31408,5758,5758,5558,0,25650,20000,8000,12000,0,5650,2900,2750,0,520,520,520,0,1955,145,50,230,240,160
2020,351000372,35504,27904,14404,12104,13500,7600,3300,0,0,3300,4300,4300,0,0,1400,1400,0,0,3520,420,200,400,300,151
2020,351000382,72720,22820,22820,22820,0,49900,47500,12500,35000,0,2400,2200,200,0,22000,22000,20000,2000,2690,280,70,250,150,294
2020,351600211,25350,150,150,150,0,25200,25000,25000,0,0,200,200,0,0,11800,10000,5000,0,1980,240,360,180,120,113
2020,351600221,291850,17570,17570,17570,0,274280,273800,95000,178800,0,480,180,300,0,29000,0,0,0,2138,360,48,230,120,404
2020,351600241,13506,9006,7006,7006,2000,4500,0,0,0,0,4500,4500,0,0,3130,3130,1130,0,3470,1100,200,160,240,60
2020,351600261,19150,350,350,350,0,18800,18500,11000,7500,0,300,300,0,0,2800,2800,800,0,1466,240,30,240,140,87
2020,351600271,30,30,30,30,0,0,0,0,0,0,0,0,0,0,0,0,0,0,1030,250,400,15,25,4
2020,351600281,72730,22330,6330,6330,16000,50400,50000,0,50000,0,400,400,0,0,10000,0,0,0,2950,300,50,240,120,114
2020,351600291,2550,2100,1600,1600,500,450,0,0,0,0,450,450,0,0,0,0,0,0,1514,168,40,290,76,83
2020,351600301,4011,4011,4011,4011,0,0,0,0,0,0,0,0,0,0,0,0,0,0,1010,400,50,20,60,1
2020,351600311,54638,23088,23088,22938,0,31550,28500,21000,7500,0,3050,3050,0,0,0,0,0,0,4190,460,150,430,400,388
2020,351600321,24965,3815,3815,3815,0,21150,21000,21000,0,0,150,150,0,0,3500,3500,3500,0,4030,240,10,350,180,237
2020,351600331,9648,908,908,908,0,8740,3500,3500,0,0,5240,4900,340,0,700,700,0,700,3980,600,60,720,360,241
2020,351600341,10240,90,90,90,0,10150,10000,2500,7500,0,150,100,50,0,1000,1000,1000,0,960,200,60,120,120,38
2020,351600351,32320,1120,1120,1120,0,31200,30000,20000,10000,0,1200,1100,100,0,300,300,0,300,3340,1040,200,360,120,123
2020,351600361,12150,5300,5300,5300,0,6850,6600,0,6600,0,250,0,250,0,0,0,0,0,570,100,50,20,60,15
2020,351600371,28140,920,920,920,0,27220,25500,19500,6000,0,1720,1220,500,0,9730,9730,8730,1000,2980,280,50,700,420,111
2020,351700201,50800,700,700,700,0,50100,50000,50000,0,0,100,100,0,0,500,0,0,0,1250,120,440,120,60,108
2020,351700211,4200,3600,100,100,3500,600,0,0,0,0,600,600,0,0,0,0,0,0,403,90,30,60,18,9
2020,351700221,6604,454,454,454,0,6150,6000,6000,0,0,150,0,150,0,1069,1069,1000,0,665,140,36,12,36,12
2020,351700251,19000,5500,5500,5500,0,13500,13250,8000,5250,0,250,250,0,0,300,300,0,300,1498,180,24,360,72,343
2020,351700261,31750,10220,3720,3720,6500,21530,21000,0,21000,0,530,530,0,0,18600,4600,0,2000,1543,252,5,560,96,83
2020,351700311,37310,17640,17640,17640,0,19670,16500,10000,6500,0,3170,3170,0,0,0,0,0,0,4840,2300,100,780,240,1536
2020,351700321,245,245,35,35,210,0,0,0,0,0,0,0,0,0,0,0,0,0,573,132,20,42,24,0
2020,351700341,4620,4420,2420,2420,2000,200,0,0,0,0,200,200,0,0,650,650,650,0,2085,600,65,270,200,36
2020,351700351,6320,5770,1770,1270,4000,550,0,0,0,0,550,350,200,0,1500,1500,0,1500,2366,150,20,270,296,16
2020,351700371,15780,230,230,230,0,15550,15400,7000,8400,0,150,0,150,0,1000,1000,1000,0,926,120,240,60,96,13
2020,351700381,87940,42540,42540,42540,0,45400,39000,27000,12000,0,6400,6400,0,0,4900,4900,4900,0,6670,480,50,100,360,3123
2020,351700391,57170,24920,24920,24620,0,32250,26000,26000,0,0,6250,5700,550,0,14560,14560,9960,3500,6600,360,400,600,360,1580
2020,351800201,17138,6500,6500,6500,0,10638,10000,10000,0,0,638,500,138,0,0,0,0,0,4606,1540,30,300,96,206
2020,351800211,28560,4760,4760,4760,0,23800,23000,17000,6000,0,800,800,0,0,10180,10180,10050,0,3858,432,60,350,426,70
2020,351800261,112474,28074,28074,26074,0,84400,80000,52000,28000,0,4400,1400,0,3000,12540,10040,10000,0,2145,250,240,210,150,231
2020,351800281,34866,9966,9966,9966,0,24900,23000,23000,0,0,1900,1600,300,0,10600,10600,10500,0,4346,300,150,240,216,30
2020,351800311,9060,60,60,60,0,9000,9000,0,9000,0,0,0,0,0,0,0,0,0,360,60,20,10,20,7
2020,351800321,7120,2380,2380,2380,0,4740,4490,3500,990,0,250,250,0,0,0,0,0,0,1150,250,90,110,120,18
2020,351800331,300,100,100,100,0,200,0,0,0,0,200,200,0,0,0,0,0,0,960,180,120,120,28,15
2020,351800351,4212,3712,1912,1912,1800,500,0,0,0,0,500,500,0,0,0,0,0,0,1995,156,5,240,132,75
2020,351800361,1450,1450,50,50,1400,0,0,0,0,0,0,0,0,0,0,0,0,0,697,180,50,30,72,1
2020,351800381,8141,6641,1641,1641,5000,1500,0,0,0,0,1500,1500,0,0,4000,4000,4000,0,2398,200,120,360,288,55
2020,351800391,27180,6480,3480,3480,3000,20700,0,0,0,0,20700,16700,0,4000,9220,9220,7220,0,3580,360,80,480,240,71
2020,351900211,31861,5668,4668,4168,1000,26193,25500,0,25500,0,693,400,293,0,21267,3267,2667,500,2876,460,100,90,156,90
2020,351900221,37970,14770,14770,14770,0,23200,22500,21000,1500,0,700,700,0,0,0,0,0,0,4200,540,720,360,200,46
2020,351900231,42730,6680,6680,6680,0,36050,36000,22000,14000,0,50,0,50,0,2000,0,0,0,2544,540,120,24,90,54
2020,351900241,9550,750,750,750,0,8800,8000,8000,0,0,800,700,100,0,400,400,400,0,1851,156,15,360,100,45
2020,351900261,167080,13480,13480,13480,0,153600,150000,150000,0,0,3600,600,0,3000,60000,30000,30000,0,3342,360,150,100,312,252
2020,351900281,16739,1850,1850,1850,0,14889,14300,12000,2300,0,589,250,339,0,3600,3600,3600,0,3142,210,10,360,228,405
2020,351900301,6266,1266,1266,1266,0,5000,3800,3800,0,0,1200,1200,0,0,0,0,0,0,725,100,20,100,35,48
2020,351900311,39350,350,350,350,0,39000,39000,6000,33000,0,0,0,0,0,0,0,0,0,740,180,20,70,40,31
2020,351900331,25275,6300,6300,6300,0,18975,18775,10000,8775,0,200,100,100,0,0,0,0,0,1054,180,120,36,18,212
2020,351900361,5080,3280,2580,2580,700,1800,0,0,0,0,1800,1800,0,0,700,700,700,0,1950,180,30,230,120,37
2020,351900381,220,220,120,120,100,0,0,0,0,0,0,0,0,0,0,0,0,0,720,300,10,50,25,0
2020,352000222,14910,14250,2250,2250,12000,660,0,0,0,0,660,660,0,0,7900,7900,2500,5400,1195,120,15,180,120,502
2020,352000232,74945,12678,12678,12678,0,62267,60000,60000,0,0,2267,2267,0,0,7700,7700,7000,700,3884,300,36,360,408,856
2020,352000242,35370,7070,7070,7070,0,28300,25000,25000,0,0,3300,3300,0,0,0,0,0,0,2690,450,100,200,100,380
2020,352000252,6300,5000,1500,1500,3500,1300,0,0,0,0,1300,1300,0,0,0,0,0,0,1294,120,4,150,120,34
2020,352000272,58000,500,500,500,0,57500,50500,50500,0,0,7000,7000,0,0,15000,15000,15000,0,2715,360,50,205,40,139
2020,352000282,38210,200,200,200,0,38010,38000,38000,0,0,10,10,0,0,0,0,0,0,1612,240,200,40,72,133
2020,352000292,86900,25700,25700,5700,0,61200,47000,47000,0,0,14200,4200,10000,0,20000,20000,20000,0,5500,360,300,480,180,211
2020,352000302,32680,5680,1380,1380,4300,27000,23500,0,23500,0,3500,3500,0,0,6200,4200,4200,0,2760,420,60,240,240,393
2020,352000322,7260,1260,1260,1260,0,6000,6000,6000,0,0,0,0,0,0,0,0,0,0,770,88,20,10,48,5
2020,352000342,1655,1655,1655,1655,0,0,0,0,0,0,0,0,0,0,0,0,0,0,540,80,108,10,24,0
2020,352000362,9285,1335,1335,1335,0,7950,7000,7000,0,0,950,950,0,0,7855,7855,1860,1100,3200,216,450,310,168,116
2020,352000372,30473,4473,4473,4473,0,26000,26000,5000,21000,0,0,0,0,0,0,0,0,0,565,102,24,12,36,20
2020,352000382,45392,2292,2292,2292,0,43100,39000,4000,35000,0,4100,4100,0,0,0,0,0,0,1810,360,30,120,132,100
2020,352000392,30620,15120,15120,15120,0,15500,15000,5000,10000,0,500,500,0,0,0,0,0,0,1497,147,120,120,180,64
2020,352600211,27857,22357,5357,1357,17000,5500,4400,0,4400,0,1100,300,800,0,14600,14600,14600,0,3705,450,700,110,380,45
2020,352600221,150575,31085,31085,28585,0,119490,117000,52000,65000,0,2490,1900,590,0,39794,34794,34794,0,8400,1500,400,600,500,1583
2020,352600231,327100,72500,2500,2500,70000,254600,250000,0,250000,0,4600,4600,0,0,76580,11580,11400,0,7080,600,200,100,180,1577
2020,352600271,39768,9668,9668,9668,0,30100,30000,30000,0,0,100,100,0,0,0,0,0,0,1454,108,36,180,60,101
2020,352600291,4270,170,170,170,0,4100,4000,4000,0,0,100,0,100,0,0,0,0,0,550,72,60,24,25,5
2020,352600301,1555,1055,1055,1055,0,500,0,0,0,0,500,500,0,0,0,0,0,0,1653,300,23,300,130,163
2020,352600321,17280,80,80,80,0,17200,16700,4700,12000,0,500,500,0,0,0,0,0,0,1364,324,100,300,60,27
2020,352600331,47880,4080,4080,4080,0,43800,39000,9000,30000,0,4800,2700,2100,0,3800,3800,3000,800,1024,220,30,120,54,190
2020,352600341,15073,7898,7898,7898,0,7175,4500,4500,0,0,2675,2500,175,0,0,0,0,0,2068,192,190,180,180,146
2020,352600351,5688,888,888,888,0,4800,4800,4800,0,0,0,0,0,0,2326,2326,2000,0,736,104,24,48,60,8
2020,352600371,8950,450,450,450,0,8500,8500,8500,0,0,0,0,0,0,0,0,0,0,330,100,60,10,20,3
2020,352700231,106280,23580,23580,23580,0,82700,80000,80000,0,0,2700,2000,700,0,9500,9500,9500,0,3520,300,120,240,180,878
2020,352700241,28100,1600,1600,1600,0,26500,25000,25000,0,0,1500,1500,0,0,0,0,0,0,3232,72,50,400,240,103
2020,352700251,60520,620,620,620,0,59900,49000,27000,22000,0,10900,3900,2000,5000,25987,25987,21000,4987,4572,432,100,360,200,167
2020,352700261,33141,6041,6041,6041,0,27100,27000,27000,0,0,100,100,0,0,12906,12906,12906,0,2920,400,180,380,240,755
2020,352700281,21130,5380,5380,5380,0,15750,15000,15000,0,0,750,750,0,0,7100,7100,7000,100,5240,360,220,700,300,195
2020,352700301,4446,431,431,431,0,4015,4000,4000,0,0,15,0,15,0,0,0,0,0,840,78,200,12,22,4
2020,352700321,5500,300,300,300,0,5200,5200,5200,0,0,0,0,0,0,0,0,0,0,511,100,100,25,36,14
2020,352700341,9035,7875,875,875,7000,1160,0,0,0,0,1160,1160,0,0,6400,6400,6400,0,2700,120,100,500,240,46
2020,352700351,16480,2800,2800,2800,0,13680,13400,5000,8400,0,280,0,280,0,0,0,0,0,393,120,30,30,48,6
2020,352700361,7570,370,370,370,0,7200,7200,800,6400,0,0,0,0,0,0,0,0,0,970,136,276,24,54,5
2020,352700371,5478,978,978,978,0,4500,4500,0,4500,0,0,0,0,0,1000,1000,1000,0,531,98,24,36,48,3
2020,352800211,58500,15500,15500,15500,0,43000,37500,25000,12500,0,5500,5500,0,0,750,0,0,0,3403,156,5,360,72,482
2020,352800271,109380,12780,12780,10780,0,96600,90000,60000,30000,0,6600,600,5000,1000,18000,2000,0,2000,3020,300,50,180,180,441
2020,352800281,19006,1526,1526,1526,0,17480,16000,16000,0,0,1480,1400,80,0,8040,8040,7840,0,2278,360,100,260,138,19
2020,352800301,42645,13675,13675,13675,0,28970,23000,14500,8500,0,5970,800,5170,0,13560,6560,6560,0,3825,480,30,280,240,270
2020,352800311,130000,25050,5050,5050,20000,104950,45000,0,45000,0,59950,2250,57700,0,77000,65000,15000,50000,3790,420,50,360,300,87
2020,352800321,3012,812,812,812,0,2200,2200,2200,0,0,0,0,0,0,0,0,0,0,888,168,60,96,54,30
2020,352800331,153533,7465,7465,7465,0,146068,83000,31000,52000,0,63068,18800,39068,5200,67000,67000,54000,0,2964,240,24,360,240,210
2020,352800351,3400,550,550,550,0,2850,2850,800,2050,0,0,0,0,0,0,0,0,0,380,80,36,24,30,3
2020,352800371,1250,150,150,150,0,1100,1100,1100,0,0,0,0,0,0,0,0,0,0,481,126,60,12,24,6
2020,352900241,165983,13483,13483,13483,0,152500,151000,70000,81000,0,1500,1500,0,0,0,0,0,0,5926,286,250,350,180,1743
2020,352900251,68960,8890,8890,8890,0,60070,59500,35500,24000,0,570,570,0,0,23222,22722,22722,0,5890,420,260,290,240,1065
2020,352900261,3120,3120,120,120,3000,0,0,0,0,0,0,0,0,0,0,0,0,0,915,57,530,10,38,1
2020,352900271,6967,6300,5300,5300,1000,667,0,0,0,0,667,580,87,0,0,0,0,0,1788,520,30,60,48,18
2020,352900281,18280,7380,2380,2380,5000,10900,0,0,0,0,10900,900,0,10000,0,0,0,0,1364,300,20,120,84,9
2020,352900291,12900,10600,7100,7100,3500,2300,0,0,0,0,2300,1800,500,0,0,0,0,0,1868,504,120,144,96,77
2020,352900301,19246,2146,2146,2146,0,17100,14000,5000,9000,0,3100,2800,300,0,6750,6750,700,2050,1850,144,10,600,156,66
2020,352900311,30026,6026,6026,6026,0,24000,12000,12000,0,0,12000,9000,0,3000,0,0,0,0,2742,200,70,240,132,376
2020,352900321,27998,19600,19600,19600,0,8398,7998,6000,0,1998,400,400,0,0,0,0,0,0,2706,156,100,180,120,159
2020,352900331,37630,28730,28730,21980,0,8900,6800,6800,0,0,2100,2100,0,0,0,0,0,0,3016,240,10,600,216,78
2020,352900341,11326,1900,1900,1900,0,9426,6200,5000,1200,0,3226,3000,226,0,2300,2300,0,0,2960,96,2000,120,84,9
2020,352900351,12450,600,600,600,0,11850,11500,3500,8000,0,350,350,0,0,0,0,0,0,720,120,180,100,30,146
2020,352900361,25150,2900,2900,2900,0,22250,22000,10000,12000,0,250,0,250,0,0,0,0,0,645,180,200,70,30,20
2020,352900371,19900,7400,7400,7400,0,12500,12000,12000,0,0,500,500,0,0,0,0,0,0,1315,180,200,380,40,17
2020,353000202,42154,5154,5154,2154,0,37000,37000,37000,0,0,0,0,0,0,22700,22700,22700,0,2366,108,400,0,78,178
2020,353000212,663,263,263,263,0,400,0,0,0,0,400,400,0,0,0,0,0,0,1651,504,100,80,76,25
2020,353000222,10040,40,40,40,0,10000,10000,10000,0,0,0,0,0,0,7150,7150,5100,1200,2348,123,360,60,192,21
2020,353000232,17367,7767,4767,767,3000,9600,7500,0,7500,0,2100,500,1600,0,250,0,0,0,4014,144,360,600,120,72
2020,353600201,20200,100,100,100,0,20100,20100,20100,0,0,0,0,0,0,0,0,0,0,282,144,18,0,0,22
2020,353800201,99356,21856,21856,21856,0,77500,75000,30000,45000,0,2500,1000,1500,0,19500,19500,15500,4000,3590,660,500,600,180,1159
2020,353900201,145000,15000,15000,15000,0,130000,128000,60000,68000,0,2000,2000,0,0,34500,0,0,0,3460,300,180,300,200,2031
2020,360000202,8364,6964,964,964,6000,1400,0,0,0,0,1400,1400,0,0,1500,1500,0,1500,1945,335,50,276,204,39
2020,360000212,1130,650,650,650,0,480,0,0,0,0,480,480,0,0,0,0,0,0,1695,310,150,100,100,42
2020,360000232,47277,9400,9400,9400,0,37877,37400,37400,0,0,477,200,277,0,0,0,0,0,2064,240,120,240,84,74
2020,360000242,22920,3770,3770,3770,0,19150,19000,19000,0,0,150,150,0,0,3500,3500,3500,0,1424,190,50,120,72,48
2020,360000262,365,365,5,5,360,0,0,0,0,0,0,0,0,0,0,0,0,0,492,174,42,24,26,1
2020,360000272,112780,44280,44280,44280,0,68500,57000,57000,0,0,11500,11500,0,0,21000,21000,17000,4000,2770,430,100,500,360,1454
2020,360000282,111456,11456,11456,7956,0,100000,95000,75000,20000,0,5000,5000,0,0,8490,8490,8490,0,5900,600,500,360,600,178
2020,360000292,52000,1200,1200,1200,0,50800,50000,20000,30000,0,800,800,0,0,10300,10300,10000,300,2770,240,50,250,168,215
2020,360000302,17292,6092,3592,3592,2500,11200,9500,0,9500,0,1700,1700,0,0,3190,3090,3000,0,3424,216,100,180,288,132
2020,360000312,11500,500,500,500,0,11000,11000,11000,0,0,0,0,0,0,0,0,0,0,1056,204,30,36,60,15
2020,360000322,3440,400,400,400,0,3040,2500,2500,0,0,540,0,540,0,0,0,0,0,3192,192,120,60,360,23
2020,360000332,12790,560,560,560,0,12230,10630,10000,630,0,1600,1600,0,0,8000,8000,0,8000,2300,120,100,880,120,771
2020,360000342,29555,13555,13555,13555,0,16000,16000,15000,1000,0,0,0,0,0,0,0,0,0,1531,136,480,120,72,38
2020,360000362,12010,1010,1010,1010,0,11000,11000,11000,0,0,0,0,0,0,0,0,0,0,1210,168,520,60,72,12
2020,360000392,32173,1760,1760,1760,0,30413,25000,20000,5000,0,5413,5300,113,0,10000,10000,10000,0,6184,360,60,600,600,101
2020,360600221,57880,16080,16080,16080,0,41800,37000,37000,0,0,4800,4500,300,0,0,0,0,0,2890,360,400,180,100,1569
2020,360600231,2580,2490,990,990,1500,90,0,0,0,0,90,30,60,0,0,0,0,0,1384,720,50,120,84,14
2020,360600241,21912,2712,2712,2712,0,19200,18000,18000,0,0,1200,1000,200,0,0,0,0,0,1655,180,25,180,180,45
2020,360600261,110598,10398,10398,10398,0,100200,98000,78000,20000,0,2200,1700,500,0,3000,0,0,0,5800,200,200,500,300,3290
2020,360600271,79190,25470,25470,25470,0,53720,52000,30000,22000,0,1720,900,820,0,0,0,0,0,4170,360,350,600,360,615
2020,360600281,71566,2266,2266,2266,0,69300,61000,61000,0,0,8300,500,300,7500,6020,2520,2500,0,1994,250,300,400,84,77
2020,360600321,10628,9428,7428,7428,2000,1200,0,0,0,0,1200,1200,0,0,0,0,0,0,2188,650,20,360,120,29
2020,360600331,17660,17128,7128,7128,10000,532,132,0,132,0,400,100,300,0,2502,2502,1802,0,2306,324,72,600,120,22
2020,360600341,8482,8482,4682,4592,3800,0,0,0,0,0,0,0,0,0,1456,1456,456,1000,3176,396,300,200,330,52
2020,360600351,84060,22934,22934,22934,0,61126,50000,15000,35000,0,11126,400,10726,0,5450,5450,0,5450,1796,36,60,180,120,102
2020,360600361,7350,350,350,350,0,7000,7000,7000,0,0,0,0,0,0,0,0,0,0,718,60,50,18,60,3
2020,360600371,17018,1018,1018,1018,0,16000,16000,9000,7000,0,0,0,0,0,0,0,0,0,896,96,330,36,36,15
2020,360600381,6892,2692,1972,1972,720,4200,4000,0,4000,0,200,0,200,0,0,0,0,0,912,110,264,72,48,16
2020,360700221,6010,3510,3010,10,500,2500,0,0,0,0,2500,500,0,2000,500,500,0,0,1599,420,5,84,360,56
2020,360700251,4591,4561,1561,1561,3000,30,0,0,0,0,30,0,30,0,0,0,0,0,1196,216,60,50,50,17
2020,360700271,43962,7562,7562,7562,0,36400,34000,24000,10000,0,2400,2400,0,0,6000,0,0,0,4370,500,220,250,200,411
2020,360700281,89462,18862,18862,14862,0,70600,60000,25000,35000,0,10600,3100,3500,4000,17000,17000,12000,5000,6400,240,500,840,240,1836
2020,360700291,32201,7051,7051,7051,0,25150,22000,22000,0,0,3150,3000,150,0,700,700,0,0,1880,180,50,120,160,52
2020,360700301,14132,12232,8232,6092,4000,1900,0,0,0,0,1900,1600,300,0,2000,2000,0,0,3505,200,10,360,396,164
2020,360700341,9210,710,710,710,0,8500,8500,6500,2000,0,0,0,0,0,0,0,0,0,915,124,150,48,48,7
2020,360700361,11360,1060,1060,1060,0,10300,9500,9500,0,0,800,800,0,0,0,0,0,0,1560,120,150,240,120,56
2020,360700371,692,466,466,466,0,226,0,0,0,0,226,0,226,0,0,0,0,0,1072,108,554,30,15,1
2020,360700391,27508,3508,3508,3508,0,24000,24000,9000,15000,0,0,0,0,0,5500,5000,5000,0,651,150,24,26,42,28
2020,360800201,100,100,100,100,0,0,0,0,0,0,0,0,0,0,0,0,0,0,714,120,240,0,24,1
2020,360800211,8376,8376,3376,3376,5000,0,0,0,0,0,0,0,0,0,0,0,0,0,1288,650,30,72,66,17
2020,360800221,25080,190,190,190,0,24890,24000,24000,0,0,890,850,40,0,40,40,0,0,2060,260,70,270,280,144
2020,360800231,79569,12249,12249,10249,0,67320,61000,61000,0,0,6320,5000,1320,0,20120,20120,19800,0,4736,336,50,360,240,181
2020,360800241,46132,5332,5332,5332,0,40800,38000,38000,0,0,2800,2800,0,0,0,0,0,0,1262,120,60,84,108,72
2020,360800251,59890,22890,22890,22890,0,37000,36000,36000,0,0,1000,0,1000,0,3000,3000,0,3000,2550,360,30,120,360,505
2020,360800261,6266,6116,6116,6116,0,150,0,0,0,0,150,150,0,0,0,0,0,0,1790,150,10,70,80,30
2020,360800271,6400,3200,3000,2000,200,3200,0,0,0,0,3200,0,200,3000,400,400,0,400,1260,500,50,100,150,52
2020,360800281,5956,5056,5056,5056,0,900,0,0,0,0,900,900,0,0,0,0,0,0,2950,150,300,100,350,277
2020,360800301,3435,330,330,330,0,3105,3105,3105,0,0,0,0,0,0,956,956,956,0,1331,133,20,72,42,19
2020,360800311,75490,29640,29640,21640,0,45850,40000,10000,30000,0,5850,2850,0,3000,20000,20000,20000,0,1560,360,100,360,180,128
2020,360800321,15180,4000,4000,4000,0,11180,11000,11000,0,0,180,0,180,0,0,0,0,0,601,96,12,72,36,31
2020,360800341,35670,5520,5520,5520,0,30150,27000,27000,0,0,3150,150,3000,0,14930,14930,12500,0,3578,408,180,150,180,79
2020,360800351,7100,100,100,100,0,7000,7000,3000,4000,0,0,0,0,0,0,0,0,0,390,80,30,10,30,3
2020,360800361,131062,39412,39412,39412,0,91650,88000,30000,58000,0,3650,3650,0,0,0,0,0,0,3726,172,320,360,164,247
2020,360800371,4180,4180,3180,3180,1000,0,0,0,0,0,0,0,0,0,0,0,0,0,1436,312,120,72,72,1
2020,360800381,2765,665,165,165,500,2100,0,0,0,0,2100,2100,0,0,6000,6000,0,0,3340,560,40,300,360,86
2020,360800391,18845,265,265,265,0,18580,18500,13000,5500,0,80,80,0,0,480,480,0,0,1896,180,60,320,96,75
2020,360900211,36438,6218,6218,6218,0,30220,29800,12000,17800,0,420,200,220,0,8500,6000,6000,0,3880,1228,240,360,156,59
2020,360900221,7550,550,550,550,0,7000,7000,7000,0,0,0,0,0,0,1450,1450,1450,0,1204,120,40,30,84,19
2020,360900231,58280,10030,10030,10030,0,48250,46000,46000,0,0,2250,1800,450,0,3080,3080,3000,0,4926,396,100,240,260,1276
2020,360900251,36305,7850,7850,7850,0,28455,25000,21000,4000,0,3455,3400,55,0,0,0,0,0,2950,240,100,180,360,1593
2020,360900261,401,401,171,171,230,0,0,0,0,0,0,0,0,0,1060,1060,0,260,2076,280,200,120,132,1
2020,360900271,11778,11628,8628,8628,3000,150,0,0,0,0,150,0,150,0,0,0,0,0,2421,636,50,120,240,2
2020,360900281,34625,9025,9025,9025,0,25600,25000,25000,0,0,600,600,0,0,0,0,0,0,2727,250,600,200,130,72
2020,360900301,10784,3574,3074,3074,500,7210,0,0,0,0,7210,2000,5210,0,10400,10400,0,400,3754,480,50,600,240,31
2020,360900311,12400,0,0,0,0,12400,12000,12000,0,0,400,400,0,0,0,0,0,0,1288,240,180,100,288,26
2020,360900321,19550,6550,6550,6550,0,13000,12000,12000,0,0,1000,1000,0,0,0,0,0,0,1576,150,100,270,36,355
2020,360900341,144196,16796,16796,16796,0,127400,110000,60000,50000,0,17400,1400,16000,0,49000,49000,49000,0,5042,212,120,480,480,7069
2020,360900351,60629,28224,28224,28224,0,32405,29000,25000,4000,0,3405,3200,205,0,0,0,0,0,3192,188,96,358,392,337
2020,360900361,13502,2002,2002,2002,0,11500,9500,9500,0,0,2000,2000,0,0,2100,2100,800,0,1620,180,120,180,120,27
2020,360900371,147127,88227,88227,79227,0,58900,51000,31000,20000,0,7900,2900,3000,2000,0,0,0,0,3278,336,324,340,168,365
2020,360900381,32746,10806,10806,5306,0,21940,16000,14000,2000,0,5940,2900,2040,1000,11194,11194,7720,0,3026,660,300,600,216,349
2020,360900391,250,250,250,250,0,0,0,0,0,0,0,0,0,0,0,0,0,0,544,60,70,140,24,1
2020,361000202,32800,2300,2300,2300,0,30500,30000,30000,0,0,500,0,500,0,0,0,0,0,620,264,50,12,24,59
2020,361000212,30100,100,100,100,0,30000,30000,30000,0,0,0,0,0,0,0,0,0,0,831,300,240,60,1,33
2020,361000222,198855,68355,68355,23355,0,130500,130000,0,130000,0,500,500,0,0,79000,22000,15000,7000,3930,360,50,180,240,1753
2020,361000242,28985,1840,1840,1840,0,27145,26800,25000,1800,0,345,0,345,0,0,0,0,0,992,240,120,72,60,45
2020,361000252,4080,2930,1930,1430,1000,1150,0,0,0,0,1150,150,1000,0,0,0,0,0,1262,180,50,144,110,20
2020,361000262,13163,2723,2723,2723,0,10440,10000,10000,0,0,440,180,260,0,9000,9000,8400,600,963,184,60,240,120,72
2020,361000272,22810,430,430,430,0,22380,20700,20000,700,0,1680,1680,0,0,0,0,0,0,2427,240,36,660,144,2113
2020,361000282,72192,2192,2192,2192,0,70000,70000,25000,45000,0,0,0,0,0,0,0,0,0,780,120,60,120,60,75
2020,361000302,49400,7000,7000,7000,0,42400,36000,35000,1000,0,6400,6400,0,0,1895,1895,1895,0,2606,312,38,200,54,368
2020,361000312,6730,5380,380,380,5000,1350,600,0,600,0,750,700,50,0,1500,1500,0,0,1963,240,130,240,240,9
2020,361000322,2070,70,70,70,0,2000,2000,2000,0,0,0,0,0,0,0,0,0,0,690,50,2,36,24,2
2020,361000332,54901,17483,2483,2483,15000,37418,35750,0,35750,0,1668,1375,293,0,16000,0,0,0,3384,264,120,480,276,279
2020,361000342,29948,1583,1583,1583,0,28365,23100,23100,0,0,5265,4850,415,0,15150,15150,14200,800,2042,216,108,84,282,113
2020,361000352,44771,28321,13371,13071,14950,16450,8800,0,8800,0,7650,2400,5250,0,200,200,0,0,3710,204,120,240,264,79
2020,361000362,6154,954,954,954,0,5200,0,0,0,0,5200,200,5000,0,1000,1000,0,0,2158,156,700,191,48,19
2020,361000372,5125,1030,1030,1030,0,4095,4000,4000,0,0,95,0,95,0,0,0,0,0,662,94,350,10,26,4
2020,361000392,18406,7206,7206,7206,0,11200,11200,0,11200,0,0,0,0,0,0,0,0,0,832,276,240,20,60,10
2020,361600211,27652,18652,18652,18352,0,9000,9000,9000,0,0,0,0,0,0,1300,1300,1300,0,3450,684,336,120,240,67
2020,361600231,13500,4700,4700,4700,0,8800,8000,8000,0,0,800,300,500,0,0,0,0,0,1400,200,130,200,50,66
2020,361600241,1470,770,770,770,0,700,0,0,0,0,700,700,0,0,0,0,0,0,692,84,8,60,60,32
2020,361600261,24755,6365,6365,6365,0,18390,15000,15000,0,0,3390,3200,190,0,6000,1500,0,1500,2685,280,65,180,480,1522
2020,361600271,12565,2515,2515,2515,0,10050,10000,10000,0,0,50,50,0,0,0,0,0,0,1787,458,207,180,72,35
2020,361600291,31812,3312,3312,3312,0,28500,25000,25000,0,0,3500,3500,0,0,4200,4200,4200,0,2340,120,20,240,240,86
2020,361600301,62627,5817,5817,5817,0,56810,39000,39000,0,0,17810,1080,15230,1500,29331,29331,25451,0,2827,216,67,480,180,121
2020,361600311,36368,33646,23646,16846,10000,2722,0,0,0,0,2722,2650,72,0,10730,10730,10000,500,4226,276,21,320,204,473
2020,361600321,33286,6486,6486,6486,0,26800,25000,25000,0,0,1800,1800,0,0,3855,3855,3405,450,4626,256,500,250,490,295
2020,361600341,8480,4830,4830,4830,0,3650,0,0,0,0,3650,3650,0,0,2100,2100,0,2100,2840,220,500,460,180,117
2020,361600351,51454,15577,15577,15577,0,35877,35000,20000,15000,0,877,580,297,0,0,0,0,0,4698,270,300,480,300,860
2020,361600361,51665,15790,15790,15790,0,35875,29200,5000,24200,0,6675,475,6200,0,1600,1600,0,1600,3071,224,216,444,252,87
2020,361600371,140781,16131,16131,16131,0,124650,52000,5000,47000,0,72650,3100,69550,0,0,0,0,0,4651,1260,320,600,122,114
2020,361600391,101460,20840,20840,20840,0,80620,76000,31000,45000,0,4620,4620,0,0,5400,5400,2000,0,4880,320,80,700,460,666
2020,361700261,950,950,10,10,940,0,0,0,0,0,0,0,0,0,0,0,0,0,553,108,15,10,20,1
2020,361700271,10803,303,303,303,0,10500,10500,10500,0,0,0,0,0,0,0,0,0,0,602,156,96,60,0,24
2020,361700281,17130,1630,1630,1630,0,15500,12000,12000,0,0,3500,3500,0,0,7908,7908,5908,2000,2220,180,120,240,360,54
2020,361700291,57652,7582,7582,7582,0,50070,50000,8000,42000,0,70,70,0,0,0,0,0,0,1814,200,100,140,84,139
2020,361700301,6872,6722,2722,2722,4000,150,0,0,0,0,150,150,0,0,6207,6207,4050,1157,2248,252,524,266,210,27
2020,361700311,51626,15016,15016,5016,0,36610,36000,36000,0,0,610,400,210,0,600,600,0,0,5954,300,40,500,156,273
2020,361700321,39982,11002,11002,11002,0,28980,28000,18000,10000,0,980,880,100,0,0,0,0,0,4020,360,120,480,100,175
2020,361700331,7036,6136,2036,2036,4100,900,0,0,0,0,900,900,0,0,1385,1385,0,1350,2736,252,30,320,360,98
2020,361700351,25332,4830,4830,4330,0,20502,19000,13000,6000,0,1502,1502,0,0,5100,5100,5100,0,4095,324,363,604,366,63
2020,361700361,69650,8662,8662,7662,0,60988,58000,25000,33000,0,2988,700,1288,1000,1150,1150,0,1150,2488,202,70,420,108,98
2020,361700371,27800,20300,20300,20300,0,7500,7000,7000,0,0,500,500,0,0,0,0,0,0,1800,150,400,96,60,138
2020,361700391,10603,3803,2803,1203,1000,6800,0,0,0,0,6800,2800,4000,0,3480,3480,0,480,2965,712,193,540,259,58
2020,361800211,16297,15400,3400,3400,12000,897,0,0,0,0,897,842,55,0,1256,1256,0,500,1489,146,120,192,211,32
2020,361800231,16105,7035,7035,7035,0,9070,8500,8500,0,0,570,570,0,0,0,0,0,0,2552,216,70,72,288,61
2020,361800241,43716,3716,3716,3716,0,40000,40000,40000,0,0,0,0,0,0,0,0,0,0,2168,324,800,120,120,19
2020,361800251,36752,4752,4752,4752,0,32000,25000,25000,0,0,7000,1000,0,6000,10,10,0,0,2140,240,60,200,200,138
2020,361800261,17300,300,300,300,0,17000,17000,17000,0,0,0,0,0,0,0,0,0,0,810,150,120,60,30,17
2020,361800271,72220,41770,27770,27770,14000,30450,25000,0,25000,0,5450,4900,550,0,300,300,0,0,3210,250,100,550,200,1635
2020,361800301,164750,17640,17640,17640,0,147110,138000,38000,100000,0,9110,6850,2260,0,11500,6500,6500,0,14653,540,150,920,300,3217
2020,361800311,40315,12015,7415,7415,4600,28300,25000,0,22000,3000,3300,3300,0,0,4500,4500,3000,0,3546,240,60,720,360,91
2020,361800321,36195,9580,9580,9580,0,26615,24000,17000,7000,0,2615,2500,115,0,0,0,0,0,2106,150,23,188,146,81
2020,361800331,2474,1724,324,324,1400,750,0,0,0,0,750,750,0,0,0,0,0,0,624,168,72,84,15,36
2020,361800351,29181,3301,3301,3301,0,25880,20000,6000,14000,0,5880,2010,3870,0,0,0,0,0,1440,180,240,420,120,47
2020,361800361,8180,1940,1940,1940,0,6240,5700,3700,2000,0,540,450,90,0,0,0,0,0,2820,240,120,480,240,112
2020,361800381,25017,4017,4017,4017,0,21000,20100,10500,9600,0,900,900,0,0,13707,4107,3471,636,2560,240,100,360,180,43
2020,361800391,536,503,503,503,0,33,0,0,0,0,33,0,33,0,120,120,120,0,374,75,10,24,90,1
2020,361900201,2600,2400,1000,1000,1400,200,0,0,0,0,200,200,0,0,84,84,84,0,920,200,50,150,120,105
2020,361900211,3008,3008,508,508,2500,0,0,0,0,0,0,0,0,0,1700,1700,1700,0,1000,150,150,70,60,7
2020,361900221,110,110,10,10,100,0,0,0,0,0,0,0,0,0,0,0,0,0,528,183,126,0,12,1
2020,361900231,2141,1721,1221,1221,500,420,300,0,300,0,120,0,120,0,900,900,400,0,696,120,30,60,96,3
2020,361900241,88252,10252,10252,10252,0,78000,78000,39000,39000,0,0,0,0,0,3000,0,0,0,536,70,100,30,36,81
2020,361900261,5800,5800,800,800,5000,0,0,0,0,0,0,0,0,0,0,0,0,0,822,180,19,12,17,1
2020,361900281,40260,8560,8560,8560,0,31700,31000,26000,5000,0,700,700,0,0,700,100,0,0,5780,1300,60,240,300,519
2020,361900301,6810,60,60,60,0,6750,6500,6500,0,0,250,250,0,0,41,41,0,0,933,204,70,144,60,13
2020,361900351,4384,284,284,284,0,4100,2800,2800,0,0,1300,600,700,0,12640,12640,9500,0,1028,240,10,120,48,5
2020,361900361,2136,136,136,136,0,2000,0,0,0,0,2000,2000,0,0,940,940,0,940,1029,100,50,72,60,80
2020,361900371,6790,330,330,330,0,6460,660,660,0,0,5800,2000,0,3800,900,900,0,900,1296,106,60,15,118,2
2020,361900381,15668,8198,8198,8198,0,7470,7400,2000,5400,0,70,0,70,0,0,0,0,0,430,110,24,36,37,5
2020,361900391,23630,330,330,330,0,23300,21200,7000,14200,0,2100,0,2100,0,0,0,0,0,1047,150,50,120,67,6
2020,362000302,14659,2876,2876,2876,0,11783,11700,3600,8100,0,83,0,83,0,0,0,0,0,952,192,448,30,17,8
2020,362000322,51600,7200,7200,7200,0,44400,22500,17500,5000,0,21900,1900,20000,0,0,0,0,0,5060,400,180,700,470,107
2020,362000332,21090,3490,3490,3490,0,17600,17400,3800,13600,0,200,200,0,0,2700,2700,2700,0,988,190,40,100,48,21
2020,362000342,25256,5099,5099,5099,0,20157,7500,4500,3000,0,12657,4480,8177,0,4529,4529,0,0,3057,243,89,603,321,52
2020,362000362,7170,320,320,320,0,6850,6700,700,6000,0,150,0,150,0,0,0,0,0,379,60,84,0,5,6
2020,362000372,3160,660,660,660,0,2500,2500,1000,1500,0,0,0,0,0,0,0,0,0,728,86,60,312,0,3
2020,362600311,25272,7511,7511,7511,0,17761,7000,7000,0,0,10761,670,91,10000,6680,6680,6650,30,2833,157,225,720,296,367
2020,362600321,11561,3773,3773,3773,0,7788,7650,1350,6300,0,138,0,138,0,0,0,0,0,926,126,174,70,72,5
2020,362600341,5100,1000,1000,1000,0,4100,3900,1300,2600,0,200,200,0,0,0,0,0,0,820,110,120,100,70,13
2020,362600351,610,10,10,10,0,600,0,0,0,0,600,600,0,0,2500,2500,0,0,1061,230,20,400,36,21
2020,362700301,400456,90911,90911,90911,0,309545,308600,21000,287600,0,945,200,745,0,95000,0,0,0,2314,392,413,267,45,848
2020,362700311,16720,140,140,140,0,16580,16400,5000,11400,0,180,0,180,0,0,0,0,0,940,232,200,60,48,7
2020,362700321,14873,6573,6573,6573,0,8300,4500,2000,2500,0,3800,3800,0,0,3000,3000,2000,1000,1953,120,32,398,240,140
2020,362700341,10,10,10,10,0,0,0,0,0,0,0,0,0,0,0,0,0,0,742,70,400,0,24,0
2020,362700351,30502,2032,2032,1732,0,28470,20500,13000,7500,0,7970,1850,6120,0,6280,6280,280,0,4080,840,120,360,240,167
2020,362700361,4370,220,220,220,0,4150,4000,4000,0,0,150,0,150,0,0,0,0,0,708,96,60,120,60,10
2020,362700371,50132,5750,5750,5750,0,44382,30000,8000,22000,0,14382,4300,10082,0,5000,5000,2000,3000,2066,300,120,360,156,53
2020,362800331,6105,2445,2445,2445,0,3660,3580,700,2880,0,80,0,80,0,0,0,0,0,1205,90,700,10,30,5
2020,362800341,16083,15583,7583,7583,8000,500,0,0,0,0,500,500,0,0,0,0,0,0,3886,396,100,390,216,40
2020,362800351,7406,1138,1138,1138,0,6268,5900,3500,2400,0,368,200,168,0,3500,3500,2900,600,1310,144,84,120,192,31
2020,362800361,15500,4040,4040,4040,0,11460,8500,6000,2500,0,2960,2300,660,0,2080,2080,0,0,2230,76,145,230,90,22
2020,362900301,21930,1670,1670,1670,0,20260,19950,1200,18750,0,310,200,110,0,1000,1000,1000,0,631,117,36,178,48,7
2020,362900321,12400,1450,1450,1450,0,10950,10900,2000,8900,0,50,0,50,0,0,0,0,0,950,96,170,120,24,14
2020,362900331,19391,1545,1545,1545,0,17846,17300,17300,0,0,546,350,196,0,11572,11572,10572,1000,2059,217,72,130,114,50
2020,362900351,20,20,20,20,0,0,0,0,0,0,0,0,0,0,0,0,0,0,1143,108,60,576,5,0
2020,362900361,16870,2260,2260,2260,0,14610,13610,0,13610,0,1000,1000,0,0,1794,1794,1500,0,2952,230,450,930,20,57
2020,370000302,53700,4450,4450,4450,0,49250,47000,15000,32000,0,2250,2000,250,0,0,0,0,0,4070,300,100,360,150,157
2020,370000312,71,71,71,71,0,0,0,0,0,0,0,0,0,0,0,0,0,0,1272,240,50,50,132,72
2020,370000322,8170,170,170,170,0,8000,8000,8000,0,0,0,0,0,0,500,500,0,0,2380,1090,343,60,12,4
2020,370000332,21500,8300,8300,8300,0,13200,13000,8000,5000,0,200,200,0,0,0,0,0,0,858,204,80,180,60,62
2020,370000352,11686,7986,7486,5486,500,3700,0,0,0,0,3700,3700,0,0,2002,2002,0,0,2300,700,50,200,200,127
2020,370000372,1461,1261,261,261,1000,200,0,0,0,0,200,200,0,0,0,0,0,0,764,444,5,70,20,13
2020,370600331,110,110,110,110,0,0,0,0,0,0,0,0,0,0,4067,4067,0,1067,475,100,25,20,24,1
2020,370600341,210,210,10,10,200,0,0,0,0,0,0,0,0,0,0,0,0,0,1090,180,360,120,60,1
2020,370600361,2,2,2,2,0,0,0,0,0,0,0,0,0,0,0,0,0,0,340,140,0,10,15,0
2020,370600371,5510,200,200,200,0,5310,5000,5000,0,0,310,0,310,0,0,0,0,0,1400,132,840,60,48,6
2020,370700321,73,73,73,73,0,0,0,0,0,0,0,0,0,0,0,0,0,0,843,144,140,40,19,1
2020,370700331,70290,51210,51210,51210,0,19080,15000,10000,5000,0,4080,3600,480,0,6335,1335,0,1335,3650,336,120,360,84,1221
2020,370700351,22398,2748,2748,2748,0,19650,19000,19000,0,0,650,450,200,0,6600,6600,6600,0,3250,360,60,400,100,223
2020,370700361,61250,12650,12650,12650,0,48600,40000,40000,0,0,8600,8600,0,0,4000,4000,4000,0,9855,1285,850,800,550,967
2020,370700371,56715,9715,9715,9715,0,47000,23000,23000,0,0,24000,2500,6500,15000,14000,14000,14000,0,1495,205,70,380,120,95
2020,370700381,31440,12390,12390,12390,0,19050,18000,18000,0,0,1050,1050,0,0,0,0,0,0,4370,420,120,600,140,343
2020,370700391,54108,8231,8231,8231,0,45877,38400,21900,16500,0,7477,4200,3277,0,1000,0,0,0,3254,144,120,120,240,314
2020,370800301,5700,100,100,100,0,5600,5500,5500,0,0,100,100,0,0,0,0,0,0,2060,240,400,180,120,20
2020,370800311,22300,1800,1800,1800,0,20500,14000,0,12000,2000,6500,1500,0,5000,120,120,0,0,3416,216,100,240,250,55
2020,370800321,82710,16190,16190,16190,0,66520,64000,24000,40000,0,2520,2400,120,0,0,0,0,0,2895,380,15,600,220,227
2020,370800331,540,540,240,240,300,0,0,0,0,0,0,0,0,0,0,0,0,0,367,156,24,12,18,1
2020,370800341,71974,4774,4774,4774,0,67200,66000,26000,40000,0,1200,1200,0,0,40000,40000,9600,30000,3560,300,150,540,250,201
2020,370800351,30480,180,180,180,0,30300,20000,10000,10000,0,10300,3300,7000,0,1124,1124,724,400,1984,350,120,480,144,59
2020,370800361,10,10,10,10,0,0,0,0,0,0,0,0,0,0,0,0,0,0,576,120,20,5,16,1
2020,370800371,7991,891,891,411,0,7100,6600,5000,1600,0,500,0,500,0,8100,8100,5100,0,1505,400,200,60,30,6
2020,370800381,5840,1340,1340,1340,0,4500,4500,4500,0,0,0,0,0,0,0,0,0,0,283,100,10,5,36,6
2020,370900311,5220,535,535,535,0,4685,4500,4500,0,0,185,150,35,0,0,0,0,0,1970,200,400,300,70,90
2020,370900331,40,40,40,40,0,0,0,0,0,0,0,0,0,0,0,0,0,0,365,0,120,60,15,1
2020,370900361,46330,19030,15030,15030,4000,27300,27000,0,27000,0,300,300,0,0,0,0,0,0,865,96,0,120,96,150
2020,370900381,39686,15108,15108,15108,0,24578,23500,3500,20000,0,1078,50,1028,0,0,0,0,0,1388,64,120,90,132,30
2020,371000302,1714,760,660,660,100,954,0,0,0,0,954,954,0,0,3000,3000,0,0,1592,300,20,360,72,30
2020,371000332,6490,1890,1490,1490,400,4600,0,0,0,0,4600,4600,0,0,337,337,0,200,1860,480,0,180,240,30
2020,371000342,4532,1032,832,832,200,3500,0,0,0,0,3500,3500,0,0,5935,5935,0,2395,1702,388,50,70,72,39
2020,371000362,1050,50,50,50,0,1000,1000,1000,0,0,0,0,0,0,0,0,0,0,600,154,30,0,6,2
2020,371000382,12050,50,50,50,0,12000,12000,12000,0,0,0,0,0,0,0,0,0,0,785,400,20,5,20,11
2020,371000392,140030,15180,15180,15180,0,124850,123000,3000,120000,0,1850,1850,0,0,0,0,0,0,3790,600,250,720,180,338
2020,371600301,7500,1100,1100,1100,0,6400,6000,6000,0,0,400,400,0,0,3166,3166,2000,1166,3025,360,60,320,125,186
2020,371600321,418800,7450,7450,7450,0,411350,400000,10000,390000,0,11350,8000,3350,0,96000,84000,84000,0,4470,620,100,1100,250,1823
2020,371600391,24357,6207,6207,6207,0,18150,16000,10000,6000,0,2150,1000,1150,0,0,0,0,0,1880,180,10,240,100,19
2020,371700301,30,30,30,30,0,0,0,0,0,0,0,0,0,0,0,0,0,0,1550,180,700,50,40,1
2020,371700311,31522,7222,7222,7222,0,24300,21000,15000,6000,0,3300,3300,0,0,6500,6500,5000,1500,3390,180,100,360,180,242
2020,371700321,28630,8840,8840,8840,0,19790,19000,19000,0,0,790,790,0,0,17050,17050,12050,5000,2081,109,100,80,192,60
2020,371700331,34150,31850,22850,9650,9000,2300,0,0,0,0,2300,2300,0,0,2000,2000,2000,0,1165,120,10,240,240,148
2020,371700351,107043,16243,16243,16243,0,90800,17000,10000,7000,0,73800,5800,68000,0,17130,16130,15830,0,3690,420,120,200,240,185
2020,371700371,24330,5380,5380,5380,0,18950,17000,9000,8000,0,1950,1550,400,0,0,0,0,0,1828,168,60,110,90,99
2020,371700381,16580,1730,1730,1730,0,14850,14400,1000,13400,0,450,300,150,0,4600,4600,1300,3300,2600,100,350,150,60,16
2020,371700391,17495,2295,2295,2295,0,15200,13000,10000,3000,0,2200,2000,200,0,1010,1010,0,800,1333,72,15,204,72,77
2020,371800311,57900,5700,5700,5700,0,52200,50200,8200,42000,0,2000,0,2000,0,0,0,0,0,2310,170,650,50,60,50
2020,371800331,20600,100,100,100,0,20500,20500,8000,12500,0,0,0,0,0,3500,2000,2000,0,826,120,100,10,36,34
2020,371800341,19800,0,0,0,0,19800,18000,3000,15000,0,1800,200,1600,0,3770,3770,3000,700,1520,192,120,200,120,55
2020,371800351,92098,7998,7998,7998,0,84100,23000,13000,10000,0,61100,1100,60000,0,0,0,0,0,2370,190,50,50,180,58
2020,371800361,8884,6684,6684,6684,0,2200,0,0,0,0,2200,2200,0,0,0,0,0,0,2710,360,130,480,320,34
2020,371800371,6100,100,100,100,0,6000,6000,6000,0,0,0,0,0,0,0,0,0,0,364,100,60,30,24,12
2020,371800381,14505,13505,5,5,13500,1000,0,0,0,0,1000,1000,0,0,12400,12400,12400,0,2380,200,100,300,280,21
2020,371800391,1507,1507,7,7,1500,0,0,0,0,0,0,0,0,0,0,0,0,0,764,254,180,60,20,0
2020,371900301,113994,12864,12864,12864,0,101130,97000,40000,57000,0,4130,700,3430,0,23000,13000,13000,0,5844,620,225,485,360,554
2020,371900321,3028,2678,2578,2578,100,350,0,0,0,0,350,350,0,0,3000,3000,0,0,1400,400,20,240,40,59
2020,371900331,51980,20380,20380,18380,0,31600,9600,7000,2600,0,22000,2000,10000,10000,0,0,0,0,1706,120,120,36,100,488
2020,371900361,22300,140,140,140,0,22160,22000,9000,13000,0,160,100,60,0,0,0,0,0,1167,66,260,120,78,58
2020,371900371,57139,4039,4039,4039,0,53100,47000,9000,38000,0,6100,2600,3500,0,25700,11700,3800,7900,1626,300,120,110,96,62
2020,372000312,26750,4150,4150,4150,0,22600,20000,10000,10000,0,2600,2500,100,0,1300,800,0,800,2324,324,150,240,120,70
2020,372000322,37710,6710,6710,6710,0,31000,28000,28000,0,0,3000,3000,0,0,10000,10000,10000,0,2565,290,5,480,180,259
2020,372000332,19138,7900,7900,7900,0,11238,10030,0,10030,0,1208,511,697,0,2500,2500,2500,0,6212,288,12,240,192,67
2020,372000352,11920,300,300,300,0,11620,11620,6620,5000,0,0,0,0,0,3500,3500,3500,0,1020,120,120,80,60,23
2020,372000362,30000,700,700,700,0,29300,28590,3590,25000,0,710,500,210,0,0,0,0,0,892,140,80,110,84,12
2020,372000372,33140,32740,32240,2240,500,400,0,0,0,0,400,400,0,0,750,750,0,0,2440,840,100,300,100,114
2020,372000382,47300,11200,11200,11200,0,36100,27500,13500,14000,0,8600,600,8000,0,4000,4000,0,4000,2330,408,120,60,180,120
2020,372600311,14358,5988,5988,5988,0,8370,8000,5000,3000,0,370,350,20,0,0,0,0,0,2770,208,10,300,252,236
2020,372600321,7636,5136,4636,4136,500,2500,0,0,0,0,2500,300,700,1500,0,0,0,0,5840,640,300,600,390,32
2020,372600331,9724,4924,3924,3924,1000,4800,0,0,0,0,4800,4800,0,0,5550,5550,4350,200,3610,300,300,120,360,57
2020,372600341,53104,7754,7754,7754,0,45350,35000,35000,0,0,10350,1200,150,9000,2000,0,0,0,1860,180,60,120,120,70
2020,372600351,10500,8000,8000,8000,0,2500,2500,2500,0,0,0,0,0,0,0,0,0,0,740,150,200,80,20,3
2020,372600361,3165,165,165,165,0,3000,3000,3000,0,0,0,0,0,0,0,0,0,0,1002,228,180,36,48,9
2020,372700331,462100,2000,2000,2000,0,460100,460000,5000,455000,0,100,50,50,0,2500,0,0,0,1730,120,300,100,60,1026
2020,372700341,24600,250,250,250,0,24350,24000,4000,20000,0,350,50,300,0,24000,24000,24000,0,2026,120,96,60,180,24
2020,372700351,80,80,80,80,0,0,0,0,0,0,0,0,0,0,0,0,0,0,666,40,280,120,72,1
2020,372700361,41196,3846,3846,3846,0,37350,37000,9000,28000,0,350,350,0,0,1350,1350,1350,0,3680,400,40,360,210,977
2020,372700371,39698,21098,21098,21098,0,18600,15000,15000,0,0,3600,2000,1100,500,1800,1800,800,1000,1491,156,20,120,65,32
2020,372800301,6850,3750,3550,3550,200,3100,0,0,0,0,3100,100,1000,2000,3200,3200,0,3200,2730,480,100,180,360,116
2020,372800311,13683,70,70,70,0,13613,10500,10500,0,0,3113,3000,113,0,1700,1700,0,1700,2017,300,520,180,130,72
2020,372800341,200,130,130,130,0,70,0,0,0,0,70,70,0,0,0,0,0,0,811,30,180,120,21,4
2020,372800351,22042,10942,10942,2942,0,11100,9800,6000,0,3800,1300,1100,200,0,100,100,0,0,3290,510,300,170,210,205
2020,372800361,4460,460,460,460,0,4000,4000,4000,0,0,0,0,0,0,300,300,0,300,487,65,30,5,12,7
2020,372900301,29246,11246,11246,11246,0,18000,18000,18000,0,0,0,0,0,0,0,0,0,0,1036,252,36,40,108,36
2020,372900311,44240,3940,3940,3940,0,40300,37000,37000,0,0,3300,2800,500,0,4420,4420,4000,0,2798,288,50,400,240,504
2020,372900341,21776,2508,2508,2508,0,19268,18200,10000,8200,0,1068,1000,68,0,0,0,0,0,934,300,100,200,24,42
2020,372900361,1248,198,198,198,0,1050,1000,0,1000,0,50,50,0,0,0,0,0,0,834,120,100,120,40,6
2020,380000312,17670,9170,9170,9170,0,8500,8500,8500,0,0,0,0,0,0,0,0,0,0,1258,160,36,15,42,11
2020,380000322,103190,580,580,580,0,102610,101000,101000,0,0,1610,810,800,0,1000,1000,0,1000,2633,84,500,420,69,247
2020,380000332,1639,1589,589,589,1000,50,0,0,0,0,50,0,50,0,0,0,0,0,1460,360,50,160,50,31
2020,380000342,33278,1230,1230,1230,0,32048,32000,17000,15000,0,48,0,48,0,5000,5000,5000,0,1254,131,90,102,42,28
2020,380000352,22329,4935,4935,4935,0,17394,17000,17000,0,0,394,340,54,0,8790,8790,8300,490,3507,192,800,180,451,43
2020,380000362,16500,2500,2500,2500,0,14000,14000,14000,0,0,0,0,0,0,8000,8000,8000,0,1342,180,200,110,108,62
2020,380000372,8050,50,50,50,0,8000,8000,8000,0,0,0,0,0,0,0,0,0,0,740,120,120,120,60,11
2020,380000382,48908,4908,4908,4908,0,44000,39000,19000,20000,0,5000,2700,2300,0,0,0,0,0,3152,250,240,360,174,315
2020,380000392,81760,110,110,110,0,81650,80000,22000,47000,11000,1650,1650,0,0,24500,19700,16500,0,2800,300,250,240,240,110
2020,380600321,13930,1330,1330,1330,0,12600,12000,12000,0,0,600,600,0,0,0,0,0,0,1354,144,24,100,72,138
2020,380600331,32067,9147,9147,9147,0,22920,12000,12000,0,0,10920,1800,120,9000,0,0,0,0,1169,168,15,12,100,86
2020,380600351,58025,6305,6305,6305,0,51720,45000,45000,0,0,6720,3500,220,3000,26500,26500,25000,1500,1778,600,12,120,120,82
2020,380600361,3762,3762,2762,2762,1000,0,0,0,0,0,0,0,0,0,1400,1400,0,900,3116,380,550,70,204,21
2020,380600381,3050,50,50,50,0,3000,3000,3000,0,0,0,0,0,0,0,0,0,0,1035,100,360,10,5,5
2020,380700311,5048,4818,4818,1818,0,230,0,0,0,0,230,230,0,0,200,200,0,0,2131,324,18,360,84,39
2020,380700321,10740,4090,4090,4090,0,6650,6500,6500,0,0,150,150,0,0,0,0,0,0,828,144,10,186,42,35
2020,380700331,8125,1125,1125,1125,0,7000,7000,7000,0,0,0,0,0,0,0,0,0,0,828,98,96,48,22,11
2020,380700341,4380,2680,480,480,2200,1700,0,0,0,0,1700,1700,0,0,2656,2656,0,0,2306,408,50,166,132,102
2020,380700351,34357,6257,6257,6257,0,28100,27000,27000,0,0,1100,1100,0,0,14000,14000,14000,0,3090,300,200,240,300,534
2020,380700361,42590,9740,9740,8740,0,32850,31700,14000,17700,0,1150,900,250,0,50,50,0,0,2332,126,150,240,120,66
2020,380800301,6792,6392,5892,5892,500,400,0,0,0,0,400,400,0,0,0,0,0,0,1829,420,10,202,120,41
2020,380800311,4418,4305,1305,1305,3000,113,0,0,0,0,113,0,113,0,0,0,0,0,1574,414,20,72,199,2
2020,380800321,26770,370,370,370,0,26400,26400,4000,22400,0,0,0,0,0,0,0,0,0,874,129,45,60,30,10
2020,380800331,17925,5905,5905,5905,0,12020,12000,12000,0,0,20,0,20,0,0,0,0,0,1043,700,15,6,24,49
2020,380800351,31208,4761,4761,4761,0,26447,26000,26000,0,0,447,350,97,0,4974,4974,4974,0,5354,300,300,300,240,381
2020,380800361,53096,17566,17566,17566,0,35530,31500,19000,0,12500,4030,2950,1080,0,1070,1070,0,1000,5186,300,200,300,230,234
2020,380800381,2050,2050,50,50,2000,0,0,0,0,0,0,0,0,0,0,0,0,0,428,24,90,72,52,1
2020,380900301,17631,16131,1131,1131,15000,1500,0,0,0,0,1500,1500,0,0,50,50,0,0,2752,180,12,240,180,386
2020,380900311,24963,24263,11263,11263,13000,700,0,0,0,0,700,700,0,0,0,0,0,0,1082,180,5,180,120,26
2020,380900331,10069,10069,4069,4069,6000,0,0,0,0,0,0,0,0,0,4,4,0,0,1152,144,95,120,21,1
2020,380900341,14347,7797,7797,7797,0,6550,4800,4800,0,0,1750,1750,0,0,3917,3917,0,3917,9216,444,3500,985,222,189
2020,380900351,25620,6620,6620,4920,0,19000,18500,9500,9000,0,500,0,500,0,5020,5020,5000,0,1940,144,200,130,156,28
2020,380900361,28576,4976,4976,4976,0,23600,12000,9000,3000,0,11600,3600,0,8000,5610,5610,5610,0,3740,240,50,150,240,25
2020,380900371,36794,9094,9094,9094,0,27700,26300,26300,0,0,1400,1400,0,0,0,0,0,0,5436,286,50,500,240,1357
2020,380900381,18155,7575,7575,6575,0,10580,9000,9000,0,0,1580,1300,280,0,60,60,0,0,3130,320,20,720,204,87
2020,380900391,22082,6982,6982,3982,0,15100,13000,13000,0,0,2100,800,300,1000,3541,3541,3502,0,2506,180,50,420,312,87
2020,381000322,38030,2130,2130,2130,0,35900,35000,35000,0,0,900,900,0,0,20,20,0,0,2298,300,240,240,60,85
2020,381000362,6250,5630,130,130,5500,620,0,0,0,0,620,620,0,0,8185,8185,5500,0,3514,174,80,300,324,104
2020,381000372,7400,400,400,400,0,7000,7000,7000,0,0,0,0,0,0,0,0,0,0,1282,192,300,100,60,17
2020,381000392,28285,11995,11995,9995,0,16290,12000,12000,0,0,4290,2490,1800,0,4000,4000,4000,0,2533,88,10,450,240,77
2020,381600301,17915,2915,2915,2915,0,15000,15000,15000,0,0,0,0,0,0,7909,7909,6769,1140,1410,260,80,150,120,14
2020,381600311,12489,989,989,989,0,11500,11500,7000,4500,0,0,0,0,0,13000,13000,13000,0,1944,280,100,64,270,12
2020,381600321,22628,4328,4328,4328,0,18300,18000,18000,0,0,300,300,0,0,10175,10175,10072,0,3130,360,80,160,360,60
2020,381600331,64390,7790,7790,7790,0,56600,56000,29000,27000,0,600,600,0,0,3000,0,0,0,2590,240,100,150,180,108
2020,381600341,1870,1870,20,20,1850,0,0,0,0,0,0,0,0,0,0,0,0,0,574,130,0,48,36,1
2020,381600351,25921,921,921,921,0,25000,25000,25000,0,0,0,0,0,0,0,0,0,0,254,58,18,17,36,39
2020,381600371,68893,8433,8433,3433,0,60460,56000,56000,0,0,4460,1960,0,2500,29400,29400,27500,1800,3760,520,700,250,240,98
2020,381700321,20100,100,100,100,0,20000,20000,20000,0,0,0,0,0,0,2100,500,500,0,651,50,30,15,20,36
2020,381700331,17852,7896,7896,7896,0,9956,9500,9500,0,0,456,230,226,0,30,30,0,0,2972,390,150,450,84,133
2020,381700341,31401,5103,5103,5103,0,26298,12000,12000,0,0,14298,1230,6068,7000,3500,3500,3500,0,2297,234,120,180,216,122
2020,381700361,115444,27794,9794,9794,18000,87650,85000,0,80000,5000,2650,2650,0,0,16800,15300,15000,300,6087,300,400,560,307,372
2020,381700391,4395,3895,95,95,3800,500,0,0,0,0,500,500,0,0,800,800,800,0,1428,180,250,150,72,13
2020,381800321,4952,3952,1952,1802,2000,1000,0,0,0,0,1000,1000,0,0,2140,2140,2000,0,1146,266,50,200,120,48
2020,381800331,29326,2280,2280,2280,0,27046,27000,12000,15000,0,46,0,46,0,53,53,0,0,941,114,230,20,15,18
2020,381800341,910,810,510,510,300,100,0,0,0,0,100,100,0,0,50,50,0,0,3290,480,100,250,60,36
2020,381800351,17108,2708,2708,2708,0,14400,14000,8000,6000,0,400,400,0,0,2863,2863,2443,0,1270,180,100,180,60,24
2020,381800361,42345,7524,7524,7524,0,34821,33500,23500,10000,0,1321,1030,291,0,2650,2650,2650,0,5097,324,300,485,288,108
2020,381900301,90938,10040,10040,5040,0,80898,68000,18000,50000,0,12898,1600,298,11000,30000,30000,30000,0,3255,228,60,276,267,70
2020,381900311,29494,7210,7210,6710,0,22284,18000,18000,0,0,4284,3500,784,0,4624,4624,2744,0,6501,216,800,780,265,198
2020,381900321,7716,1716,1716,1716,0,6000,6000,6000,0,0,0,0,0,0,0,0,0,0,452,20,220,10,72,8
2020,381900331,993666,735049,735049,702049,0,258617,233000,58000,175000,0,25617,7117,18500,0,250000,250000,250000,0,5593,459,198,448,189,252
2020,381900341,16930,2730,2730,2730,0,14200,13000,13000,0,0,1200,1000,200,0,7097,7097,7097,0,1362,168,10,240,36,39
2020,381900351,54516,10616,10616,10616,0,43900,42000,24000,18000,0,1900,1600,300,0,2000,0,0,0,5022,360,100,452,300,388
2020,381900371,5500,4500,1500,1500,3000,1000,0,0,0,0,1000,1000,0,0,0,0,0,0,1040,50,30,200,30,285
2020,381900391,44152,9180,9180,9180,0,34972,33500,33000,500,0,1472,1370,102,0,18750,8750,8000,750,4852,670,500,600,400,300
2020,382000342,104099,38000,38000,38000,0,66099,65400,38000,27400,0,699,699,0,0,17700,3700,0,3700,3643,384,183,420,166,922
2020,382000352,29660,3360,3360,3360,0,26300,25000,15000,10000,0,1300,1300,0,0,14000,5000,5000,0,1562,315,325,120,60,84
2020,382000362,11032,32,32,32,0,11000,11000,11000,0,0,0,0,0,0,65,65,0,0,2073,355,240,60,132,16
2020,382600311,46245,8945,8945,8945,0,37300,37000,21000,16000,0,300,300,0,0,3000,3000,0,3000,4340,300,400,530,360,1182
2020,382600361,23542,8342,8342,8342,0,15200,14000,14000,0,0,1200,1200,0,0,7400,7400,6400,0,5930,240,10,800,360,134
2020,382600371,100,100,100,100,0,0,0,0,0,0,0,0,0,0,0,0,0,0,570,102,96,24,18,1
2020,382600391,24958,4058,4058,4058,0,20900,17600,8600,9000,0,3300,3300,0,0,7000,7000,6000,1000,3190,300,30,800,216,101
2020,382700311,137400,2400,2400,2400,0,135000,130000,60000,70000,0,5000,5000,0,0,95000,90000,90000,0,4096,456,240,240,200,2209
2020,382700321,39394,37236,6236,6236,31000,2158,0,0,0,0,2158,2045,113,0,2000,2000,0,2000,3838,240,120,410,300,1101
2020,382700341,35482,4246,4246,4246,0,31236,30000,30000,0,0,1236,1236,0,0,3550,1050,0,1000,7476,586,200,800,480,415
2020,382700351,18840,2400,2400,1400,0,16440,11000,11000,0,0,5440,380,5060,0,7600,7600,7000,0,1330,140,10,120,180,29
2020,382700361,20620,11320,11320,11320,0,9300,8000,8000,0,0,1300,1300,0,0,0,0,0,0,3043,264,1070,250,78,203
2020,382700381,16414,2976,2976,2976,0,13438,13100,0,10100,3000,338,150,188,0,2000,2000,2000,0,1555,108,72,82,140,40
2020,382700391,14970,224,224,224,0,14746,14746,2500,12246,0,0,0,0,0,10000,10000,10000,0,1082,202,322,50,66,9
2020,382800301,20686,16786,6786,6786,10000,3900,0,0,0,0,3900,3900,0,0,4200,4200,0,0,2580,200,20,80,240,52
2020,382800311,5570,5570,70,70,5500,0,0,0,0,0,0,0,0,0,700,700,0,0,1450,370,20,50,180,1
2020,382800321,30950,5800,5800,5800,0,25150,25000,25000,0,0,150,150,0,0,3000,0,0,0,1920,400,180,60,100,53
2020,382800331,91222,4957,4957,1957,0,86265,80200,27200,53000,0,6065,5387,678,0,20198,19198,18518,0,9427,752,30,1900,390,240
2020,382800341,43461,19698,19698,19698,0,23763,23000,23000,0,0,763,763,0,0,20,20,0,0,2842,98,120,720,209,127
2020,382800351,16200,6770,6770,6770,0,9430,5000,5000,0,0,4430,0,4430,0,0,0,0,0,1378,144,200,30,66,8
2020,382800371,23170,5880,5880,5880,0,17290,13500,7000,6500,0,3790,3790,0,0,2700,2700,0,2700,3273,306,48,360,72,52
2020,382800381,8322,2322,2322,2322,0,6000,5500,5500,0,0,500,500,0,0,0,0,0,0,2606,240,240,240,108,55
2020,382800391,36600,3250,3250,3250,0,33350,20200,2000,18200,0,13150,150,13000,0,16000,16000,9000,7000,2720,200,150,280,120,28
2020,382900311,40546,9376,9376,9376,0,31170,31000,31000,0,0,170,170,0,0,0,0,0,0,3490,250,250,200,150,388
2020,382900321,74424,3698,3698,3698,0,70726,70500,30000,40500,0,226,0,226,0,0,0,0,0,1484,234,200,50,72,155
2020,382900341,9416,1416,1416,1416,0,8000,6000,6000,0,0,2000,2000,0,0,1400,1400,0,0,2060,180,0,120,180,37
2020,382900351,26520,8190,8190,7190,0,18330,10800,5800,5000,0,7530,1430,5800,300,5600,5600,600,5000,2310,170,200,250,230,450
2020,382900371,17960,1430,1430,1430,0,16530,16500,5000,11500,0,30,0,30,0,0,0,0,0,960,180,120,60,50,10
2020,382900381,10,10,10,10,0,0,0,0,0,0,0,0,0,0,0,0,0,0,687,324,6,12,15,0
2020,382900391,43550,1850,1850,1850,0,41700,41500,6500,35000,0,200,150,50,0,0,0,0,0,1605,88,195,360,60,24
2020,383000302,2996,1496,496,496,1000,1500,0,0,0,0,1500,1500,0,0,1370,1370,900,0,4472,464,500,572,288,536
2020,383000312,6735,955,955,955,0,5780,5780,4800,980,0,0,0,0,0,0,0,0,0,560,130,100,30,40,6
2020,383600311,35718,7468,7468,7468,0,28250,25800,15000,10800,0,2450,2400,50,0,0,0,0,0,4185,790,45,420,220,751
2020,383700301,143,143,143,143,0,0,0,0,0,0,0,0,0,0,0,0,0,0,627,104,60,29,24,1
2020,390000202,6828,4228,2228,2228,2000,2600,0,0,0,0,2600,1600,1000,0,2286,2286,0,2286,3195,948,30,120,252,46
2020,390000222,5834,2034,1284,534,750,3800,0,0,0,0,3800,1300,2500,0,5000,5000,0,4500,3500,1320,30,300,300,17
2020,390000232,17600,1000,1000,1000,0,16600,16500,12000,4500,0,100,0,100,0,0,0,0,0,1619,390,216,72,114,28
2020,390000252,272964,29264,29264,9264,0,243700,226000,15000,211000,0,17700,5700,12000,0,30200,30200,25000,0,4260,600,60,720,360,708
2020,390000262,2584,2584,2084,2084,500,0,0,0,0,0,0,0,0,0,300,300,0,300,2498,108,100,50,120,1
2020,390000272,21860,17160,8360,8360,8800,4700,0,0,0,0,4700,4700,0,0,200,200,200,0,1261,216,5,315,156,95
2020,390000292,160081,12390,5790,5790,6600,147691,142000,0,136000,6000,5691,900,791,4000,102400,57400,51000,4400,2620,744,50,720,174,556
2020,390000302,21570,1470,1470,1470,0,20100,20000,20000,0,0,100,100,0,0,2570,2570,2500,0,2780,1400,20,250,100,86
2020,390000322,11120,520,520,320,0,10600,10000,10000,0,0,600,600,0,0,2250,2250,2000,0,1742,56,10,480,420,17
2020,390000342,230,180,80,80,100,50,0,0,0,0,50,50,0,0,0,0,0,0,1013,248,10,180,15,1
2020,390000352,16700,13700,1700,400,12000,3000,0,0,0,0,3000,0,1000,2000,12900,12900,12600,0,2580,360,120,240,360,42
2020,390000362,71676,2776,2776,2776,0,68900,67400,32400,35000,0,1500,1500,0,0,8500,8500,8500,0,6104,204,60,720,480,113
2020,390000382,5200,5200,5100,100,100,0,0,0,0,0,0,0,0,0,0,0,0,0,1590,36,120,48,120,4
2020,390000392,4455,3555,3355,3355,200,900,0,0,0,0,900,900,0,0,900,900,0,900,2840,780,30,120,600,12
2020,390600231,41538,5648,5648,5648,0,35890,34500,20000,14500,0,1390,1000,390,0,0,0,0,0,1385,234,110,192,163,274
2020,390600311,3048,1248,318,318,930,1800,0,0,0,0,1800,1800,0,0,0,0,0,0,1006,84,10,60,132,1
2020,390600321,5260,4570,70,70,4500,690,0,0,0,0,690,590,100,0,0,0,0,0,2302,432,30,390,120,30
2020,390600331,46210,210,210,210,0,46000,35000,25000,10000,0,11000,1000,0,10000,0,0,0,0,1290,240,180,120,50,32
2020,390600361,30100,12100,12100,12100,0,18000,18000,18000,0,0,0,0,0,0,0,0,0,0,1664,154,200,0,60,28
2020,390600381,61500,11500,11500,11500,0,50000,46000,33000,13000,0,4000,4000,0,0,0,0,0,0,2670,180,50,240,150,1094
2020,390600391,7412,112,12,12,100,7300,7000,0,7000,0,300,300,0,0,4300,4300,4000,200,1422,662,18,180,120,30
2020,390700221,37879,3779,3779,2819,0,34100,34100,0,34100,0,0,0,0,0,22871,22871,12973,9898,2120,400,300,200,100,268
2020,390700231,14009,12409,4409,4409,8000,1600,0,0,0,0,1600,1600,0,0,3840,3840,2700,400,2950,500,200,300,150,53
2020,390700341,56154,10174,10174,10174,0,45980,27920,0,27920,0,18060,2060,16000,0,10800,10800,7000,3800,4096,560,10,360,420,144
2020,390700361,77083,6983,6983,6983,0,70100,70000,35000,35000,0,100,100,0,0,0,0,0,0,3346,256,400,240,120,127
2020,390700371,25880,5330,5330,5330,0,20550,18000,18000,0,0,2550,2550,0,0,1495,1495,1200,0,3950,180,50,200,300,57
2020,390700381,84640,13440,13440,13440,0,71200,70000,40000,30000,0,1200,1200,0,0,17450,17450,10000,7450,3726,466,240,480,180,3155
2020,390700391,63117,4017,4017,4017,0,59100,55000,50000,5000,0,4100,4100,0,0,14000,14000,9000,5000,3950,480,600,480,300,87
2020,390800201,15947,7747,7747,7747,0,8200,7000,7000,0,0,1200,200,1000,0,0,0,0,0,1930,360,10,400,120,30
2020,390800211,780,680,380,80,300,100,0,0,0,0,100,0,100,0,600,600,0,600,1665,300,25,240,250,1
2020,390800231,100088,14088,14088,14088,0,86000,85500,70000,15500,0,500,500,0,0,0,0,0,0,5172,300,400,480,252,278
2020,390800241,161125,3025,3025,2025,0,158100,153000,13000,140000,0,5100,100,5000,0,300,300,0,300,1012,276,24,60,72,131
2020,390800251,89141,5641,5641,5641,0,83500,83000,13000,70000,0,500,500,0,0,24420,23620,21950,1670,1330,280,100,110,60,194
2020,390800261,22258,5158,5158,3158,0,17100,15000,10000,5000,0,2100,600,1300,200,0,0,0,0,1725,420,50,192,110,119
2020,390800311,182360,32260,32260,32260,0,150100,147000,60000,87000,0,3100,3100,0,0,1500,0,0,0,2350,112,50,240,72,332
2020,390800321,40200,200,200,200,0,40000,40000,0,40000,0,0,0,0,0,0,0,0,0,424,76,36,12,18,6
2020,390800361,7510,380,380,380,0,7130,7000,7000,0,0,130,100,30,0,0,0,0,0,700,150,20,60,40,6
2020,390800371,12430,1200,700,700,500,11230,10000,0,10000,0,1230,1000,230,0,5198,5198,4900,0,3070,900,30,500,180,37
2020,390800391,320,320,320,320,0,0,0,0,0,0,0,0,0,0,50,50,0,0,1400,70,60,120,180,12
2020,390900201,79720,15820,15820,15820,0,63900,47900,16500,31400,0,16000,1000,0,15000,0,0,0,0,2790,162,24,720,180,457
2020,390900211,39536,15836,15836,8836,0,23700,17000,17000,0,0,6700,1700,0,5000,8625,8625,8625,0,2870,520,150,550,200,35
2020,390900221,5916,916,916,916,0,5000,5000,4000,1000,0,0,0,0,0,0,0,0,0,684,180,60,24,12,23
2020,390900241,134700,9300,9300,9300,0,125400,120000,120000,0,0,5400,400,5000,0,0,0,0,0,1183,230,20,156,48,58
2020,390900251,64116,15566,15566,15566,0,48550,47000,7000,40000,0,1550,1550,0,0,200,200,0,200,1910,250,160,400,150,70
2020,390900271,28480,28180,10180,10180,18000,300,0,0,0,0,300,300,0,0,0,0,0,0,2088,218,500,150,60,699
2020,390900301,59945,5645,5645,5645,0,54300,53500,13500,40000,0,800,800,0,0,0,0,0,0,2156,200,200,360,60,67
2020,390900331,77650,7600,7600,7600,0,70050,70000,70000,0,0,50,50,0,0,620,320,0,0,1596,114,350,20,84,120
2020,390900341,32750,4650,4650,4650,0,28100,28000,18000,10000,0,100,100,0,0,1500,1500,1500,0,2440,580,510,120,240,71
2020,390900351,450,200,200,200,0,250,0,0,0,0,250,250,0,0,0,0,0,0,1796,436,30,200,120,6
2020,390900361,9140,1640,1640,1640,0,7500,7500,7500,0,0,0,0,0,0,0,0,0,0,2215,500,15,70,300,91
2020,390900371,3000,2700,1100,1100,1600,300,0,0,0,0,300,300,0,0,300,300,0,0,2410,432,24,120,204,12
2020,390900381,62413,11363,11363,11363,0,51050,50000,50000,0,0,1050,850,200,0,6800,6800,6300,500,4556,345,300,480,220,480
2020,391000202,73880,6380,6380,4380,0,67500,54000,54000,0,0,13500,1500,12000,0,29866,29866,26776,0,5668,780,250,250,180,77
2020,391000212,67640,28320,5320,5320,23000,39320,37520,0,0,37520,1800,1800,0,0,37420,37420,0,37420,2910,300,150,120,140,15
2020,391000222,20020,20020,20,20,20000,0,0,0,0,0,0,0,0,0,0,0,0,0,1340,300,10,15,31,1
2020,391000232,288940,4140,4140,4140,0,284800,270000,70000,200000,0,14800,4800,10000,0,15000,15000,15000,0,2900,504,200,600,96,1167
2020,391000302,11698,1098,1098,1098,0,10600,10000,0,10000,0,600,600,0,0,1200,1200,1200,0,3710,420,110,360,240,44
2020,391000312,109667,5367,5367,5367,0,104300,99500,4500,95000,0,4800,1800,3000,0,33300,33300,28800,4200,4390,110,10,500,360,29
2020,391000322,250,250,10,10,240,0,0,0,0,0,0,0,0,0,0,0,0,0,673,69,0,15,18,1
2020,391000332,41920,41920,2020,2020,39900,0,0,0,0,0,0,0,0,0,20000,20000,20000,0,1592,120,12,180,120,3
2020,391000342,44710,43410,3510,3510,39900,1300,0,0,0,0,1300,1300,0,0,15000,15000,0,15000,1596,300,36,250,120,233
2020,391600311,34820,2800,2800,2800,0,32020,32000,17000,15000,0,20,0,20,0,0,0,0,0,888,60,36,0,42,18
2020,391600331,37564,11884,11884,11884,0,25680,20000,20000,0,0,5680,680,1000,4000,0,0,0,0,3848,500,18,180,280,341
2020,391600341,900,900,100,100,800,0,0,0,0,0,0,0,0,0,700,700,700,0,392,120,0,12,0,1
2020,391700301,14088,1588,388,388,1200,12500,0,0,0,0,12500,2400,100,10000,0,0,0,0,1440,150,100,100,120,5
2020,391700311,7680,7580,5880,5880,1700,100,0,0,0,0,100,0,100,0,1640,1640,1640,0,3120,400,120,200,150,16
2020,391800201,29475,375,375,375,0,29100,29100,19600,9500,0,0,0,0,0,1000,1000,1000,0,1770,120,600,70,100,94
2020,391800211,4886,486,486,486,0,4400,0,0,0,0,4400,4400,0,0,3100,3100,0,1000,2810,360,100,320,360,141
2020,391800221,35070,5470,5470,5470,0,29600,29000,17000,12000,0,600,300,300,0,500,0,0,0,1900,300,120,240,160,512
2020,391800281,553,373,73,73,300,180,0,0,0,0,180,180,0,0,350,350,0,0,2231,624,144,200,110,7
2020,391800291,15920,4420,4420,4420,0,11500,11500,11500,0,0,0,0,0,0,0,0,0,0,521,120,224,12,10,16
2020,391800301,62825,13470,13470,13470,0,49355,49000,40000,9000,0,355,355,0,0,1080,1080,1000,0,4316,120,600,300,324,298
2020,391800311,75384,15264,2264,2264,13000,60120,60000,0,60000,0,120,120,0,0,50000,0,0,0,1389,114,5,330,180,81
2020,391800321,20350,550,550,550,0,19800,19800,0,19800,0,0,0,0,0,0,0,0,0,555,180,60,0,15,4
2020,391800331,36820,1620,1620,1620,0,35200,35000,35000,0,0,200,200,0,0,0,0,0,0,2240,314,10,245,180,104
2020,391800341,330,100,100,100,0,230,0,0,0,0,230,230,0,0,80,80,0,0,2316,1000,50,120,96,32
2020,391900211,73570,21970,21970,21970,0,51600,50000,50000,0,0,1600,1600,0,0,250,250,0,0,2432,264,600,24,84,104
2020,391900231,83160,13360,13360,13360,0,69800,67000,26000,41000,0,2800,2800,0,0,37420,37170,6870,10300,3900,300,100,500,100,1984
2020,391900321,32181,10181,10181,10181,0,22000,21000,21000,0,0,1000,1000,0,0,360,360,140,0,2607,232,230,645,280,47
2020,391900331,120,120,120,120,0,0,0,0,0,0,0,0,0,0,0,0,0,0,590,150,100,30,30,1
2020,391900341,66600,7300,7300,4300,0,59300,54000,35000,13000,6000,5300,2800,2500,0,4000,4000,4000,0,5220,300,120,120,84,713
2020,392800211,399059,78627,78627,77627,0,320432,303840,27000,276840,0,16592,1200,14942,450,0,0,0,0,3897,379,100,660,168,257
2020,392800221,18510,2510,2510,2510,0,16000,16000,16000,0,0,0,0,0,0,0,0,0,0,1375,127,300,120,96,36
2020,392800251,61376,4846,4846,4846,0,56530,54500,0,54500,0,2030,2030,0,0,26100,21600,19000,0,1950,240,60,360,240,109
2020,392800271,194700,38300,38300,38300,0,156400,153000,100000,53000,0,3400,0,3400,0,300,0,0,0,1211,180,240,240,72,368
2020,393800201,27250,250,250,250,0,27000,27000,6000,21000,0,0,0,0,0,0,0,0,0,878,36,180,72,0,31
2020,393800251,35390,23740,11740,11740,12000,11650,3500,0,3500,0,8150,5150,0,3000,0,0,0,0,2246,576,250,240,140,56
2020,393800291,69878,21578,21578,20578,0,48300,45000,45000,0,0,3300,2500,800,0,7400,7400,7400,0,3848,400,100,500,150,1410
2020,394800201,177600,10000,10000,10000,0,167600,165500,69000,96500,0,2100,2100,0,0,41544,39544,37044,2500,7640,420,700,800,120,1133
2020,394800221,116326,24200,24200,24200,0,92126,91000,42000,49000,0,1126,900,226,0,3000,0,0,0,6452,180,3000,120,96,299
2020,394800231,20814,12614,6114,4114,6500,8200,0,0,0,0,8200,3200,0,5000,0,0,0,0,1339,150,5,240,144,38
2020,394800241,12090,10490,2490,2490,8000,1600,0,0,0,0,1600,1600,0,0,2400,2400,2400,0,1701,96,20,150,120,214
2020,395800201,298156,5156,5156,5156,0,293000,292000,40000,252000,0,1000,0,1000,0,127500,113000,113000,0,3374,240,10,0,264,173
2020,395800271,89583,23893,23893,18893,0,65690,65000,57000,8000,0,690,400,290,0,5590,5290,3200,2000,1796,300,100,480,181,918
2020,410000112,83900,8900,8900,8900,0,75000,75000,75000,0,0,0,0,0,0,0,0,0,0,932,200,30,60,72,93
2020,410000132,204950,3450,3450,3450,0,201500,200000,200000,0,0,1500,1500,0,0,150,150,0,0,2014,360,300,200,60,451
2020,410000162,161600,21600,21600,11600,0,140000,125000,105000,20000,0,15000,5000,0,10000,28486,28486,28286,0,2240,240,100,150,150,201
2020,410000182,44120,1420,1420,1420,0,42700,42000,42000,0,0,700,700,0,0,4320,4320,4320,0,3024,340,240,360,84,261
2020,410000192,165199,164199,139199,139199,25000,1000,0,0,0,0,1000,1000,0,0,0,0,0,0,10092,144,120,288,240,1445
2020,410000212,26200,5500,5500,5500,0,20700,19500,8500,11000,0,1200,1200,0,0,1500,0,0,0,2316,78,230,600,84,37
2020,410000222,7100,100,100,100,0,7000,7000,7000,0,0,0,0,0,0,0,0,0,0,1344,120,30,60,84,7
2020,410000252,29780,2780,2780,2780,0,27000,26000,16000,0,10000,1000,1000,0,0,700,0,0,0,1470,60,10,240,60,81
2020,410000262,128230,230,230,230,0,128000,128000,38000,90000,0,0,0,0,0,101500,96500,90000,500,870,240,50,24,36,245
2020,410000272,27900,7500,7500,7500,0,20400,20000,20000,0,0,400,400,0,0,0,0,0,0,2494,216,130,336,144,78
2020,410000282,30600,600,600,600,0,30000,30000,30000,0,0,0,0,0,0,0,0,0,0,908,144,115,60,60,159
2020,410000292,33469,1938,1938,1938,0,31531,29800,29800,0,0,1731,1500,231,0,0,0,0,0,3330,240,100,240,50,564
2020,410000302,46350,550,550,550,0,45800,45000,45000,0,0,800,800,0,0,23000,23000,23000,0,3990,240,240,300,264,259
2020,410000312,57500,9100,9100,9100,0,48400,48000,48000,0,0,400,400,0,0,3500,3500,3500,0,2261,196,284,228,193,331
2020,410000322,2580,2580,80,80,2500,0,0,0,0,0,0,0,0,0,2572,2572,0,1212,1730,468,40,192,120,1
2020,410000332,3720,3520,520,520,3000,200,0,0,0,0,200,200,0,0,0,0,0,0,1970,300,50,100,360,19
2020,410000342,2496,2496,2196,2196,300,0,0,0,0,0,0,0,0,0,700,700,0,0,1585,360,50,120,120,1
2020,410000362,29880,2380,2380,2380,0,27500,27000,27000,0,0,500,0,500,0,0,0,0,0,990,180,10,60,120,15
2020,410000372,470,470,170,170,300,0,0,0,0,0,0,0,0,0,2000,2000,0,0,1968,780,60,100,480,1
2020,410000382,120,120,70,70,50,0,0,0,0,0,0,0,0,0,0,0,0,0,1334,480,50,24,144,1
2020,410000392,41660,40360,12360,12360,28000,1300,0,0,0,0,1300,1300,0,0,0,0,0,0,5680,300,100,700,180,634
2020,410600121,126805,5005,5005,5005,0,121800,120000,100000,0,20000,1800,1800,0,0,40358,40358,29158,10000,5390,420,420,420,280,2939
2020,410600141,25620,20,20,20,0,25600,25000,25000,0,0,600,600,0,0,2800,2800,2800,0,810,80,150,80,100,19
2020,410600161,10000,9500,3500,3500,6000,500,0,0,0,0,500,0,500,0,623,623,0,600,2764,800,40,240,168,1
2020,410600181,1010,1010,10,10,1000,0,0,0,0,0,0,0,0,0,400,400,0,0,620,144,90,12,7,1
2020,410600211,24876,11876,11876,11876,0,13000,13000,13000,0,0,0,0,0,0,0,0,0,0,835,125,180,24,36,75
2020,410600221,2496,2496,2496,2496,0,0,0,0,0,0,0,0,0,0,0,0,0,0,968,120,120,72,30,0
2020,410600251,53769,13019,13019,10019,0,40750,40000,40000,0,0,750,300,450,0,17100,17100,15000,2100,3900,360,300,540,350,154
2020,410600261,42653,12440,12440,12440,0,30213,28000,26000,2000,0,2213,100,2113,0,16000,16000,16000,0,2752,300,200,360,192,103
2020,410600271,48797,2477,2477,2477,0,46320,46000,42000,4000,0,320,0,320,0,11420,7420,7420,0,1254,176,200,44,42,63
2020,410600281,28434,934,934,934,0,27500,27500,27500,0,0,0,0,0,0,3000,0,0,0,802,84,100,65,36,13
2020,410600331,102850,10550,10550,550,0,92300,70000,0,70000,0,22300,2000,20300,0,62680,62680,30000,31330,2070,400,100,200,40,141
2020,410600341,33680,4680,4680,4680,0,29000,27000,25000,2000,0,2000,2000,0,0,0,0,0,0,2553,300,800,240,103,114
2020,410600351,122194,26144,26144,6144,0,96050,90000,40000,50000,0,6050,6050,0,0,21500,18000,18000,0,5360,420,30,400,240,844
2020,410600361,59540,17590,17590,14590,0,41950,38000,38000,0,0,3950,450,500,3000,0,0,0,0,4300,300,50,360,240,461
2020,410600381,193792,3042,3042,3042,0,190750,180000,60000,120000,0,10750,3500,7250,0,110420,110420,103020,6400,8560,1200,100,400,300,620
2020,410601101,107416,1766,1766,1766,0,105650,105400,100000,5400,0,250,250,0,0,51000,1000,0,1000,1690,240,200,200,100,393
2020,410700111,126500,55500,4500,4500,51000,71000,70000,0,70000,0,1000,1000,0,0,72700,40700,40000,0,4900,240,80,240,240,265
2020,410700121,24044,3044,3044,3044,0,21000,20000,20000,0,0,1000,1000,0,0,0,0,0,0,3410,180,110,600,360,41
2020,410700131,3110,3110,110,110,3000,0,0,0,0,0,0,0,0,0,1600,1600,1600,0,1764,120,20,120,84,1
2020,410700141,6922,6922,1922,1922,5000,0,0,0,0,0,0,0,0,0,0,0,0,0,2560,490,240,180,250,14
2020,410700151,72400,24590,5590,5590,19000,47810,47000,0,47000,0,810,610,200,0,16000,15000,0,15000,2694,204,30,144,156,1800
2020,410700171,24500,12500,12500,12500,0,12000,12000,12000,0,0,0,0,0,0,0,0,0,0,999,50,360,15,58,29
2020,410700181,31860,1260,1260,1260,0,30600,30000,30000,0,0,600,600,0,0,15724,15724,15724,0,2500,120,50,120,240,27
2020,410700201,12500,12500,4500,4500,8000,0,0,0,0,0,0,0,0,0,0,0,0,0,1420,280,170,20,30,4
2020,410700211,530,530,430,430,100,0,0,0,0,0,0,0,0,0,0,0,0,0,1030,315,165,12,48,0
2020,410700221,2010,10,10,10,0,2000,2000,2000,0,0,0,0,0,0,0,0,0,0,526,84,60,36,18,1
2020,410700231,73443,13143,13143,13143,0,60300,60000,60000,0,0,300,300,0,0,14396,14396,14396,0,7495,288,107,200,252,999
2020,410700251,4614,64,64,64,0,4550,4500,4500,0,0,50,20,30,0,1736,1736,1736,0,1244,220,50,60,48,19
2020,410700261,13300,2300,2300,2300,0,11000,11000,11000,0,0,0,0,0,0,400,0,0,0,916,86,276,10,24,6
2020,410700331,104842,19892,19892,19892,0,84950,82000,50000,32000,0,2950,2650,300,0,7000,7000,7000,0,6050,400,400,500,200,2162
2020,410700351,12780,1880,1880,1880,0,10900,10900,10900,0,0,0,0,0,0,3300,3300,1300,0,1656,684,60,120,96,21
2020,410700381,14216,14216,2216,2216,12000,0,0,0,0,0,0,0,0,0,9600,9600,9600,0,2340,240,240,120,240,23
2020,410700391,41240,11340,11340,11340,0,29900,29000,29000,0,0,900,900,0,0,20000,20000,20000,0,3130,240,200,360,240,915
2020,410701101,1020,1020,20,20,1000,0,0,0,0,0,0,0,0,0,0,0,0,0,1086,556,12,36,72,67
2020,410701131,18420,18220,3220,3220,15000,200,0,0,0,0,200,200,0,0,0,0,0,0,1730,240,150,200,220,61
2020,410800101,171640,68840,15840,15840,53000,102800,100000,0,100000,0,2800,2800,0,0,75000,10000,10000,0,3680,300,200,500,180,910
2020,410800131,13104,12104,7104,7104,5000,1000,0,0,0,0,1000,1000,0,0,3600,3600,0,3400,3460,1080,10,380,340,1194
2020,410800171,28596,27396,6396,6396,21000,1200,0,0,0,0,1200,1200,0,0,0,0,0,0,1499,73,30,250,96,21
2020,410800181,194600,24350,24350,24350,0,170250,170000,170000,0,0,250,250,0,0,0,0,0,0,4174,324,20,220,200,1377
2020,410800201,4783,783,783,783,0,4000,4000,4000,0,0,0,0,0,0,900,900,0,900,2140,120,40,120,120,24
2020,410800211,2098,2066,1891,1891,175,32,0,0,0,0,32,0,32,0,500,500,0,0,1672,96,400,51,15,0
2020,410800221,36832,18000,18000,18000,0,18832,18000,8000,10000,0,832,380,452,0,0,0,0,0,3144,390,230,320,144,388
2020,410800231,4194,960,960,960,0,3234,1200,0,1200,0,2034,2034,0,0,864,864,0,0,2008,274,18,303,184,33
2020,410800251,8910,410,410,410,0,8500,8500,8500,0,0,0,0,0,0,0,0,0,0,728,112,20,20,48,7
2020,410800291,9692,7692,692,492,7000,2000,0,0,0,0,2000,2000,0,0,1520,1520,0,0,3330,440,50,200,280,87
2020,410800311,2192,2192,1692,1692,500,0,0,0,0,0,0,0,0,0,600,600,0,600,1700,500,50,70,150,110
2020,410800331,20543,20143,4543,4543,15600,400,0,0,0,0,400,300,100,0,300,300,0,300,5592,520,30,420,300,422
2020,410800351,1564,1564,64,64,1500,0,0,0,0,0,0,0,0,0,3000,3000,0,2000,520,66,0,2,42,4
2020,410800381,1752,1652,1352,1352,300,100,0,0,0,0,100,100,0,0,3440,3440,0,440,840,391,2,10,72,24
2020,410800391,3014,3014,3014,3014,0,0,0,0,0,0,0,0,0,0,0,0,0,0,382,80,40,30,42,2
2020,410801101,8380,8380,880,880,7500,0,0,0,0,0,0,0,0,0,590,590,0,0,1672,120,10,120,72,6
2020,410900111,121640,21400,12400,12400,9000,100240,98000,0,98000,0,2240,100,2140,0,55500,5000,5000,0,2350,300,200,50,120,248
2020,410900141,10910,10910,910,910,10000,0,0,0,0,0,0,0,0,0,6070,6070,6000,0,1500,120,10,10,200,16
2020,410900161,138780,58680,8680,8680,50000,80100,80000,0,80000,0,100,100,0,0,30000,0,0,0,5100,420,480,320,360,261
2020,410900191,8400,8000,1000,1000,7000,400,0,0,0,0,400,400,0,0,0,0,0,0,2373,360,30,10,150,297
2020,410900211,17030,30,30,30,0,17000,17000,17000,0,0,0,0,0,0,0,0,0,0,872,240,150,20,44,14
2020,410900221,17255,255,255,255,0,17000,17000,17000,0,0,0,0,0,0,3000,3000,3000,0,807,180,180,36,78,23
2020,410900241,6650,650,650,650,0,6000,6000,6000,0,0,0,0,0,0,0,0,0,0,667,170,96,36,36,11
2020,410900251,69732,27576,9576,9576,18000,42156,40000,0,40000,0,2156,800,1356,0,25000,25000,22500,2400,5168,612,150,240,216,412
2020,410900261,27280,4980,4980,4980,0,22300,22300,22000,300,0,0,0,0,0,0,0,0,0,1496,206,220,84,94,24
2020,410900281,9150,250,250,250,0,8900,8900,8900,0,0,0,0,0,0,2600,2600,2600,0,1166,120,230,96,72,18
2020,410900291,4260,4260,760,760,3500,0,0,0,0,0,0,0,0,0,0,0,0,0,1525,420,10,25,120,2
2020,410900341,16050,3050,3050,2550,0,13000,12000,12000,0,0,1000,1000,0,0,5200,5200,5200,0,2350,180,480,180,240,49
2020,410900351,35210,22360,9360,9360,13000,12850,11000,0,0,11000,1850,1600,250,0,2000,2000,1500,500,2430,120,100,350,80,247
2020,410900361,18000,6000,6000,6000,0,12000,12000,12000,0,0,0,0,0,0,0,0,0,0,1007,105,10,24,84,13
2020,410900371,72950,7200,7200,7200,0,65750,65000,40000,25000,0,750,750,0,0,2000,0,0,0,2985,216,100,460,215,110
2020,410900381,14540,14040,40,40,14000,500,0,0,0,0,500,500,0,0,18700,18700,0,15000,4300,350,500,500,320,223
2020,410900391,278960,35960,35960,30960,0,243000,239000,41000,198000,0,4000,3500,500,0,14000,0,0,0,5540,360,10,960,240,1910
2020,410901101,49830,16878,16878,16878,0,32952,30000,0,30000,0,2952,1500,1452,0,32000,32000,32000,0,3298,408,100,360,240,25
2020,411000152,36650,150,150,150,0,36500,35000,35000,0,0,1500,1500,0,0,2000,2000,2000,0,2485,160,1000,360,180,253
2020,411000162,30140,140,140,140,0,30000,30000,30000,0,0,0,0,0,0,4000,4000,3000,800,2588,276,720,84,108,54
2020,411000182,325,325,25,25,300,0,0,0,0,0,0,0,0,0,2000,2000,0,700,2398,340,20,216,192,26
2020,411000202,14115,1115,1115,1115,0,13000,13000,13000,0,0,0,0,0,0,0,0,0,0,445,73,24,36,22,8
2020,411000212,2513,2513,513,513,2000,0,0,0,0,0,0,0,0,0,0,0,0,0,1467,445,80,72,180,2
2020,411000222,63266,30816,5816,5316,25000,32450,32000,0,32000,0,450,450,0,0,4990,4990,4990,0,1548,220,70,320,108,47
2020,411000242,50,50,50,50,0,0,0,0,0,0,0,0,0,0,0,0,0,0,450,5,12,10,20,0
2020,411000252,3859,359,359,359,0,3500,3500,3500,0,0,0,0,0,0,0,0,0,0,1445,60,400,15,70,8
2020,411000262,2340,2340,1340,1340,1000,0,0,0,0,0,0,0,0,0,0,0,0,0,1260,120,10,120,120,7
2020,411000272,8607,2307,2307,2307,0,6300,6000,6000,0,0,300,300,0,0,0,0,0,0,2080,180,30,240,150,17
2020,411000282,13190,3190,3190,3190,0,10000,10000,10000,0,0,0,0,0,0,5100,5100,5100,0,1185,120,10,75,120,13
2020,411000292,99120,6320,6320,3320,0,92800,83000,83000,0,0,9800,3800,1000,5000,61000,61000,58000,3000,5420,360,100,400,120,1003
2020,411000302,29690,7090,7090,7090,0,22600,22000,22000,0,0,600,600,0,0,0,0,0,0,1713,468,96,129,96,64
2020,411000332,43400,3000,3000,3000,0,40400,40000,40000,0,0,400,400,0,0,8000,8000,8000,0,1772,240,80,150,72,154
2020,411000342,15070,14670,2170,2170,12500,400,0,0,0,0,400,400,0,0,1550,1550,1500,0,2662,392,100,200,300,187
2020,411000362,9958,6958,5358,5358,1600,3000,0,0,0,0,3000,3000,0,0,0,0,0,0,1721,660,60,96,0,1
2020,411000372,14850,12850,350,350,12500,2000,0,0,0,0,2000,2000,0,0,8000,8000,8000,0,3810,360,120,690,360,67
2020,411000382,61123,3123,3123,3123,0,58000,56000,56000,0,0,2000,2000,0,0,4436,4436,4400,0,2056,130,30,68,128,151
2020,411000392,32490,32010,3010,3010,29000,480,0,0,0,0,480,480,0,0,0,0,0,0,3692,300,60,720,120,487
2020,411600101,5134,5134,2134,1134,3000,0,0,0,0,0,0,0,0,0,540,540,0,540,1390,720,100,100,100,8
2020,411600111,135240,19640,19640,19640,0,115600,115000,100000,15000,0,600,600,0,0,10000,0,0,0,4600,240,200,480,240,2664
2020,411600121,9710,9360,7360,2360,2000,350,0,0,0,0,350,350,0,0,5050,5050,0,5000,4660,800,140,360,320,27
2020,411600131,17100,16100,3100,2000,13000,1000,0,0,0,0,1000,1000,0,0,5540,5540,0,5120,1550,80,100,80,250,1770
2020,411600151,2600,2600,100,100,2500,0,0,0,0,0,0,0,0,0,0,0,0,0,1561,60,800,10,16,1
2020,411600171,74680,2080,2080,2080,0,72600,72000,54000,18000,0,600,500,100,0,1080,80,0,0,3279,180,650,184,120,77
2020,411600201,3700,200,200,200,0,3500,3500,3500,0,0,0,0,0,0,0,0,0,0,605,133,25,45,25,21
2020,411600211,50210,2210,2210,2210,0,48000,40000,40000,0,0,8000,400,100,7500,5400,5400,5400,0,2025,190,240,50,120,40
2020,411600221,117838,7260,7260,7260,0,110578,104000,65000,27000,12000,6578,6500,78,0,12000,12000,12000,0,4562,200,150,600,170,1418
2020,411600231,13809,4209,4209,4209,0,9600,8000,8000,0,0,1600,1600,0,0,0,0,0,0,2100,100,80,520,120,110
2020,411600241,12020,2020,2020,2020,0,10000,10000,10000,0,0,0,0,0,0,50,50,0,0,1830,120,120,180,150,13
2020,411600251,31980,780,780,780,0,31200,31200,16200,15000,0,0,0,0,0,500,0,0,0,1564,384,240,60,60,21
2020,411600261,30344,3364,3364,3364,0,26980,23000,23000,0,0,3980,3800,180,0,13040,13040,10200,2840,3060,264,180,540,156,161
2020,411600281,21908,2408,2408,2408,0,19500,18000,18000,0,0,1500,1500,0,0,21227,21227,14267,6000,2650,230,20,400,200,59
2020,411600291,97021,24921,9921,9921,15000,72100,71000,0,59000,12000,1100,1000,100,0,29150,29150,0,29150,4075,400,187,473,205,674
2020,411600331,126382,26982,26982,26982,0,99400,98000,56000,42000,0,1400,950,450,0,12750,12750,12750,0,4384,300,60,144,240,151
2020,411600341,185080,32800,32800,32800,0,152280,152000,72000,80000,0,280,180,100,0,67000,45000,0,25000,3560,400,120,400,140,552
2020,411600361,43045,35745,2745,2745,33000,7300,0,0,0,0,7300,7300,0,0,20000,20000,20000,0,4270,480,20,1200,480,80
2020,411600371,31825,1575,1575,1575,0,30250,30000,30000,0,0,250,250,0,0,4895,4895,4895,0,1115,110,60,240,120,323
2020,411700101,53737,7602,7602,7602,0,46135,46000,36000,10000,0,135,135,0,0,5700,200,0,200,6534,360,1080,480,300,348
2020,411700121,68722,8700,8700,8700,0,60022,60000,60000,0,0,22,0,22,0,12000,0,0,0,2250,450,200,50,150,108
2020,411700141,92683,26527,26527,26527,0,66156,65000,65000,0,0,1156,300,856,0,0,0,0,0,6750,350,700,240,350,2074
2020,411700151,220760,11460,11460,6460,0,209300,204000,59000,145000,0,5300,5300,0,0,13272,10072,10000,0,6707,432,300,348,480,1327
2020,411700181,220262,24497,24497,14497,0,195765,195200,45000,150200,0,565,0,565,0,140800,6000,0,6000,4770,240,100,60,80,417
2020,411700201,22853,3603,3603,3603,0,19250,19000,19000,0,0,250,250,0,0,17900,17900,17900,0,2709,291,120,520,360,56
2020,411700221,27981,7281,7281,7281,0,20700,20000,20000,0,0,700,500,200,0,9812,9812,9800,0,2420,170,300,500,300,162
2020,411700231,42160,110,110,110,0,42050,37000,12000,25000,0,5050,50,5000,0,20000,0,0,0,2019,128,62,246,240,159
2020,411700241,14200,14200,10700,10700,3500,0,0,0,0,0,0,0,0,0,0,0,0,0,1086,120,506,50,72,13
2020,411700251,2710,1650,1650,1650,0,1060,0,0,0,0,1060,900,160,0,570,570,0,550,1346,180,8,100,78,43
2020,411700291,17540,840,840,840,0,16700,15000,15000,0,0,1700,1700,0,0,7250,7250,7100,0,1204,300,50,120,200,34
2020,411700311,60155,3205,3205,1505,0,56950,52500,39500,0,13000,4450,250,2200,2000,9000,9000,9000,0,1034,216,60,120,60,33
2020,411700331,43195,3195,3195,3195,0,40000,40000,40000,0,0,0,0,0,0,0,0,0,0,2256,280,550,250,156,53
2020,411700371,16463,16463,12463,12463,4000,0,0,0,0,0,0,0,0,0,0,0,0,0,1158,120,124,40,144,59
2020,411700391,18440,16140,15640,14640,500,2300,0,0,0,0,2300,2000,0,300,90,90,0,50,1838,480,10,240,48,89
2020,411800121,10500,10500,2500,2500,8000,0,0,0,0,0,0,0,0,0,0,0,0,0,1185,120,100,80,160,139
2020,411800131,57512,2512,2512,2512,0,55000,55000,50000,5000,0,0,0,0,0,2200,0,0,0,2430,210,500,90,120,87
2020,411800151,41212,3042,3042,3042,0,38170,35000,35000,0,0,3170,3070,100,0,15550,15550,15450,0,2424,200,30,150,288,65
2020,411800171,72000,800,800,800,0,71200,71000,70000,1000,0,200,0,200,0,200,200,0,0,2592,300,360,80,132,4963
2020,411800201,51578,9958,9958,9958,0,41620,36500,26500,0,10000,5120,4600,520,0,17200,17200,17200,0,6990,360,250,780,420,493
2020,411800211,157280,35680,35680,35680,0,121600,114000,54000,60000,0,7600,600,4000,3000,0,0,0,0,3165,230,40,250,250,1938
2020,411800221,71049,10399,10399,10399,0,60650,60000,60000,0,0,650,0,650,0,0,0,0,0,2660,250,100,420,120,93
2020,411800231,51005,505,505,505,0,50500,48800,47000,1800,0,1700,1200,500,0,11400,11400,11200,0,3092,207,400,750,250,261
2020,411800241,259900,103400,103400,103400,0,156500,108500,78500,30000,0,48000,0,48000,0,25000,0,0,0,9205,470,1600,800,135,17026
2020,411800301,1030,1030,30,30,1000,0,0,0,0,0,0,0,0,0,10000,10000,0,0,862,438,18,10,36,1
2020,411800311,78440,4340,4340,4340,0,74100,70000,70000,0,0,4100,3800,300,0,7000,7000,7000,0,5300,300,200,450,200,494
2020,411800331,82900,400,400,400,0,82500,80000,80000,0,0,2500,2500,0,0,45340,45340,45340,0,5626,660,240,240,276,527
2020,411800351,118934,117504,87504,87504,30000,1430,0,0,0,0,1430,300,1130,0,61135,61135,53580,6000,3844,716,20,155,276,350
2020,411800371,45570,7120,7120,5120,0,38450,35000,35000,0,0,3450,950,2500,0,32250,32250,22000,10000,3258,360,10,240,120,535
2020,411800381,90,90,90,90,0,0,0,0,0,0,0,0,0,0,0,0,0,0,1890,270,350,54,151,1
2020,411900101,7300,7300,7300,7300,0,0,0,0,0,0,0,0,0,0,10000,10000,0,10000,1830,120,100,100,60,216
2020,411900141,3300,3300,300,300,3000,0,0,0,0,0,0,0,0,0,0,0,0,0,1066,74,200,72,120,1
2020,411900151,4306,4306,3306,3306,1000,0,0,0,0,0,0,0,0,0,880,880,880,0,2180,540,240,480,120,1
2020,411900161,6410,6410,1410,1410,5000,0,0,0,0,0,0,0,0,0,0,0,0,0,1655,50,50,80,75,12
2020,411900171,4540,1640,140,140,1500,2900,2500,0,0,2500,400,400,0,0,100,100,0,0,3190,720,100,180,160,48
2020,411900181,510,510,10,10,500,0,0,0,0,0,0,0,0,0,1500,1500,0,1500,1320,600,10,20,50,0
2020,411900211,25507,3507,3507,3507,0,22000,22000,22000,0,0,0,0,0,0,0,0,0,0,1537,204,30,36,60,15
2020,411900221,18825,525,525,525,0,18300,17000,17000,0,0,1300,1300,0,0,0,0,0,0,2300,120,140,360,180,101
2020,411900231,39442,2142,2142,2142,0,37300,35000,35000,0,0,2300,2300,0,0,22793,22793,22643,0,4098,300,14,480,240,61
2020,411900251,47300,300,300,300,0,47000,47000,15000,32000,0,0,0,0,0,0,0,0,0,1640,140,500,50,50,41
2020,411900261,5622,622,622,622,0,5000,5000,5000,0,0,0,0,0,0,0,0,0,0,912,50,10,70,72,7
2020,411900271,15828,828,828,828,0,15000,15000,15000,0,0,0,0,0,0,6000,6000,6000,0,1210,180,120,100,60,16
2020,411900281,59245,4080,4080,4080,0,55165,50000,50000,0,0,5165,4800,365,0,23000,23000,23000,0,4136,264,20,120,120,369
2020,411900291,169100,11900,11900,11900,0,157200,156000,45000,52000,59000,1200,1200,0,0,67000,35000,35000,0,7400,300,700,1000,600,3413
2020,411900301,11234,10934,934,934,10000,300,0,0,0,0,300,300,0,0,0,0,0,0,1374,132,140,216,120,19
2020,411900321,36551,13051,5051,5051,8000,23500,23000,0,23000,0,500,500,0,0,18750,18750,18750,0,3694,240,20,264,180,335
2020,411900331,301730,90030,11030,11030,79000,211700,200000,0,200000,0,11700,10700,1000,0,7000,7000,0,7000,11720,600,100,600,600,3827
2020,411900361,66118,10958,10958,10958,0,55160,55000,47000,8000,0,160,160,0,0,19400,17400,7400,10000,6000,360,300,360,120,3992
2020,411900381,1800,1300,300,300,1000,500,0,0,0,0,500,500,0,0,0,0,0,0,3304,528,200,600,72,49
2020,411900391,35790,33790,9290,8890,24500,2000,0,0,0,0,2000,0,2000,0,22000,22000,22000,0,1710,240,40,50,180,115
2020,412000122,52700,50200,20200,20200,30000,2500,0,0,0,0,2500,2500,0,0,200,200,0,0,4200,360,100,300,120,329
2020,412000132,7750,5250,2750,2250,2500,2500,0,0,0,0,2500,2500,0,0,1520,1520,1520,0,2710,240,40,240,300,87
2020,412000142,1506,1506,6,6,1500,0,0,0,0,0,0,0,0,0,0,0,0,0,853,158,60,29,42,0
2020,412000162,6200,6200,200,200,6000,0,0,0,0,0,0,0,0,0,0,0,0,0,1400,60,10,96,144,3
2020,412000172,47150,2150,2150,2150,0,45000,45000,35000,10000,0,0,0,0,0,10500,7500,5000,2500,3040,240,20,360,360,41
2020,412000202,25808,5808,5808,5808,0,20000,18000,14000,4000,0,2000,2000,0,0,2300,2300,0,0,4300,240,10,360,240,56
2020,412000212,1850,1850,50,50,1800,0,0,0,0,0,0,0,0,0,0,0,0,0,990,78,25,65,50,1
2020,412000232,9700,700,700,700,0,9000,9000,9000,0,0,0,0,0,0,0,0,0,0,632,96,100,12,44,10
2020,412000242,19535,4535,4535,4535,0,15000,12000,12000,0,0,3000,300,700,2000,0,0,0,0,4559,324,450,120,420,237
2020,412000252,8218,8218,218,218,8000,0,0,0,0,0,0,0,0,0,6400,6400,6400,0,1910,120,10,120,180,12
2020,412000262,550,550,50,50,500,0,0,0,0,0,0,0,0,0,0,0,0,0,1787,780,12,15,240,0
2020,412000272,12321,12321,821,821,11500,0,0,0,0,0,0,0,0,0,113,113,0,0,4082,270,200,288,384,28
2020,412000282,3080,3080,80,80,3000,0,0,0,0,0,0,0,0,0,0,0,0,0,1492,480,120,60,132,1
2020,412000302,104100,12000,12000,12000,0,92100,92000,42000,50000,0,100,100,0,0,31000,31000,31000,0,2220,360,20,600,120,482
2020,412000312,5186,5186,4886,86,300,0,0,0,0,0,0,0,0,0,5040,5040,4800,0,1552,360,300,20,100,60
2020,412000332,83670,6870,6870,6870,0,76800,73000,43000,30000,0,3800,3800,0,0,6560,6560,2000,0,6456,420,60,360,420,567
2020,412000342,28585,26240,240,240,26000,2345,0,0,0,0,2345,2300,45,0,11564,11564,564,0,3234,300,120,276,168,19
2020,412000362,150,150,150,150,0,0,0,0,0,0,0,0,0,0,0,0,0,0,3400,800,100,700,300,2
2020,412000382,9496,5400,400,400,5000,4096,0,0,0,0,4096,1096,0,3000,1096,1096,0,0,2926,180,84,360,216,33
2020,412600101,87400,24450,24450,24450,0,62950,61000,61000,0,0,1950,1950,0,0,0,0,0,0,2787,372,115,291,119,127
2020,412600111,42555,4555,4555,4555,0,38000,38000,38000,0,0,0,0,0,0,15350,50,0,0,5224,427,141,136,181,302
2020,412600151,8790,290,290,290,0,8500,8500,8500,0,0,0,0,0,0,1340,1340,940,0,1446,126,120,144,168,7
2020,412600171,33515,3335,3335,3335,0,30180,30000,30000,0,0,180,0,180,0,18770,18770,17370,1400,2282,252,95,214,168,73
2020,412600191,107542,17942,17942,17542,0,89600,88500,64500,24000,0,1100,1100,0,0,26050,16050,0,9550,4972,387,98,207,144,1002
2020,412600201,41502,1420,1420,1420,0,40082,40000,40000,0,0,82,0,82,0,0,0,0,0,1889,265,10,24,120,6
2020,412600221,3890,1390,1390,1390,0,2500,0,0,0,0,2500,2500,0,0,2217,2217,0,0,2462,200,400,200,216,181
2020,412600231,80137,34987,34987,34987,0,45150,45000,45000,0,0,150,150,0,0,1000,1000,0,1000,6090,2150,800,480,240,350
2020,412600241,11221,221,221,221,0,11000,11000,11000,0,0,0,0,0,0,0,0,0,0,1212,178,50,32,122,9
2020,412600251,1198,1198,698,698,500,0,0,0,0,0,0,0,0,0,3530,3530,1000,2000,812,180,27,45,30,1
2020,412600271,14380,6080,4980,4980,1100,8300,8000,0,8000,0,300,0,300,0,1500,0,0,0,1306,120,240,96,60,16
2020,412600291,11249,11000,9000,9000,2000,249,0,0,0,0,249,0,249,0,0,0,0,0,2465,620,15,122,96,81
2020,412600381,28791,8791,8791,8791,0,20000,20000,20000,0,0,0,0,0,0,0,0,0,0,1838,72,20,180,180,53
2020,412600391,43813,15663,15663,10663,0,28150,25000,25000,0,0,3150,2750,400,0,3000,3000,3000,0,5000,112,40,370,360,59
2020,412700101,122584,24884,24884,22384,0,97700,87100,70000,8500,8600,10600,600,0,10000,10000,10000,10000,0,6760,300,300,600,360,466
2020,412700141,24995,24995,2995,2995,22000,0,0,0,0,0,0,0,0,0,3000,3000,0,3000,2280,240,50,200,100,581
2020,412700151,5000,5000,2500,2500,2500,0,0,0,0,0,0,0,0,0,0,0,0,0,1276,384,70,50,72,4
2020,412700161,27572,4272,1272,1272,3000,23300,22000,0,22000,0,1300,1300,0,0,2300,2300,2300,0,4470,1500,150,200,240,74
2020,412700181,15250,250,250,250,0,15000,15000,15000,0,0,0,0,0,0,8100,8100,8100,0,2250,240,36,360,204,45
2020,412700201,81021,10571,10571,10571,0,70450,70000,42000,28000,0,450,250,200,0,10840,10840,0,10840,5725,240,60,300,156,1215
2020,412700211,79520,17070,17070,17070,0,62450,56000,56000,0,0,6450,450,6000,0,288,288,0,0,2816,500,150,180,96,144
2020,412700221,55435,7735,7735,7735,0,47700,45000,45000,0,0,2700,2700,0,0,15000,15000,15000,0,2360,100,100,200,120,161
2020,412700231,56890,28690,4690,4690,24000,28200,19000,0,15000,4000,9200,1200,0,8000,0,0,0,0,1724,240,150,180,120,36
2020,412700251,25260,3460,3460,3460,0,21800,20000,20000,0,0,1800,1800,0,0,1200,1200,700,0,4700,260,1020,550,240,59
2020,412700261,51790,1790,1790,1790,0,50000,50000,50000,0,0,0,0,0,0,28000,28000,28000,0,4386,360,100,120,156,640
2020,412700281,61810,5810,5810,5810,0,56000,53000,35000,18000,0,3000,3000,0,0,20280,20280,20280,0,3900,360,600,300,180,596
2020,412700311,100,100,100,100,0,0,0,0,0,0,0,0,0,0,0,0,0,0,546,96,30,20,50,1
2020,412700321,25292,892,892,892,0,24400,21000,21000,0,0,3400,3400,0,0,14500,14500,14500,0,2543,284,60,620,276,201
2020,412700341,18140,17950,2950,2950,15000,190,0,0,0,0,190,190,0,0,0,0,0,0,3650,300,100,250,300,27
2020,412700351,2956,2906,2606,2606,300,50,0,0,0,0,50,50,0,0,0,0,0,0,1800,370,80,460,150,41
2020,412700361,30410,26610,2610,2610,24000,3800,3000,0,0,3000,800,800,0,0,22440,22440,8440,14000,2840,240,20,400,120,520
2020,412700381,45627,38046,10046,10046,28000,7581,0,0,0,0,7581,981,600,6000,18000,18000,18000,0,4410,500,150,240,240,512
2020,412700391,5498,4898,1398,898,3500,600,0,0,0,0,600,600,0,0,48,48,0,0,3560,450,400,200,300,94
2020,412800101,93731,3663,3663,3663,0,90068,90000,90000,0,0,68,0,68,0,35200,20000,20000,0,4930,240,120,180,240,93
2020,412800121,55902,6702,6702,6702,0,49200,48000,48000,0,0,1200,1200,0,0,4828,4828,4828,0,4346,236,50,300,480,234
2020,412800131,3550,3550,50,50,3500,0,0,0,0,0,0,0,0,0,0,0,0,0,466,60,12,0,24,7
2020,412800161,110556,5856,5856,5856,0,104700,99500,59500,40000,0,5200,5200,0,0,22945,22945,20200,0,3095,300,80,400,400,277
2020,412800171,62300,3100,3100,1600,0,59200,59000,59000,0,0,200,200,0,0,0,0,0,0,1915,280,50,200,100,102
2020,412800181,23000,1000,1000,1000,0,22000,22000,22000,0,0,0,0,0,0,0,0,0,0,744,100,240,24,60,15
2020,412800191,54710,38910,11910,9910,27000,15800,11000,0,11000,0,4800,2800,0,2000,12000,4000,0,4000,4402,320,250,800,312,281
2020,412800201,22202,7802,7802,7802,0,14400,11600,6000,5600,0,2800,2700,100,0,2717,2717,800,1917,2630,192,25,340,192,84
2020,412800211,22760,10760,10760,10760,0,12000,12000,12000,0,0,0,0,0,0,0,0,0,0,889,132,60,10,18,30
2020,412800221,18500,6500,6500,6500,0,12000,12000,12000,0,0,0,0,0,0,0,0,0,0,1414,120,240,90,108,44
2020,412800231,3080,3080,80,80,3000,0,0,0,0,0,0,0,0,0,0,0,0,0,1103,399,12,36,46,1
2020,412800241,81,36,36,36,0,45,0,0,0,0,45,0,45,0,0,0,0,0,812,144,96,24,48,4
2020,412800251,2227,2040,1940,1940,100,187,0,0,0,0,187,140,47,0,650,650,0,650,2011,245,100,130,72,109
2020,412800261,30694,8694,8694,8694,0,22000,19000,19000,0,0,3000,3000,0,0,16550,6550,700,3850,3075,270,270,255,132,150
2020,412800271,555,555,555,555,0,0,0,0,0,0,0,0,0,0,0,0,0,0,1005,84,68,80,78,6
2020,412800281,30800,800,800,800,0,30000,30000,30000,0,0,0,0,0,0,0,0,0,0,3754,240,30,190,84,236
2020,412800291,50533,4920,4920,4920,0,45613,42000,42000,0,0,3613,3500,113,0,3500,0,0,0,1932,240,100,120,72,108
2020,412800301,220,220,220,220,0,0,0,0,0,0,0,0,0,0,0,0,0,0,429,72,25,40,15,1
2020,412800311,2500,2500,1000,1000,1500,0,0,0,0,0,0,0,0,0,0,0,0,0,1027,60,10,120,72,4
2020,412800321,55240,13040,13040,13040,0,42200,41000,40000,1000,0,1200,700,500,0,0,0,0,0,4250,360,10,600,360,74
2020,412800341,63740,3740,3740,3740,0,60000,56000,56000,0,0,4000,4000,0,0,25700,25700,25700,0,2697,204,403,150,100,742
2020,412800361,39478,8128,8128,3128,0,31350,25000,25000,0,0,6350,6350,0,0,18041,18041,13205,4836,3770,580,150,480,240,240
2020,412800371,250,250,50,50,200,0,0,0,0,0,0,0,0,0,0,0,0,0,418,258,24,0,12,1
2020,412800381,23130,230,230,230,0,22900,13000,13000,0,0,9900,1400,0,8500,3500,3500,3300,200,4080,240,100,720,180,29
2020,412800391,6010,6010,1010,1010,5000,0,0,0,0,0,0,0,0,0,0,0,0,0,1590,250,150,240,150,27
2020,412900101,129207,40707,40707,32707,0,88500,83000,65000,18000,0,5500,5500,0,0,0,0,0,0,4190,350,400,150,120,1760
2020,412900121,73207,5107,5107,3107,0,68100,68000,68000,0,0,100,100,0,0,1700,1700,1700,0,2801,245,100,240,96,114
2020,412900131,195780,15780,15780,15780,0,180000,180000,95000,85000,0,0,0,0,0,45050,3050,0,0,4401,292,3000,30,54,366
2020,412900141,170390,7640,7640,7140,0,162750,152000,59000,93000,0,10750,150,10600,0,58030,6030,6000,0,4852,216,20,300,216,559
2020,412900161,99536,48536,16536,16536,32000,51000,50000,0,50000,0,1000,1000,0,0,39000,0,0,0,2700,360,120,360,240,435
2020,412900201,1668,1668,68,68,1600,0,0,0,0,0,0,0,0,0,0,0,0,0,570,120,80,10,30,1
2020,412900221,42385,7080,7080,7080,0,35305,35000,35000,0,0,305,170,135,0,2781,2781,2781,0,1634,250,100,80,74,107
2020,412900231,54594,51094,19094,9094,32000,3500,0,0,0,0,3500,3500,0,0,10180,10180,0,10000,5230,240,300,480,340,1213
2020,412900241,43364,27364,27364,27364,0,16000,16000,16000,0,0,0,0,0,0,0,0,0,0,2717,480,78,60,120,516
2020,412900251,50436,22136,22136,4136,0,28300,25000,25000,0,0,3300,300,2000,1000,16100,16100,14000,2100,4500,240,50,360,240,613
2020,412900261,4057,4057,3057,3057,1000,0,0,0,0,0,0,0,0,0,0,0,0,0,1336,516,10,72,90,4
2020,412900271,13540,13340,1340,1340,12000,200,0,0,0,0,200,200,0,0,3880,3880,3600,250,3654,204,20,120,180,18
2020,412900281,45530,2430,2430,1930,0,43100,41000,41000,0,0,2100,1300,300,500,20000,20000,20000,0,9848,280,490,280,348,590
2020,412900291,182053,10603,10603,8603,0,171450,170000,50000,120000,0,1450,1300,150,0,48480,43480,2700,40400,4225,495,355,490,510,1062
2020,412900301,33690,6690,6690,6690,0,27000,27000,27000,0,0,0,0,0,0,0,0,0,0,2486,180,840,10,84,47
2020,412900341,82450,7450,2450,2450,5000,75000,75000,0,75000,0,0,0,0,0,61900,4900,2500,2000,4180,180,20,360,240,49
2020,412900351,44535,1035,1035,1035,0,43500,38000,38000,0,0,5500,5500,0,0,11900,11900,11500,400,3600,100,10,324,144,274
2020,412900361,1700,900,400,400,500,800,0,0,0,0,800,800,0,0,1440,1440,0,1040,3930,800,1000,380,220,48
2020,412900381,13160,10610,2610,2610,8000,2550,0,0,0,0,2550,2550,0,0,7960,7960,7600,0,5560,240,30,600,240,234
2020,413000112,49000,3900,3900,3900,0,45100,45000,45000,0,0,100,100,0,0,0,0,0,0,2260,300,60,120,120,84
2020,413000122,45620,9620,9620,9620,0,36000,36000,36000,0,0,0,0,0,0,0,0,0,0,2190,100,10,360,180,1484
2020,413000132,5934,5934,934,934,5000,0,0,0,0,0,0,0,0,0,3330,3330,0,3000,2424,690,3,180,240,7
2020,413000142,44820,220,220,220,0,44600,35000,35000,0,0,9600,1600,0,8000,10060,10060,10060,0,2360,210,700,20,150,68
2020,413000162,25200,500,500,500,0,24700,24000,15000,9000,0,700,700,0,0,90,90,0,0,1072,120,400,60,84,48
2020,413000172,18470,15370,370,370,15000,3100,0,0,0,0,3100,3100,0,0,0,0,0,0,4130,260,200,660,360,310
2020,413000182,41500,40510,10510,10510,30000,990,0,0,0,0,990,990,0,0,4000,4000,0,4000,2086,360,6,300,240,46
2020,413000192,60053,3,3,3,0,60050,60000,60000,0,0,50,50,0,0,14443,14443,14443,0,1500,150,30,60,200,72
2020,413000202,56256,5530,5530,5530,0,50726,50000,50000,0,0,726,500,226,0,2000,0,0,0,2286,216,180,420,180,49
2020,413000242,1020,1020,720,720,300,0,0,0,0,0,0,0,0,0,0,0,0,0,2856,426,10,63,96,318
2020,413000262,27200,2400,2400,400,0,24800,23000,23000,0,0,1800,1500,0,300,14875,14875,14875,0,3750,210,10,460,280,85
2020,413000302,10220,2220,2220,2220,0,8000,8000,8000,0,0,0,0,0,0,5284,5284,2000,2944,1827,240,15,72,360,9
2020,413000312,47240,6740,6740,6740,0,40500,40000,40000,0,0,500,500,0,0,0,0,0,0,1800,140,200,200,0,43
2020,413000322,47150,150,150,150,0,47000,46000,40000,6000,0,1000,1000,0,0,8500,0,0,0,974,356,36,120,44,77
2020,413000332,21720,20180,2180,1680,18000,1540,0,0,0,0,1540,1540,0,0,18240,18240,14458,1582,3310,250,200,500,300,63
2020,413000342,35400,400,400,400,0,35000,25000,10000,15000,0,10000,0,10000,0,0,0,0,0,1925,135,780,60,30,35
2020,413000352,27919,6289,6289,6289,0,21630,20000,18000,2000,0,1630,1000,630,0,2000,2000,1500,0,3440,240,100,1200,120,702
2020,413000362,1950,1050,50,50,1000,900,0,0,0,0,900,900,0,0,3400,3400,0,3400,2894,690,36,120,304,54
2020,413000372,32900,100,100,100,0,32800,32000,32000,0,0,800,800,0,0,0,0,0,0,2350,360,30,360,60,244
2020,413600101,31150,30150,30150,30150,0,1000,0,0,0,0,1000,1000,0,0,0,0,0,0,2750,200,300,400,190,194
2020,413600141,24918,24468,4968,4968,19500,450,0,0,0,0,450,450,0,0,15600,15600,15600,0,3776,360,30,240,216,21
2020,413600151,3480,3480,980,980,2500,0,0,0,0,0,0,0,0,0,1000,1000,0,0,3986,306,20,240,480,2
2020,413600161,60590,6090,6090,6090,0,54500,53000,18000,35000,0,1500,1500,0,0,0,0,0,0,2090,120,600,100,100,710
2020,413600191,600,600,100,100,500,0,0,0,0,0,0,0,0,0,0,0,0,0,728,130,120,50,48,11
2020,413600231,2905,605,205,205,400,2300,0,0,0,0,2300,1300,0,1000,270,270,0,0,1321,137,120,25,84,4
2020,413600241,21912,5412,5412,3912,0,16500,15000,15000,0,0,1500,1000,0,500,6464,6464,6464,0,3015,180,100,375,240,225
2020,413600261,25507,307,307,307,0,25200,25000,25000,0,0,200,0,200,0,0,0,0,0,1091,216,70,15,180,35
2020,413600271,181400,14200,14200,14200,0,167200,163000,55000,108000,0,4200,3900,300,0,2940,1940,1940,0,4912,360,155,450,300,377
2020,413600301,26030,30,30,30,0,26000,26000,25000,0,1000,0,0,0,0,0,0,0,0,712,260,50,30,24,18
2020,413600341,7300,4500,200,200,4300,2800,0,0,0,0,2800,500,0,2300,795,795,1,150,1226,360,60,48,108,1
2020,413600351,3100,3100,100,100,3000,0,0,0,0,0,0,0,0,0,2000,2000,0,0,1520,240,10,120,360,1
2020,413600371,40359,9459,9459,9459,0,30900,30000,30000,0,0,900,900,0,0,0,0,0,0,2136,240,720,120,216,52
2020,413600381,13163,163,163,163,0,13000,13000,13000,0,0,0,0,0,0,5000,5000,5000,0,3010,250,500,200,280,95
2020,413600391,97279,22629,22629,19629,0,74650,73000,40000,33000,0,1650,150,500,1000,530,30,0,0,1860,240,100,250,120,73
2020,413700121,98900,43100,11100,11100,32000,55800,55000,0,55000,0,800,800,0,0,3000,0,0,0,1596,240,30,120,156,164
2020,413700161,34892,8942,8942,8942,0,25950,25000,25000,0,0,950,950,0,0,13153,13153,10877,2276,4950,750,250,500,550,49
2020,413700171,19020,19020,3020,3020,16000,0,0,0,0,0,0,0,0,0,0,0,0,0,1350,150,10,180,120,14
2020,413700181,10100,10100,6600,6600,3500,0,0,0,0,0,0,0,0,0,0,0,0,0,936,120,36,48,72,7
2020,413700191,106548,101848,19848,19848,82000,4700,0,0,0,0,4700,4500,200,0,0,0,0,0,4422,420,120,130,192,3502
2020,413700201,36607,5007,5007,5007,0,31600,30200,13200,17000,0,1400,1400,0,0,16430,15430,15400,0,4027,1052,240,200,120,276
2020,413700211,49581,13731,13731,12231,0,35850,30000,27000,3000,0,5850,4350,1000,500,1220,1220,0,0,4030,340,10,550,180,420
2020,413700251,17188,17138,17138,15138,0,50,0,0,0,0,50,0,50,0,0,0,0,0,1932,380,120,120,180,21
2020,413700261,550,550,50,50,500,0,0,0,0,0,0,0,0,0,2000,2000,0,0,990,360,60,60,30,4
2020,413700301,14549,1399,1399,1399,0,13150,13000,13000,0,0,150,150,0,0,4300,4300,2000,0,1180,192,10,168,180,21
2020,413700311,22662,2362,2362,2362,0,20300,18500,18500,0,0,1800,1800,0,0,14200,14200,12000,2000,5508,268,600,720,480,330
2020,413700321,31750,1200,1200,1200,0,30550,30500,18500,12000,0,50,50,0,0,13160,12160,12160,0,2014,360,60,170,108,82
2020,413700341,1200,550,50,50,500,650,0,0,0,0,650,650,0,0,1268,1268,0,0,1643,540,60,204,134,15
2020,413700351,507,507,7,7,500,0,0,0,0,0,0,0,0,0,0,0,0,0,758,396,40,10,12,11
2020,413700361,12120,1560,1560,1560,0,10560,10000,10000,0,0,560,560,0,0,0,0,0,0,1973,180,380,210,48,39
2020,413700381,2580,2580,2080,2080,500,0,0,0,0,0,0,0,0,0,741,741,0,312,1418,540,36,72,240,20
2020,413800101,99383,2433,2433,2433,0,96950,96500,43000,53500,0,450,450,0,0,0,0,0,0,5110,410,550,450,320,1110
2020,413800121,1005,1005,5,5,1000,0,0,0,0,0,0,0,0,0,0,0,0,0,564,84,80,3,15,0
2020,413800131,6510,6510,3310,3310,3200,0,0,0,0,0,0,0,0,0,1000,1000,0,1000,681,180,10,40,36,4
2020,413800141,98684,8384,8384,8384,0,90300,90000,60000,30000,0,300,300,0,0,23550,1550,1500,0,5270,300,20,700,400,69
2020,413800161,58516,16290,16290,16290,0,42226,42000,0,42000,0,226,0,226,0,0,0,0,0,1036,180,30,84,72,47
2020,413800191,92790,7290,7290,7290,0,85500,85000,85000,0,0,500,500,0,0,12150,12150,10000,2000,3090,700,300,100,240,659
2020,413800201,18475,5850,5850,5850,0,12625,12000,12000,0,0,625,580,45,0,575,575,0,500,1982,142,30,258,145,73
2020,413800211,11273,10248,10248,10248,0,1025,0,0,0,0,1025,600,425,0,25,25,0,0,3405,210,10,186,440,41
2020,413800221,50632,22932,22932,17932,0,27700,27000,27000,0,0,700,500,200,0,0,0,0,0,2030,240,30,240,250,66
2020,413800311,79860,7970,7970,7970,0,71890,71440,25000,46440,0,450,450,0,0,18790,18790,18790,0,5118,336,480,565,180,661
2020,413800331,8548,48,48,48,0,8500,8500,8500,0,0,0,0,0,0,0,0,0,0,626,96,6,8,15,7
2020,413800341,540,540,90,90,450,0,0,0,0,0,0,0,0,0,500,500,0,500,2683,360,20,210,360,0
2020,413800351,40663,3590,3590,3590,0,37073,36500,31500,5000,0,573,437,136,0,36,36,0,0,3856,372,120,180,176,45
2020,413800361,54376,20860,20860,20860,0,33516,31500,31500,0,0,2016,1826,190,0,15,15,0,0,5128,369,80,420,188,596
2020,413800371,178000,101000,101000,26000,0,77000,75000,60000,15000,0,2000,2000,0,0,6000,6000,0,0,7090,600,2000,450,240,426
2020,413900101,14900,14900,8400,8400,6500,0,0,0,0,0,0,0,0,0,0,0,0,0,1278,72,10,200,36,397
2020,413900111,59960,4860,4860,3860,0,55100,53000,35000,18000,0,2100,950,150,1000,30510,17510,16710,800,3330,180,350,380,230,106
2020,413900121,3840,3840,1190,1190,2650,0,0,0,0,0,0,0,0,0,0,0,0,0,957,150,30,55,72,5
2020,413900131,30480,480,480,480,0,30000,30000,30000,0,0,0,0,0,0,0,0,0,0,2410,240,50,300,120,35
2020,413900141,28550,550,550,550,0,28000,28000,28000,0,0,0,0,0,0,0,0,0,0,1615,280,350,10,40,18
2020,413900161,10560,10560,560,560,10000,0,0,0,0,0,0,0,0,0,0,0,0,0,826,54,10,30,40,1
2020,413900191,10020,10020,20,20,10000,0,0,0,0,0,0,0,0,0,0,0,0,0,1292,68,600,24,60,2
2020,413900201,1495,1495,95,95,1400,0,0,0,0,0,0,0,0,0,250,250,0,250,1464,290,36,130,112,0
2020,413900221,11070,70,70,70,0,11000,11000,11000,0,0,0,0,0,0,0,0,0,0,623,70,100,10,8,11
2020,413900231,45740,26440,13940,12940,12500,19300,18000,0,18000,0,1300,800,500,0,99,99,0,0,2240,180,230,320,150,226
2020,413900241,15050,50,50,50,0,15000,15000,15000,0,0,0,0,0,0,7000,7000,7000,0,1182,180,120,180,72,15
2020,413900301,205,205,5,5,200,0,0,0,0,0,0,0,0,0,0,0,0,0,639,144,20,15,36,1
2020,413900321,3600,3600,3300,3300,300,0,0,0,0,0,0,0,0,0,2760,2760,2700,0,1367,380,5,48,84,8
2020,413900331,14352,1352,1352,1352,0,13000,13000,13000,0,0,0,0,0,0,2500,2500,2500,0,522,166,36,0,50,15
2020,413900351,375,235,35,35,200,140,0,0,0,0,140,140,0,0,1700,1700,0,1700,2546,504,50,360,120,60
2020,413900381,7507,7507,7,7,7500,0,0,0,0,0,0,0,0,0,0,0,0,0,494,48,120,24,38,2
2020,413900391,49210,4610,4610,4610,0,44600,44000,44000,0,0,600,600,0,0,0,0,0,0,4090,300,240,840,120,87
2020,414000102,20800,20700,700,700,20000,100,0,0,0,0,100,100,0,0,9060,9060,5000,4000,1950,122,35,50,288,244
2020,414000112,97500,65300,7300,7300,58000,32200,30000,0,0,30000,2200,2200,0,0,10000,10000,0,0,2560,200,100,120,150,901
2020,414000142,161000,6000,6000,1000,0,155000,110000,110000,0,0,45000,0,5000,40000,24000,24000,10000,7000,1286,396,10,120,60,3626
2020,414000172,3110,3110,110,110,3000,0,0,0,0,0,0,0,0,0,0,0,0,0,2997,588,10,240,154,1
2020,414000182,9122,6122,5122,5122,1000,3000,0,0,0,0,3000,3000,0,0,1616,1616,0,1600,3056,480,100,204,142,87
2020,414000192,17562,2062,2062,2062,0,15500,15500,15500,0,0,0,0,0,0,4000,4000,3700,300,1532,132,5,125,62,102
2020,414000332,91870,14870,14870,7370,0,77000,37000,22000,15000,0,40000,15000,25000,0,54750,54750,7000,33000,4634,300,50,434,600,1951
2020,414000342,22620,1770,1270,1270,500,20850,20000,0,20000,0,850,850,0,0,6500,4500,4500,0,1177,567,10,45,60,27
2020,414000352,27978,6628,6628,3628,0,21350,20000,20000,0,0,1350,250,1100,0,13350,13350,13350,0,2997,364,122,364,121,359
2020,414000362,57100,26900,26900,1900,0,30200,30000,30000,0,0,200,200,0,0,9700,9700,9600,0,4140,180,120,960,360,70
2020,414000372,730100,29000,29000,29000,0,701100,700000,90000,610000,0,1100,500,600,0,7000,0,0,0,7100,300,1700,150,194,196
2020,414000392,43996,3396,3396,3396,0,40600,31500,31500,0,0,9100,1600,0,7500,0,0,0,0,3638,241,1405,85,181,49
2020,414600101,41390,40590,6590,6590,34000,800,0,0,0,0,800,800,0,0,100,100,0,0,4440,420,120,240,240,3215
2020,414600131,26280,280,280,280,0,26000,26000,26000,0,0,0,0,0,0,0,0,0,0,750,120,20,40,60,23
2020,414600141,59610,610,610,610,0,59000,59000,59000,0,0,0,0,0,0,1000,0,0,0,2480,220,200,100,180,95
2020,414600151,530,530,30,30,500,0,0,0,0,0,0,0,0,0,0,0,0,0,1170,260,100,90,110,2
2020,414600161,41230,6170,6170,6170,0,35060,35000,35000,0,0,60,0,60,0,0,0,0,0,1176,240,120,48,48,178
2020,414600171,54694,3544,3544,3544,0,51150,51000,51000,0,0,150,150,0,0,4203,4203,4203,0,2395,380,90,130,80,47
2020,414600301,25500,500,500,500,0,25000,25000,25000,0,0,0,0,0,0,6136,6136,5336,0,1380,240,100,100,100,29
2020,414600311,112090,1840,1840,1840,0,110250,110000,110000,0,0,250,250,0,0,400,400,0,400,3340,430,120,550,250,508
2020,414600331,910,610,610,610,0,300,0,0,0,0,300,300,0,0,0,0,0,0,1250,100,50,70,120,18
2020,414600351,55,55,55,55,0,0,0,0,0,0,0,0,0,0,0,0,0,0,1246,240,20,30,96,1
2020,414600361,623860,103360,103360,103360,0,520500,500000,100000,400000,0,20500,18500,2000,0,300000,150000,150000,0,8000,500,50,800,480,4211
2020,414600371,88840,3714,3714,3214,0,85126,83000,35000,48000,0,2126,1900,226,0,4000,3500,3500,0,3792,192,60,360,300,55
2020,414600381,17496,16846,1846,1846,15000,650,0,0,0,0,650,650,0,0,12000,12000,12000,0,2256,288,60,240,336,34
2020,414600391,75980,9280,9280,9280,0,66700,49000,19000,30000,0,17700,2700,15000,0,6100,6100,6100,0,1509,114,10,50,180,74
2020,414700121,196528,5000,5000,5000,0,191528,172178,93000,79178,0,19350,2950,8700,7700,1193,213,0,0,2438,310,950,120,240,511
2020,414700131,203670,3300,3300,3300,0,200370,200000,120000,80000,0,370,250,120,0,55500,18500,10000,8500,4580,360,120,240,300,1197
2020,414700181,27790,26990,1990,1990,25000,800,0,0,0,0,800,600,200,0,25000,25000,17000,8000,2200,180,300,360,210,224
2020,414700311,34254,30004,3004,3004,27000,4250,0,0,0,0,4250,3850,400,0,26000,26000,20000,6000,5078,360,24,120,300,15
2020,414700351,199045,20665,20665,20665,0,178380,165000,100000,65000,0,13380,3380,10000,0,40000,0,0,0,13866,1220,507,1310,364,1997
2020,414700361,69710,30910,30910,30910,0,38800,37200,37200,0,0,1600,1600,0,0,40,40,0,0,2938,300,60,358,230,153
2020,414700381,22825,22025,4025,2025,18000,800,0,0,0,0,800,800,0,0,5800,5800,5000,800,2800,300,500,200,150,222
2020,414800141,70330,23080,22530,12030,550,47250,45000,0,45000,0,2250,0,250,2000,0,0,0,0,3793,492,570,324,204,32
2020,414800151,4424,4324,3324,2534,1000,100,0,0,0,0,100,100,0,0,3495,3495,0,3495,2704,288,36,374,276,50
2020,414800161,76120,26120,1120,1120,25000,50000,50000,0,50000,0,0,0,0,0,3000,0,0,0,2198,240,1000,30,28,62
2020,414800171,5760,5580,3280,3280,2300,180,0,0,0,0,180,180,0,0,1000,1000,1000,0,2422,432,70,300,120,24
2020,414800181,195551,17541,17541,17541,0,178010,176880,80000,96880,0,1130,0,1130,0,54194,38194,38194,0,5640,240,300,260,300,841
2020,414800191,3800,1000,500,500,500,2800,0,0,0,0,2800,2800,0,0,4300,4300,0,1370,1890,610,50,300,150,131
2020,414800301,38552,22626,6626,6626,16000,15926,14000,0,14000,0,1926,1700,226,0,8000,8000,7800,0,5568,420,300,432,276,2945
2020,414800321,92680,38380,38380,18380,0,54300,53000,50000,3000,0,1300,700,600,0,24300,24300,23800,500,3680,420,100,660,420,276
2020,414800341,32592,6992,6992,6992,0,25600,25000,25000,0,0,600,600,0,0,8860,8860,8740,0,3250,200,50,200,300,129
2020,414800351,127450,21140,21140,19540,0,106310,105000,60000,45000,0,1310,1310,0,0,93100,91100,75250,15600,5480,600,120,500,360,6248
2020,414800391,61202,2202,2202,2202,0,59000,59000,9000,50000,0,0,0,0,0,5000,5000,5000,0,1785,380,500,200,85,131
2020,414900101,5658,5658,2658,2658,3000,0,0,0,0,0,0,0,0,0,1180,1180,1180,0,1410,500,10,120,130,43
2020,414900111,9160,1160,1160,1160,0,8000,8000,8000,0,0,0,0,0,0,0,0,0,0,2470,120,10,80,100,74
2020,414900121,10080,80,80,80,0,10000,10000,10000,0,0,0,0,0,0,0,0,0,0,905,100,80,30,60,11
2020,414900141,38150,150,150,150,0,38000,38000,38000,0,0,0,0,0,0,15000,0,0,0,636,120,60,36,60,30
2020,414900311,88950,8550,8550,8550,0,80400,79000,70000,9000,0,1400,400,1000,0,60,60,0,0,9029,540,794,216,204,6524
2020,414900321,33140,11290,11290,11290,0,21850,21000,21000,0,0,850,850,0,0,50,50,0,0,4626,364,208,365,288,238
2020,414900371,55560,21560,21560,21560,0,34000,34000,34000,0,0,0,0,0,0,0,0,0,0,2162,372,192,240,38,65
2020,415000122,32300,300,300,300,0,32000,30000,30000,0,0,2000,2000,0,0,0,0,0,0,2510,240,50,360,300,126
2020,415000132,145010,19810,19810,8810,0,125200,125000,90000,35000,0,200,200,0,0,63500,35500,33500,2000,4730,480,500,350,240,829
2020,415000152,660,660,500,500,160,0,0,0,0,0,0,0,0,0,0,0,0,0,560,132,20,20,138,1
2020,415000162,212680,32630,32630,12630,0,180050,173000,143000,30000,0,7050,250,6800,0,25000,0,0,0,7420,600,270,1200,330,644
2020,415000302,27813,2733,2733,2733,0,25080,25000,25000,0,0,80,80,0,0,12100,12100,12000,0,2312,396,30,108,308,41
2020,415000312,22200,200,200,200,0,22000,22000,22000,0,0,0,0,0,0,0,0,0,0,629,180,10,3,36,2
2020,415000342,56020,53720,27720,27720,26000,2300,0,0,0,0,2300,1800,500,0,0,0,0,0,3588,336,12,240,240,814
2020,415000352,17560,1560,1560,1560,0,16000,14500,14500,0,0,1500,1500,0,0,20000,20000,12000,8000,4957,267,200,720,180,47
2020,415000362,24540,5340,5340,5340,0,19200,18000,18000,0,0,1200,1200,0,0,18,18,0,0,2050,200,730,60,210,61
2020,415000382,3901,3401,3101,3101,300,500,0,0,0,0,500,500,0,0,2165,2165,0,1915,1920,500,20,120,180,18
2020,415000392,33600,600,600,600,0,33000,33000,33000,0,0,0,0,0,0,12000,0,0,0,1122,567,250,0,0,46
2020,415600131,116390,6840,6840,6840,0,109550,105000,50000,55000,0,4550,2550,0,2000,36870,33870,33870,0,1764,240,700,240,144,164
2020,415600141,82942,11762,11762,6762,0,71180,71000,14000,57000,0,180,0,180,0,5010,10,0,0,2246,150,200,140,112,125
2020,415600191,2410,2410,410,410,2000,0,0,0,0,0,0,0,0,0,90,90,90,0,934,240,30,24,72,7
2020,415600301,63454,23204,9204,9204,14000,40250,39250,0,39250,0,1000,1000,0,0,28000,27000,27000,0,5780,240,100,900,360,1482
2020,415600311,117728,21928,21928,16928,0,95800,93000,32000,61000,0,2800,2200,600,0,0,0,0,0,1640,300,100,60,120,216
2020,415600321,828,76,76,76,0,752,0,0,0,0,752,707,45,0,8010,8010,7510,0,4325,180,366,323,456,59
2020,415600351,730,650,150,150,500,80,0,0,0,0,80,80,0,0,240,240,0,0,1898,480,260,300,84,36
2020,415600371,629,609,109,109,500,20,0,0,0,0,20,0,20,0,5230,5230,0,3750,2701,428,611,148,363,7
2020,415600381,38610,4000,4000,4000,0,34610,34000,34000,0,0,610,270,340,0,0,0,0,0,1865,360,96,250,114,153
2020,415600391,544180,392180,392180,382180,0,152000,85000,70000,15000,0,67000,21000,46000,0,0,0,0,0,7600,600,60,1200,204,1364
2020,415700101,142000,12000,12000,12000,0,130000,130000,100000,30000,0,0,0,0,0,10000,0,0,0,2420,420,360,100,60,576
2020,415700121,28020,2520,2520,2520,0,25500,25000,12000,13000,0,500,500,0,0,0,0,0,0,1950,100,300,200,60,38
2020,415700141,92226,1000,1000,1000,0,91226,91000,51000,40000,0,226,0,226,0,1350,50,0,0,946,120,60,55,46,116
2020,415700171,157028,21452,21452,21452,0,135576,134600,45000,65000,24600,976,750,226,0,55260,49760,10000,19760,4199,192,36,312,218,245
2020,415700191,4777,4777,1277,1277,3500,0,0,0,0,0,0,0,0,0,200,200,0,0,620,120,60,20,60,1
2020,415700301,1004,1004,4,4,1000,0,0,0,0,0,0,0,0,0,0,0,0,0,3000,180,20,120,180,1
2020,415700321,176670,21070,21070,21070,0,155600,151000,58000,93000,0,4600,4100,500,0,65500,61500,61500,0,6855,450,120,500,350,6000
2020,415700331,79850,12850,12850,12850,0,67000,65000,65000,0,0,2000,2000,0,0,0,0,0,0,1901,396,35,180,150,117
2020,415700361,2215,315,15,15,300,1900,0,0,0,0,1900,1900,0,0,5400,5400,0,3500,1667,434,21,180,144,76
2020,415700371,3984,3984,2984,2984,1000,0,0,0,0,0,0,0,0,0,0,0,0,0,2255,800,15,70,150,1
2020,415700391,2972,2972,872,872,2100,0,0,0,0,0,0,0,0,0,2760,2760,2700,0,538,108,18,36,6,3
2020,415800101,920,920,620,620,300,0,0,0,0,0,0,0,0,0,0,0,0,0,1930,600,10,240,120,2
2020,415800111,60550,550,550,550,0,60000,60000,60000,0,0,0,0,0,0,0,0,0,0,598,324,70,10,24,60
2020,415800131,49164,19584,19584,19584,0,29580,29000,26000,3000,0,580,530,50,0,0,0,0,0,3767,154,100,540,240,131
2020,415800141,48610,3360,3360,3360,0,45250,45000,45000,0,0,250,250,0,0,14000,0,0,0,2836,360,32,240,144,48
2020,415800171,125220,30220,5220,5220,25000,95000,95000,0,95000,0,0,0,0,0,6900,0,0,0,958,208,420,50,60,603
2020,415800191,108070,88070,8070,8070,80000,20000,20000,0,20000,0,0,0,0,0,4000,0,0,0,1545,360,100,10,15,111
2020,415800301,282550,22000,22000,22000,0,260550,260000,10000,250000,0,550,300,250,0,0,0,0,0,2086,450,120,250,180,219
2020,415800351,28470,7470,7470,6670,0,21000,21000,15000,0,6000,0,0,0,0,0,0,0,0,768,180,60,120,82,23
2020,415800371,2840,2840,40,40,2800,0,0,0,0,0,0,0,0,0,2110,2110,1100,0,1578,396,192,120,60,1
2020,415800381,210372,24822,24822,24822,0,185550,182000,31000,151000,0,3550,3550,0,0,67900,64400,59000,5400,4893,910,1200,950,136,691
2020,415800391,55460,210,210,210,0,55250,55000,35000,20000,0,250,250,0,0,1000,0,0,0,3180,190,120,450,150,193
2020,415900101,16990,14880,2880,2880,12000,2110,0,0,0,0,2110,1360,750,0,5750,5750,5000,0,3519,181,100,200,342,100
2020,415900111,58916,6616,6616,6616,0,52300,50000,50000,0,0,2300,2300,0,0,4500,4500,4000,500,3409,150,200,90,100,183
2020,415900121,7710,7700,2700,2700,5000,10,0,0,0,0,10,10,0,0,0,0,0,0,1100,120,50,60,60,27
2020,415900131,6371,6371,871,871,5500,0,0,0,0,0,0,0,0,0,980,980,0,980,1457,120,21,48,108,13
2020,415900151,8100,8100,1000,1000,7100,0,0,0,0,0,0,0,0,0,0,0,0,0,827,312,120,60,23,1
2020,415900311,29690,1390,1390,390,0,28300,26000,26000,0,0,2300,2300,0,0,19168,19168,18568,600,6820,720,60,120,300,381
2020,415900321,49780,9930,9930,9930,0,39850,38000,26000,12000,0,1850,1700,150,0,1000,0,0,0,2350,360,60,360,240,750
2020,415900331,53844,3444,3444,2944,0,50400,48000,20000,28000,0,2400,1500,600,300,22000,2000,0,2000,2850,450,120,150,180,41
2020,415900341,73523,17210,17210,15210,0,56313,50000,50000,0,0,6313,4200,113,2000,2000,2000,0,2000,6309,516,1600,330,290,1279
2020,415900351,32930,3630,3630,3630,0,29300,29000,29000,0,0,300,300,0,0,200,0,0,0,4450,500,450,400,300,708
2020,415900371,45460,17300,17300,9300,0,28160,17000,17000,0,0,11160,1160,0,10000,2000,2000,0,2000,2130,180,200,500,90,143
2020,415900391,1080,1080,80,80,1000,0,0,0,0,0,0,0,0,0,5230,5230,0,3100,3100,600,250,130,255,374
2020,416000102,1290,1290,290,290,1000,0,0,0,0,0,0,0,0,0,270,270,0,0,1520,500,120,20,80,7
2020,416000112,15860,15860,11860,11860,4000,0,0,0,0,0,0,0,0,0,270,270,0,0,4005,140,350,325,360,5
2020,416000122,25418,7268,7268,7268,0,18150,18000,18000,0,0,150,150,0,0,3080,3080,0,3000,3059,330,30,120,240,448
2020,416000132,4180,4180,3680,3680,500,0,0,0,0,0,0,0,0,0,500,500,0,0,2044,612,70,24,120,1
2020,416000142,20362,20362,1362,1362,19000,0,0,0,0,0,0,0,0,0,4000,4000,0,0,602,180,10,72,80,13
2020,416000152,25564,22764,21264,16264,1500,2800,0,0,0,0,2800,2800,0,0,3000,3000,0,3000,3195,1200,50,60,120,747
2020,416000162,36840,36140,7640,7640,28500,700,0,0,0,0,700,700,0,0,18000,18000,0,18000,1962,300,2,360,100,436
2020,416000172,37722,9722,9722,9722,0,28000,25000,25000,0,0,3000,3000,0,0,9500,9500,9300,200,2314,360,30,240,144,68
2020,416000302,94436,11210,11210,11210,0,83226,81500,42000,39500,0,1726,1500,226,0,606,606,0,0,4218,480,30,504,228,168
2020,416000322,121310,42310,9310,9310,33000,79000,75000,0,75000,0,4000,4000,0,0,33586,586,0,586,2822,300,300,420,240,786
2020,416000332,90800,800,800,800,0,90000,90000,50000,40000,0,0,0,0,0,3000,0,0,0,2752,336,50,40,96,65
2020,416000342,57200,1200,1200,1200,0,56000,56000,56000,0,0,0,0,0,0,0,0,0,0,1894,240,350,60,90,196
2020,416000352,61310,3920,3920,3920,0,57390,56000,56000,0,0,1390,1390,0,0,0,0,0,0,2811,300,350,120,48,451
2020,416000362,80705,8790,8790,8790,0,71915,68000,51000,17000,0,3915,3915,0,0,9500,0,0,0,6816,420,500,900,300,190
2020,416000372,143240,53040,53040,53040,0,90200,85000,60000,25000,0,5200,5200,0,0,2000,0,0,0,8880,480,1420,1020,240,1852
2020,416000382,242580,580,580,580,0,242000,240000,75000,165000,0,2000,2000,0,0,94500,80500,80000,0,5340,600,240,600,180,1096
2020,416000392,50738,1468,1468,1468,0,49270,44130,4530,39600,0,5140,1500,3640,0,17400,17400,17400,0,3922,276,366,576,312,271
2020,416600111,9140,9140,7140,7140,2000,0,0,0,0,0,0,0,0,0,100,100,0,100,2060,720,50,60,80,611
2020,416600141,16820,12420,2420,2420,10000,4400,0,0,0,0,4400,4400,0,0,3000,3000,0,0,3057,180,80,156,276,66
2020,416600151,71204,6804,6804,5804,0,64400,64000,64000,0,0,400,400,0,0,2516,2516,2516,0,2214,480,120,240,144,117
2020,416600161,81896,1896,1896,1896,0,80000,80000,80000,0,0,0,0,0,0,0,0,0,0,1018,300,30,20,48,106
2020,416600171,149823,79823,4823,4823,75000,70000,70000,0,70000,0,0,0,0,0,65000,30000,10000,0,2838,408,120,30,60,53
2020,416600181,89664,29564,29564,29564,0,60100,60000,60000,0,0,100,100,0,0,0,0,0,0,1414,240,70,110,64,1881
2020,416600311,113955,3075,2475,2475,600,110880,110000,0,110000,0,880,880,0,0,31090,14090,14000,0,3550,660,250,600,240,182
2020,416600321,350,150,150,150,0,200,0,0,0,0,200,200,0,0,0,0,0,0,2120,350,57,720,84,89
2020,416600331,38162,162,162,162,0,38000,34000,0,34000,0,4000,4000,0,0,22930,22930,19730,0,3020,340,90,200,120,46
2020,416600351,53610,1510,1510,1510,0,52100,48500,40000,8500,0,3600,3600,0,0,0,0,0,0,4760,600,200,960,500,505
2020,416700101,10580,3780,2580,2580,1200,6800,0,0,0,0,6800,6800,0,0,13100,13100,0,13100,3756,480,360,240,240,482
2020,416700111,6196,6196,1196,1196,5000,0,0,0,0,0,0,0,0,0,0,0,0,0,1067,138,300,60,264,1
2020,416700121,540,540,40,40,500,0,0,0,0,0,0,0,0,0,0,0,0,0,761,327,100,60,24,1
2020,416700131,104263,9263,9263,9263,0,95000,95000,45000,50000,0,0,0,0,0,10000,0,0,0,1824,200,700,120,84,141
2020,416700151,2032,2032,1032,1032,1000,0,0,0,0,0,0,0,0,0,0,0,0,0,3145,720,20,40,95,69
2020,416700161,7415,7415,1915,1915,5500,0,0,0,0,0,0,0,0,0,2980,2980,1000,0,872,84,270,60,48,1
2020,416700181,74860,33260,8260,6260,25000,41600,40000,0,0,40000,1600,1500,100,0,0,0,0,0,2129,136,300,300,148,199
2020,416700301,81763,41413,13413,13413,28000,40350,40000,0,40000,0,350,350,0,0,46000,46000,20000,0,2316,216,120,204,84,139
2020,416700341,45261,2261,2261,2261,0,43000,43000,43000,0,0,0,0,0,0,0,0,0,0,909,162,10,3,24,48
2020,416700361,76378,18878,18878,15878,0,57500,52000,20000,32000,0,5500,2500,2000,1000,1000,0,0,0,1252,280,200,200,100,192
2020,416700391,35923,28616,10616,10616,18000,7307,6000,0,6000,0,1307,1307,0,0,8100,1600,1600,0,2518,180,70,126,192,179
2020,416800131,36170,1170,1170,1170,0,35000,35000,35000,0,0,0,0,0,0,0,0,0,0,1880,180,300,240,120,44
2020,416800141,10057,10057,6057,6057,4000,0,0,0,0,0,0,0,0,0,143,143,0,0,1110,276,80,84,60,7
2020,416800171,320,320,20,20,300,0,0,0,0,0,0,0,0,0,3330,3330,0,3330,1792,456,300,60,120,121
2020,416800181,2272,2272,1272,1272,1000,0,0,0,0,0,0,0,0,0,0,0,0,0,1430,700,0,100,120,26
2020,416800191,88790,18000,18000,13000,0,70790,70000,55000,15000,0,790,700,90,0,20030,20030,20000,0,1221,272,150,84,120,157
2020,416800301,21166,2416,2416,2416,0,18750,17500,17500,0,0,1250,1250,0,0,500,500,0,500,3400,240,30,250,240,782
2020,416800311,815,815,15,15,800,0,0,0,0,0,0,0,0,0,0,0,0,0,596,252,120,60,24,1
2020,416800321,803,803,3,3,800,0,0,0,0,0,0,0,0,0,0,0,0,0,444,228,12,0,12,1
2020,416800331,1164840,937840,937840,937840,0,227000,190000,80000,110000,0,37000,7000,30000,0,38000,0,0,0,8000,1000,500,800,200,3254
2020,416800341,5,5,5,5,0,0,0,0,0,0,0,0,0,0,0,0,0,0,303,24,18,5,0,1
2020,416800351,4395,4325,1965,1965,2360,70,0,0,0,0,70,0,70,0,2360,2360,2360,0,1327,389,10,120,120,14
2020,416800361,41030,2230,2230,2230,0,38800,35000,35000,0,0,3800,3800,0,0,6910,6910,6910,0,4092,250,220,542,140,446
2020,416800371,29875,3875,3875,3875,0,26000,26000,26000,0,0,0,0,0,0,90,90,0,0,2608,240,200,240,96,381
2020,416800381,110980,400,400,400,0,110580,110000,100000,10000,0,580,580,0,0,21729,21729,21729,0,2692,360,1000,600,72,341
2020,416800391,20970,18270,2770,1270,15500,2700,0,0,0,0,2700,2700,0,0,32000,32000,32000,0,2306,500,500,480,96,144
2020,416900121,2148,2148,1248,1248,900,0,0,0,0,0,0,0,0,0,45,45,0,0,2361,312,5,300,420,56
2020,416900151,103,103,3,3,100,0,0,0,0,0,0,0,0,0,800,800,0,600,590,256,14,10,48,1
2020,416900161,254900,103800,43800,43800,60000,151100,150000,0,150000,0,1100,1100,0,0,10076,0,0,0,4130,480,200,400,300,413
2020,416900171,45620,962,962,962,0,44658,44500,44500,0,0,158,0,158,0,19700,19700,19700,0,4530,120,50,240,240,35
2020,416900181,72820,2820,2820,820,0,70000,70000,70000,0,0,0,0,0,0,14000,12000,12000,0,2854,216,500,120,408,288
2020,416900191,107200,32200,32200,32200,0,75000,75000,70000,5000,0,0,0,0,0,0,0,0,0,970,360,10,15,20,283
2020,416900301,59198,14572,2572,2572,12000,44626,29500,0,0,29500,15126,1900,226,13000,0,0,0,0,2790,404,780,90,50,124
2020,416900321,98266,13100,13100,13100,0,85166,78000,50000,28000,0,7166,7000,166,0,51813,33813,6000,24413,6038,300,120,360,180,1080
2020,416900331,7580,6680,2680,2680,4000,900,0,0,0,0,900,900,0,0,2539,2539,2539,0,4236,720,240,480,216,314
2020,416900351,80369,12879,12879,10879,0,67490,64500,60000,0,4500,2990,2990,0,0,15630,15630,15430,200,7868,372,800,600,216,2258
2020,416900361,65308,5608,5608,5608,0,59700,58000,50000,8000,0,1700,400,1300,0,4800,0,0,0,2680,300,20,300,96,957
2020,416900371,72450,9250,9250,9250,0,63200,59000,59000,0,0,4200,4000,200,0,18060,18060,17100,900,4790,250,100,500,240,426
2020,417000102,50200,200,200,200,0,50000,50000,50000,0,0,0,0,0,0,22970,470,0,0,1012,132,360,72,96,61
2020,417000122,32798,1098,1098,1098,0,31700,30000,30000,0,0,1700,1700,0,0,6000,6000,6000,0,2094,128,80,200,216,103
2020,417000132,130300,300,300,300,0,130000,130000,130000,0,0,0,0,0,0,0,0,0,0,2810,600,360,50,100,183
2020,417000142,290500,29000,29000,25000,0,261500,260000,130000,130000,0,1500,1000,500,0,10000,0,0,0,7150,500,500,1000,250,5549
2020,417000152,71180,5680,5680,5680,0,65500,65000,55000,10000,0,500,500,0,0,12500,12000,12000,0,4320,360,60,180,156,1487
2020,417000162,50105,5,5,5,0,50100,50000,50000,0,0,100,0,100,0,3030,3030,3000,0,1415,166,260,120,120,46
2020,417000172,3062,3062,62,62,3000,0,0,0,0,0,0,0,0,0,0,0,0,0,1402,690,30,36,36,0
2020,417000182,16435,335,335,335,0,16100,16000,16000,0,0,100,100,0,0,0,0,0,0,2260,180,1100,90,50,67
2020,417000192,22500,2500,2500,2500,0,20000,20000,10000,10000,0,0,0,0,0,3000,0,0,0,1402,208,500,36,78,70
2020,417000302,11654,9984,2484,2484,7500,1670,0,0,0,0,1670,1670,0,0,12530,12530,0,12480,3556,936,120,400,240,51
2020,417000312,9777,8827,1027,1027,7800,950,0,0,0,0,950,950,0,0,7020,7020,6000,1000,3817,864,25,273,242,74
2020,417000322,58848,23348,23348,23348,0,35500,34500,29500,2000,3000,1000,500,500,0,10600,10600,10600,0,3170,220,10,420,180,282
2020,417000332,18700,700,700,700,0,18000,18000,6000,12000,0,0,0,0,0,0,0,0,0,1391,216,600,72,20,15
2020,417000342,14050,50,50,50,0,14000,14000,0,14000,0,0,0,0,0,3000,3000,3000,0,479,144,10,20,24,10
2020,417000352,51550,19950,19950,19950,0,31600,30900,30900,0,0,700,700,0,0,1600,1600,1600,0,5468,228,360,300,360,417
2020,417000362,36780,5180,5180,4680,0,31600,31000,31000,0,0,600,600,0,0,12389,12389,0,12389,5500,360,350,660,180,347
2020,417000372,55712,12712,12712,12712,0,43000,43000,43000,0,0,0,0,0,0,0,0,0,0,2440,240,100,72,120,293
2020,417000382,53140,2140,2140,2140,0,51000,50000,50000,0,0,1000,1000,0,0,8000,8000,8000,0,5380,300,100,240,240,1009
2020,417000392,14500,500,500,500,0,14000,14000,14000,0,0,0,0,0,0,0,0,0,0,1154,276,6,84,120,1
2020,417600141,17290,16890,1890,1890,15000,400,0,0,0,0,400,400,0,0,0,0,0,0,3380,200,80,240,310,58
2020,417600151,9970,9970,8470,8470,1500,0,0,0,0,0,0,0,0,0,0,0,0,0,2360,540,300,180,60,16
2020,417600161,158760,35260,35260,35260,0,123500,120000,120000,0,0,3500,3500,0,0,36400,36400,36400,0,6962,480,50,560,216,1451
2020,417600171,91000,1000,1000,1000,0,90000,90000,90000,0,0,0,0,0,0,40,40,0,0,1590,240,200,60,60,131
2020,417600191,23616,22790,10840,10840,11950,826,0,0,0,0,826,600,226,0,0,0,0,0,1404,204,240,100,192,20
2020,417600301,20170,19570,570,570,19000,600,0,0,0,0,600,600,0,0,8000,8000,6000,0,3930,480,240,120,320,105
2020,417600341,6930,6830,4130,4130,2700,100,0,0,0,0,100,100,0,0,0,0,0,0,1428,260,120,150,48,1
2020,417600361,22402,1402,1402,1402,0,21000,21000,6000,15000,0,0,0,0,0,0,0,0,0,538,168,100,33,42,29
2020,417600391,22498,16921,4921,4921,12000,5577,2777,0,0,2777,2800,800,2000,0,4800,4800,4800,0,3020,200,120,400,200,122
2020,417700101,2150,2150,150,150,2000,0,0,0,0,0,0,0,0,0,0,0,0,0,924,60,36,96,96,1
2020,417700111,17110,10010,10,10,10000,7100,5000,0,5000,0,2100,2100,0,0,10110,10110,7500,0,1712,240,40,60,72,71
2020,417700131,3517,3517,3517,3517,0,0,0,0,0,0,0,0,0,0,0,0,0,0,2410,102,10,180,264,0
2020,417700151,53440,1640,1640,1640,0,51800,49000,14000,35000,0,2800,2800,0,0,15060,60,0,0,2486,174,300,480,252,236
2020,417700171,57200,6900,6900,6900,0,50300,50000,50000,0,0,300,300,0,0,13155,13155,12155,1000,3994,300,50,240,54,122
2020,417700321,1962,1962,962,962,1000,0,0,0,0,0,0,0,0,0,11,11,0,0,2392,1020,36,48,132,15
2020,417700331,45210,4740,4740,2740,0,40470,38800,13800,25000,0,1670,170,1500,0,20000,20000,20000,0,3480,600,100,400,240,65
2020,417700341,15,15,15,15,0,0,0,0,0,0,0,0,0,0,5000,5000,0,0,1039,95,60,300,40,1
2020,417700351,14450,2500,2500,2500,0,11950,10750,7000,3750,0,1200,1200,0,0,0,0,0,0,1804,110,200,300,144,62
2020,417700361,18734,3234,3234,3234,0,15500,13000,13000,0,0,2500,2500,0,0,5000,5000,3300,1700,2547,300,30,960,216,151
2020,417700381,26189,689,689,689,0,25500,25000,25000,0,0,500,500,0,0,14300,14300,14300,0,1446,216,60,135,145,67
2020,417800101,35492,21492,1492,1492,20000,14000,12000,0,12000,0,2000,2000,0,0,4000,4000,0,2000,1659,197,10,188,144,59
2020,417800111,47600,37100,10100,10100,27000,10500,10000,0,10000,0,500,500,0,0,21000,21000,19000,2000,6230,200,200,1000,30,374
2020,417800141,200676,7176,7176,6696,0,193500,190000,190000,0,0,3500,3500,0,0,0,0,0,0,7320,360,120,240,180,1163
2020,417800151,254470,45470,45470,45470,0,209000,200000,200000,0,0,9000,9000,0,0,97000,97000,77000,20000,11740,400,200,300,240,5101
2020,417800161,10,10,10,10,0,0,0,0,0,0,0,0,0,0,0,0,0,0,956,126,36,12,42,1
2020,417800171,13030,11630,6630,6630,5000,1400,0,0,0,0,1400,1400,0,0,4700,4700,3500,0,4330,1020,200,200,240,51
2020,417800191,2020,2020,20,20,2000,0,0,0,0,0,0,0,0,0,0,0,0,0,1354,564,20,50,60,42
2020,417800301,4287,3687,1592,1592,2095,600,0,0,0,0,600,600,0,0,301,301,0,0,2338,392,50,360,240,13
2020,417800331,79244,15244,15244,15244,0,64000,50000,30000,20000,0,14000,800,200,13000,0,0,0,0,2570,200,100,800,50,1559
2020,417800341,27711,10911,2411,2411,8500,16800,15000,0,15000,0,1800,1800,0,0,9100,9100,9100,0,2280,180,30,240,180,88
2020,417800371,89216,4090,4090,4090,0,85126,84000,36000,48000,0,1126,900,226,0,12900,12900,11000,1900,2660,290,500,200,120,193
2020,417800381,650,650,150,150,500,0,0,0,0,0,0,0,0,0,0,0,0,0,494,300,30,15,12,1
2020,417800391,10945,545,545,545,0,10400,10000,10000,0,0,400,400,0,0,300,0,0,0,1460,250,60,170,90,67
2020,417900111,69949,4726,4726,4706,0,65223,65000,65000,0,0,223,200,23,0,400,400,0,400,2638,480,30,100,108,293
2020,417900121,6005,6005,5,5,6000,0,0,0,0,0,0,0,0,0,100,100,0,100,680,36,36,0,26,1
2020,417900151,1120,1000,800,800,200,120,0,0,0,0,120,120,0,0,0,0,0,0,474,96,5,60,120,8
2020,417900161,2000,2000,1000,1000,1000,0,0,0,0,0,0,0,0,0,0,0,0,0,852,372,30,20,17,11
2020,417900171,61430,60730,7730,7730,53000,700,0,0,0,0,700,700,0,0,0,0,0,0,6540,500,500,200,240,701
2020,417900181,272200,48900,48900,31400,0,223300,223000,100000,123000,0,300,300,0,0,0,0,0,0,2920,300,500,200,120,1120
2020,417900311,525,325,325,325,0,200,0,0,0,0,200,200,0,0,790,790,0,440,1232,10,120,120,192,15
2020,417900321,2185,2185,385,385,1800,0,0,0,0,0,0,0,0,0,0,0,0,0,1329,412,36,8,54,1
2020,417900331,2044,1894,94,94,1800,150,0,0,0,0,150,150,0,0,2276,2276,1400,0,1431,264,96,240,60,58
2020,417900341,295583,32833,32833,32833,0,262750,260000,50000,210000,0,2750,2750,0,0,59000,47000,47000,0,9510,600,300,1230,240,2190
2020,417900351,146464,16384,16384,16384,0,130080,130000,50000,80000,0,80,80,0,0,47000,44000,44000,0,5995,610,1100,480,386,6052
2020,417900361,31510,7560,7560,7560,0,23950,23000,23000,0,0,950,950,0,0,30,30,0,0,2728,360,240,480,120,186
2020,417900371,81816,4526,4526,4526,0,77290,76000,36000,40000,0,1290,490,800,0,18000,0,0,0,1634,360,12,72,96,130
2020,417900381,6000,6000,3000,3000,3000,0,0,0,0,0,0,0,0,0,0,0,0,0,1628,930,10,30,28,4
2020,417900391,75550,50,50,50,0,75500,75000,35000,40000,0,500,500,0,0,22300,22300,20300,2000,2280,130,360,300,180,59
2020,418000102,7030,7030,30,30,7000,0,0,0,0,0,0,0,0,0,0,0,0,0,600,60,0,120,60,2
2020,418000112,16330,16330,4330,3930,12000,0,0,0,0,0,0,0,0,0,10500,10500,9900,400,1618,120,60,144,120,74
2020,418000122,2430,2430,930,930,1500,0,0,0,0,0,0,0,0,0,0,0,0,0,877,507,30,79,59,13
2020,418000132,2220,2220,20,20,2200,0,0,0,0,0,0,0,0,0,0,0,0,0,620,240,20,24,36,1
2020,418000162,371750,70650,43650,43650,27000,301100,300000,0,300000,0,1100,1100,0,0,154000,74000,74000,0,4120,240,100,180,200,437
2020,418000172,509200,170700,50700,50700,120000,338500,330000,0,330000,0,8500,8500,0,0,85000,0,0,0,18600,600,500,500,600,14282
2020,418000302,3607,3107,607,607,2500,500,0,0,0,0,500,500,0,0,0,0,0,0,620,210,50,20,20,41
2020,418000322,43340,7530,7530,1430,0,35810,23000,18000,5000,0,12810,1610,11200,0,12330,12330,5000,7200,4156,880,120,420,240,104
2020,418600161,126250,2250,2250,2250,0,124000,120000,120000,0,0,4000,1000,0,3000,5000,5000,0,0,1352,250,400,140,72,201
2020,418600191,178300,6500,6500,6500,0,171800,170000,170000,0,0,1800,1800,0,0,0,0,0,0,1720,300,240,120,110,422
2020,418600301,21430,4000,4000,4000,0,17430,13500,8900,4600,0,3930,1630,0,2300,2300,2300,2300,0,1692,120,140,300,132,120
2020,418600331,54120,3420,3420,3420,0,50700,48000,8000,40000,0,2700,2700,0,0,1000,1000,0,0,2274,204,60,180,180,110
2020,418600341,7370,7150,2150,2150,5000,220,0,0,0,0,220,0,220,0,0,0,0,0,430,120,50,0,20,1
2020,418700101,258868,37868,37868,37868,0,221000,220000,120000,100000,0,1000,1000,0,0,5500,500,0,500,1800,200,300,100,300,2017
2020,418700111,291800,7800,7800,7800,0,284000,280000,260000,20000,0,4000,2000,2000,0,2000,0,0,0,2486,360,10,120,120,7845
2020,418700121,442440,111040,111040,101040,0,331400,328500,320000,0,8500,2900,900,2000,0,10000,10000,10000,0,14120,1200,1000,820,310,12358
2020,418700131,307600,15000,15000,15000,0,292600,290000,150000,140000,0,2600,2500,100,0,11000,0,0,0,4260,480,240,360,240,366
2020,418700181,152890,31790,31790,31790,0,121100,120000,70000,50000,0,1100,600,500,0,17000,12000,12000,0,7050,350,1300,500,400,1348
2020,418700191,99636,10586,10586,10586,0,89050,80000,80000,0,0,9050,1550,0,7500,130,130,0,0,2370,240,500,250,180,488
2020,418700321,50644,22640,22640,22640,0,28004,24500,24500,0,0,3504,2600,904,0,0,0,0,0,4584,200,500,600,144,450
2020,418700331,131150,9450,9450,9450,0,121700,120000,120000,0,0,1700,1700,0,0,69000,60000,60000,0,3246,240,56,420,360,289
2020,418800101,691220,86220,86220,86220,0,605000,600000,500000,100000,0,5000,5000,0,0,2700,0,0,0,8010,960,700,350,100,6286
2020,418800131,143880,15130,15130,11130,0,128750,110000,70000,40000,0,18750,6300,450,12000,63000,60000,60000,0,4340,480,50,500,360,1271
2020,418800161,397150,144800,69800,69800,75000,252350,250000,0,250000,0,2350,150,2200,0,5000,0,0,0,4204,480,120,360,120,1675
2020,418800171,62491,761,761,761,0,61730,61700,55000,6700,0,30,30,0,0,4120,4120,3520,600,1921,144,10,240,190,68
2020,418800301,41532,13982,13982,13982,0,27550,25000,25000,0,0,2550,2300,250,0,13784,13784,9084,4500,4796,396,250,360,120,295
2020,418800311,20450,450,450,450,0,20000,20000,20000,0,0,0,0,0,0,0,0,0,0,590,120,10,10,10,13
2020,418900101,197413,42413,13913,13913,28500,155000,150000,0,150000,0,5000,5000,0,0,95000,30000,30000,0,3610,350,670,300,240,968
2020,418900121,37630,6480,6480,6480,0,31150,30000,30000,0,0,1150,800,350,0,13000,13000,13000,0,3008,222,30,420,216,126
2020,418900161,226615,142615,28615,15615,114000,84000,80000,0,0,80000,4000,1000,3000,0,89000,89000,50000,39000,13060,720,1000,600,240,6114
2020,418900171,16350,14550,1550,1550,13000,1800,0,0,0,0,1800,1800,0,0,0,0,0,0,1600,100,100,200,100,2
2020,418900181,4330,4330,330,330,4000,0,0,0,0,0,0,0,0,0,2000,2000,2000,0,2020,360,10,360,270,4
2020,418900191,84880,5880,5880,5880,0,79000,78000,70000,8000,0,1000,900,100,0,1000,0,0,0,6840,216,50,400,360,327
2020,418900301,1015,1015,1015,1015,0,0,0,0,0,0,0,0,0,0,0,0,0,0,1586,820,300,20,36,0
2020,418900311,81544,6944,6944,6944,0,74600,70000,15000,55000,0,4600,4100,500,0,7800,7800,5000,0,1620,180,60,220,140,130
2020,418900321,22300,17000,12000,9000,5000,5300,0,0,0,0,5300,300,0,5000,200,200,0,0,994,120,10,70,84,122
2020,419000102,130100,12600,12600,12600,0,117500,110000,80000,30000,0,7500,7500,0,0,12000,0,0,0,5752,360,120,480,180,632
2020,419000112,1170,1170,170,170,1000,0,0,0,0,0,0,0,0,0,0,0,0,0,948,708,3,3,84,7
2020,419000132,330,30,30,30,0,300,0,0,0,0,300,300,0,0,0,0,0,0,1210,240,100,10,60,594
2020,419000162,86480,6254,6254,6254,0,80226,78000,78000,0,0,2226,2000,226,0,3300,3300,3300,0,3464,300,200,500,264,414
2020,419000172,3916,3916,916,916,3000,0,0,0,0,0,0,0,0,0,0,0,0,0,1829,780,5,144,174,9
2020,419000192,21680,21030,11030,10030,10000,650,0,0,0,0,650,650,0,0,0,0,0,0,1750,60,628,72,98,37
2020,419600131,86720,39520,3520,3520,36000,47200,45000,0,41000,4000,2200,2200,0,0,10000,10000,8000,0,1660,400,400,240,150,72
2020,419600151,207780,21380,21380,21380,0,186400,180000,120000,60000,0,6400,6400,0,0,18000,18000,18000,0,3560,500,210,240,240,2837
2020,419600161,509212,8162,8162,8162,0,501050,500500,135500,325000,40000,550,550,0,0,10040,40,0,0,3378,480,180,540,120,2307
2020,419700101,1300,1300,1000,1000,300,0,0,0,0,0,0,0,0,0,0,0,0,0,2060,400,100,120,45,10
2020,419700121,10640,10140,640,640,9500,500,0,0,0,0,500,500,0,0,9900,9900,8900,0,1930,540,150,350,150,20
2020,419700131,4330,4330,1330,1330,3000,0,0,0,0,0,0,0,0,0,5000,5000,2500,0,2400,996,804,60,48,1
2020,419700141,2750,2750,2250,2250,500,0,0,0,0,0,0,0,0,0,0,0,0,0,1590,120,50,120,240,163
2020,419700151,27448,24448,4448,4448,20000,3000,0,0,0,0,3000,3000,0,0,6000,6000,6000,0,1820,240,30,360,240,59
2020,419700181,45500,300,300,300,0,45200,45000,45000,0,0,200,0,200,0,7000,0,0,0,984,240,400,20,24,60
2020,419700191,34540,7040,6540,6540,500,27500,27000,0,27000,0,500,0,500,0,3500,800,0,800,1448,480,200,48,90,53
2020,419800161,17068,17068,9068,9068,8000,0,0,0,0,0,0,0,0,0,0,0,0,0,695,150,5,120,120,14
2020,419800181,15190,14510,510,510,14000,680,0,0,0,0,680,680,0,0,11400,11400,11400,0,2180,400,450,120,290,1
2020,419900101,162165,15165,15165,9765,0,147000,145000,130000,15000,0,2000,2000,0,0,79876,34376,28726,5000,6200,250,600,500,450,742
2020,419900111,21730,10930,2930,2930,8000,10800,0,0,0,0,10800,2800,8000,0,400,400,0,0,3844,840,100,300,124,172
2020,419900141,366350,1550,1550,1550,0,364800,364000,220000,139000,5000,800,800,0,0,276930,27930,27500,30,2820,240,600,180,240,305
2020,419900181,71047,70347,20347,20347,50000,700,0,0,0,0,700,700,0,0,0,0,0,0,4668,480,120,360,180,989
2020,420000212,4580,4580,580,580,4000,0,0,0,0,0,0,0,0,0,0,0,0,0,1330,150,10,60,180,7
2020,420000232,1700,700,700,700,0,1000,0,0,0,0,1000,1000,0,0,0,0,0,0,1416,360,60,180,120,57
2020,420000252,30964,6064,3064,3064,3000,24900,24800,0,20000,4800,100,100,0,0,8000,8000,0,8000,2448,216,48,240,120,101
2020,420000292,44168,8568,8568,8568,0,35600,32000,32000,0,0,3600,3500,100,0,12600,12600,12000,500,3450,300,100,240,180,275
2020,420000322,18650,250,250,250,0,18400,18000,18000,0,0,400,400,0,0,2020,2020,2000,0,2202,282,40,260,240,64
2020,420000332,35066,9876,1876,1876,8000,25190,21800,0,21800,0,3390,3390,0,0,15700,4700,0,3500,3720,800,300,340,230,203
2020,420000342,32762,3560,3560,3560,0,29202,28000,18000,10000,0,1202,750,452,0,5368,5368,3868,1500,854,264,100,65,15,48
2020,420000352,2100,1100,1100,1000,0,1000,0,0,0,0,1000,0,0,1000,0,0,0,0,2830,1200,40,20,30,40
2020,420600211,41275,22458,22458,22458,0,18817,18000,18000,0,0,817,417,400,0,0,0,0,0,4583,216,550,380,120,620
2020,420600221,5230,30,30,30,0,5200,5000,5000,0,0,200,150,50,0,0,0,0,0,1320,100,100,120,80,4
2020,420600231,28216,2986,2986,2986,0,25230,25000,24000,1000,0,230,200,30,0,1000,1000,0,1000,1090,180,80,180,50,50
2020,420600261,58248,23450,23450,23450,0,34798,32000,32000,0,0,2798,2700,98,0,0,0,0,0,2426,230,800,330,84,203
2020,420600311,20027,18989,5989,5989,13000,1038,0,0,0,0,1038,900,138,0,20,20,0,0,2573,250,36,240,240,35
2020,420600331,13910,9410,2410,2410,7000,4500,0,0,0,0,4500,4500,0,0,5600,5600,5600,0,2600,180,10,360,240,320
2020,420600361,6044,6044,2344,2344,3700,0,0,0,0,0,0,0,0,0,1700,1700,0,1700,1570,162,36,120,48,2
2020,420600371,2502,1002,802,802,200,1500,0,0,0,0,1500,1500,0,0,1864,1864,274,390,1175,372,36,180,132,38
2020,420600381,29040,2190,2190,2190,0,26850,24000,13000,11000,0,2850,2850,0,0,0,0,0,0,4580,660,100,610,300,95
2020,420600391,42092,1192,1192,1192,0,40900,38500,16500,22000,0,2400,2400,0,0,28000,27000,27000,0,3092,216,60,480,216,53
2020,420700221,2305,2305,755,755,1550,0,0,0,0,0,0,0,0,0,0,0,0,0,1016,240,12,12,32,1
2020,420700231,31500,6500,6500,6500,0,25000,20000,20000,0,0,5000,5000,0,0,200,200,0,0,4390,240,300,500,300,851
2020,420700261,5054,3500,3000,3000,500,1554,0,0,0,0,1554,1400,154,0,905,905,0,905,2844,600,60,204,300,31
2020,420700271,35,35,35,35,0,0,0,0,0,0,0,0,0,0,0,0,0,0,357,50,52,12,18,1
2020,420700291,13012,12,12,12,0,13000,13000,13000,0,0,0,0,0,0,0,0,0,0,430,80,50,10,10,11
2020,420700301,13878,13152,3152,3152,10000,726,0,0,0,0,726,500,226,0,0,0,0,0,2064,144,280,240,240,186
2020,420700311,175900,21287,21287,21287,0,154613,154000,10000,144000,0,613,500,113,0,0,0,0,0,922,260,60,180,30,89
2020,420700321,67988,2938,2938,1938,0,65050,60000,30000,30000,0,5050,50,0,5000,18030,16030,4000,0,3340,1014,120,300,156,479
2020,420700331,42999,11099,11099,11099,0,31900,29000,24000,5000,0,2900,2900,0,0,6000,6000,6000,0,3580,300,300,250,180,532
2020,420700341,39018,4618,4618,4618,0,34400,28600,28600,0,0,5800,5800,0,0,10700,10700,7000,0,3420,240,500,600,240,430
2020,420700351,14510,1510,1510,1510,0,13000,13000,13000,0,0,0,0,0,0,0,0,0,0,1262,142,100,300,180,82
2020,420700361,87736,20736,20736,20736,0,67000,65000,50000,15000,0,2000,2000,0,0,11300,10000,0,10000,3334,196,20,540,240,115
2020,420700371,238270,30670,30670,27670,0,207600,194000,16000,168000,10000,13600,3600,0,10000,98600,88600,55000,30000,3706,240,400,280,252,943
2020,420700381,62750,20500,20500,20500,0,42250,42000,17000,25000,0,250,250,0,0,0,0,0,0,4048,300,100,240,180,138
2020,420800211,2952,2802,2602,2602,200,150,0,0,0,0,150,150,0,0,600,600,600,0,1254,354,20,320,40,15
2020,420800221,10025,9955,9955,9955,0,70,0,0,0,0,70,0,70,0,140,140,0,0,3731,280,15,420,156,281
2020,420800231,570,520,520,520,0,50,0,0,0,0,50,0,50,0,0,0,0,0,1772,500,90,50,132,1
2020,420800241,4000,4000,3500,3500,500,0,0,0,0,0,0,0,0,0,0,0,0,0,1885,480,5,95,210,19
2020,420800251,18632,6832,6832,6832,0,11800,10000,10000,0,0,1800,1800,0,0,360,360,0,0,2004,250,24,240,180,63
2020,420800261,16863,13800,3800,3800,10000,3063,3000,0,3000,0,63,0,63,0,0,0,0,0,785,50,200,70,15,8
2020,420800301,23180,5800,5800,5800,0,17380,17000,13000,4000,0,380,0,380,0,0,0,0,0,434,150,90,10,14,20
2020,420800311,212080,1080,1080,1080,0,211000,208000,8000,200000,0,3000,0,3000,0,30000,30000,30000,0,716,135,60,100,84,86
2020,420800321,35258,9258,9258,9258,0,26000,26000,26000,0,0,0,0,0,0,15800,8800,8500,300,2254,240,60,360,240,62
2020,420800331,14180,100,100,100,0,14080,14000,14000,0,0,80,80,0,0,0,0,0,0,1778,304,200,96,60,505
2020,420800391,26920,870,870,870,0,26050,26000,26000,0,0,50,0,50,0,7400,7400,6900,500,3022,376,240,170,96,56
2020,420900201,18384,6984,984,984,6000,11400,10000,0,10000,0,1400,1000,400,0,0,0,0,0,1642,240,120,180,120,42
2020,420900221,17840,40,40,40,0,17800,17700,16500,1200,0,100,100,0,0,2400,2400,1000,0,1080,80,50,250,100,52
2020,420900231,430,430,130,130,300,0,0,0,0,0,0,0,0,0,0,0,0,0,514,103,210,15,16,0
2020,420900241,30586,5045,5045,5045,0,25541,23000,23000,0,0,2541,1750,791,0,2634,2634,1586,0,2959,181,285,116,192,81
2020,420900251,70,70,70,70,0,0,0,0,0,0,0,0,0,0,0,0,0,0,1440,450,25,65,60,1
2020,420900271,86004,5884,5884,5694,0,80120,80000,30000,50000,0,120,20,100,0,16500,15000,15000,0,2492,360,300,200,170,52
2020,420900301,64040,13040,13040,13040,0,51000,50000,50000,0,0,1000,1000,0,0,12000,6000,6000,0,1270,180,100,240,120,141
2020,420900311,89278,1778,1778,1778,0,87500,87500,15500,72000,0,0,0,0,0,7500,5500,0,0,1526,150,240,60,120,61
2020,420900321,15574,1774,1774,1774,0,13800,12000,9000,3000,0,1800,1800,0,0,0,0,0,0,1460,135,120,480,148,175
2020,420900331,78394,22616,22616,22616,0,55778,54000,29000,25000,0,1778,1100,678,0,3000,3000,2500,500,2264,420,100,510,144,226
2020,420900341,69665,13515,13515,13515,0,56150,56000,33000,23000,0,150,150,0,0,44600,21600,21600,0,2820,500,300,500,120,984
2020,420900351,79208,1208,1208,1208,0,78000,75000,19000,56000,0,3000,3000,0,0,55290,48290,48290,0,3183,318,150,202,240,213
2020,420900361,11464,2364,2364,2364,0,9100,8000,8000,0,0,1100,1100,0,0,1400,1400,0,0,1255,120,130,360,50,35
2020,420900371,8430,3330,3330,3330,0,5100,5000,5000,0,0,100,100,0,0,918,918,888,0,3185,264,40,509,324,164
2020,420900381,55354,25428,25428,25428,0,29926,29000,19000,10000,0,926,700,226,0,13550,13550,5550,8000,5001,189,960,480,120,1531
2020,420900391,380,250,150,150,100,130,0,0,0,0,130,130,0,0,0,0,0,0,1178,252,150,180,36,13
2020,421000202,29695,1692,1692,1692,0,28003,25000,25000,0,0,3003,350,153,2500,4170,4170,4130,0,1600,250,100,250,200,46
2020,421000212,21420,100,100,100,0,21320,21320,20000,1320,0,0,0,0,0,400,0,0,0,640,100,100,10,20,30
2020,421000222,530,500,500,500,0,30,0,0,0,0,30,0,30,0,0,0,0,0,2195,180,150,60,60,139
2020,421000242,49950,4450,4450,4450,0,45500,45000,45000,0,0,500,500,0,0,6000,6000,0,6000,2920,120,100,100,100,396
2020,421000262,1750,250,50,50,200,1500,0,0,0,0,1500,0,1500,0,3200,3200,0,2000,2480,520,10,600,240,29
2020,421000282,66873,13160,13160,13160,0,53713,50000,40000,10000,0,3713,3600,113,0,50,50,0,0,2180,252,60,72,96,698
2020,421000322,15499,2919,2919,2919,0,12580,11000,11000,0,0,1580,1400,180,0,2716,2716,0,500,2612,280,380,660,252,80
2020,421000332,6150,4720,1720,1720,3000,1430,0,0,0,0,1430,1430,0,0,0,0,0,0,2610,240,50,360,240,129
2020,421000342,27264,4764,4764,4764,0,22500,22000,22000,0,0,500,500,0,0,7090,7090,7000,0,1836,276,102,396,204,87
2020,421000352,43323,21923,21923,21923,0,21400,18500,18500,0,0,2900,2900,0,0,5000,5000,5000,0,4028,252,300,580,192,687
2020,421000362,185,185,185,185,0,0,0,0,0,0,0,0,0,0,0,0,0,0,840,70,70,30,120,1
2020,421000372,20,20,20,20,0,0,0,0,0,0,0,0,0,0,0,0,0,0,602,245,20,10,24,2
2020,421000382,18800,6800,6800,6800,0,12000,12000,12000,0,0,0,0,0,0,0,0,0,0,1532,300,36,36,60,50
2020,421000392,8900,1900,1900,1900,0,7000,7000,7000,0,0,0,0,0,0,0,0,0,0,1626,180,240,120,96,16
2020,421600231,15100,100,100,100,0,15000,15000,15000,0,0,0,0,0,0,0,0,0,0,965,200,500,50,15,17
2020,421600251,24979,10579,10579,10579,0,14400,14000,14000,0,0,400,350,50,0,0,0,0,0,3160,340,100,260,350,74
2020,421600261,750,750,500,500,250,0,0,0,0,0,0,0,0,0,0,0,0,0,766,72,30,80,44,0
2020,421600271,63050,2800,2800,2800,0,60250,60000,60000,0,0,250,250,0,0,2000,0,0,0,1280,280,130,120,100,130
2020,421600281,42853,4853,4853,4853,0,38000,33000,33000,0,0,5000,1000,0,4000,4000,0,0,0,1822,162,600,100,80,33
2020,421600291,25070,0,0,0,0,25070,25000,25000,0,0,70,70,0,0,6588,6588,4000,2088,3160,180,420,320,192,115
2020,421600301,5088,4270,4270,4270,0,818,0,0,0,0,818,650,168,0,0,0,0,0,1612,300,120,180,156,11
2020,421600311,235,235,5,5,230,0,0,0,0,0,0,0,0,0,480,480,0,0,536,150,180,20,36,0
2020,421600321,105777,24377,24377,24377,0,81400,78500,25000,50000,3500,2900,2500,400,0,8000,0,0,0,4410,300,1000,240,240,427
2020,421600331,32190,8190,8190,8190,0,24000,23000,23000,0,0,1000,1000,0,0,520,520,520,0,4040,240,120,300,240,381
2020,421600341,35584,10928,10928,10928,0,24656,21700,16500,5200,0,2956,2330,626,0,4700,4700,4200,0,5120,200,300,360,180,365
2020,421600351,20150,650,650,650,0,19500,19500,8000,11500,0,0,0,0,0,6000,6000,3000,3000,1982,184,370,180,120,8
2020,421600361,26640,14140,6140,5640,8000,12500,10000,0,10000,0,2500,1500,1000,0,0,0,0,0,1910,260,60,230,150,44
2020,421600371,75745,5220,5220,4920,0,70525,66800,30000,36800,0,3725,2150,675,900,20071,16771,16771,0,3770,300,50,480,360,314
2020,421600381,59218,24728,24728,24728,0,34490,30000,30000,0,0,4490,4100,390,0,7665,7665,0,0,5490,300,260,540,360,1372
2020,421600391,26488,9288,9288,9288,0,17200,10000,5000,5000,0,7200,200,7000,0,2970,2970,2570,400,3280,280,40,110,230,190
2020,421700211,1179,1139,1139,1139,0,40,0,0,0,0,40,0,40,0,200,200,200,0,1173,270,5,60,38,1
2020,421700231,24470,3220,3220,3220,0,21250,21000,21000,0,0,250,150,100,0,0,0,0,0,1140,180,280,100,36,34
2020,421700251,98300,15300,15300,15300,0,83000,83000,83000,0,0,0,0,0,0,0,0,0,0,1950,400,300,100,100,77
2020,421700261,23369,3369,3369,3369,0,20000,19800,19800,0,0,200,200,0,0,8000,8000,5100,2000,1454,240,60,60,144,52
2020,421700271,35,35,35,35,0,0,0,0,0,0,0,0,0,0,0,0,0,0,1066,119,600,53,34,1
2020,421700281,90,40,40,40,0,50,0,0,0,0,50,0,50,0,0,0,0,0,880,390,90,60,60,1
2020,421700291,216790,68190,68190,68190,0,148600,147000,47000,100000,0,1600,1400,200,0,25600,25600,21600,4000,7770,400,500,400,150,4476
2020,421700311,4001,3077,1877,1877,1200,924,0,0,0,0,924,924,0,0,1190,1190,0,0,1354,360,180,240,120,37
2020,421700341,54530,4150,4150,4150,0,50380,50000,25000,25000,0,380,380,0,0,35300,35000,35000,0,1468,160,840,20,48,64
2020,421700351,16196,12380,11380,11380,1000,3816,3000,0,3000,0,816,590,226,0,0,0,0,0,1569,390,50,340,144,81
2020,421700361,14075,13375,13375,13375,0,700,600,0,600,0,100,100,0,0,0,0,0,0,1865,200,100,80,70,65
2020,421700371,320,320,320,320,0,0,0,0,0,0,0,0,0,0,50,50,0,0,1076,180,60,40,50,1
2020,421700381,6100,1100,1100,1100,0,5000,5000,0,5000,0,0,0,0,0,1000,0,0,0,485,127,65,25,15,19
2020,421700391,10015,9485,4485,4485,5000,530,0,0,0,0,530,530,0,0,5000,5000,5000,0,3350,370,50,280,300,123
2020,421800211,29320,4220,4220,3220,0,25100,20000,20000,0,0,5100,50,2050,3000,13800,10800,10800,0,1904,240,400,84,120,35
2020,421800221,2190,2190,190,190,2000,0,0,0,0,0,0,0,0,0,0,0,0,0,610,90,50,40,50,1
2020,421800231,10193,9503,4503,4503,5000,690,0,0,0,0,690,300,390,0,2500,2500,0,2500,3710,850,20,150,240,694
2020,421800241,5620,5520,3520,3520,2000,100,0,0,0,0,100,0,100,0,0,0,0,0,2024,268,0,360,96,63
2020,421800251,273,203,203,203,0,70,0,0,0,0,70,0,70,0,0,0,0,0,1728,160,10,240,113,12
2020,421800261,102230,1300,1300,1300,0,100930,99000,19000,80000,0,1930,930,1000,0,0,0,0,0,3090,240,50,700,70,1148
2020,421800271,19410,16210,9210,9210,7000,3200,0,0,0,0,3200,3200,0,0,2700,2700,1900,0,2238,204,84,650,150,401
2020,421800301,40540,3140,3140,3140,0,37400,36000,9000,27000,0,1400,950,450,0,5600,5600,5600,0,2298,198,600,300,120,31
2020,421800311,13364,3664,3664,3664,0,9700,9000,9000,0,0,700,700,0,0,4500,4500,4500,0,1290,200,10,180,100,70
2020,421800351,910,410,410,410,0,500,0,0,0,0,500,500,0,0,0,0,0,0,941,480,5,70,36,11
2020,421800361,72080,12080,4080,4080,8000,60000,60000,0,60000,0,0,0,0,0,3000,0,0,0,3090,230,840,110,240,88
2020,421800371,17156,8956,4456,4456,4500,8200,7000,0,7000,0,1200,1200,0,0,7700,7700,4500,2900,2968,204,1010,240,144,203
2020,421800391,2792,2792,2792,2792,0,0,0,0,0,0,0,0,0,0,0,0,0,0,391,84,80,24,36,1
2020,421900201,12300,500,500,500,0,11800,7000,0,7000,0,4800,4800,0,0,1150,650,0,650,2960,280,50,300,180,81
2020,421900231,48770,2270,2270,2270,0,46500,45000,45000,0,0,1500,1250,250,0,15000,15000,15000,0,2451,160,36,330,216,124
2020,421900261,50,50,50,50,0,0,0,0,0,0,0,0,0,0,0,0,0,0,620,55,20,20,170,0
2020,421900271,1602,1502,502,502,1000,100,0,0,0,0,100,0,100,0,0,0,0,0,2300,600,50,150,200,89
2020,421900281,43155,8785,8785,8785,0,34370,33000,33000,0,0,1370,1200,170,0,20000,20000,20000,0,3976,300,100,500,400,436
2020,421900321,13805,13405,6905,6905,6500,400,0,0,0,0,400,400,0,0,0,0,0,0,1578,120,33,144,48,79
2020,421900331,20434,5134,5134,5134,0,15300,15000,15000,0,0,300,0,100,200,4758,4758,3264,1494,486,132,20,12,87,13
2020,421900341,22852,2172,2172,2172,0,20680,20000,20000,0,0,680,680,0,0,2581,2581,0,581,1942,534,50,288,120,38
2020,421900351,26800,9700,9700,9700,0,17100,17000,7000,10000,0,100,0,100,0,0,0,0,0,2320,150,350,60,80,35
2020,421900371,23204,2204,2204,1204,0,21000,20000,20000,0,0,1000,0,1000,0,10800,10800,10800,0,2490,240,48,120,320,29
2020,421900391,4250,1210,1210,1210,0,3040,3000,3000,0,0,40,0,40,0,0,0,0,0,1680,60,1000,50,20,1
2020,422000202,17750,250,250,250,0,17500,16000,16000,0,0,1500,1500,0,0,0,0,0,0,1770,156,50,150,96,47
2020,422000212,106228,8178,5178,5178,3000,98050,98000,0,98000,0,50,0,50,0,44060,44060,30000,14000,904,150,120,84,60,29
2020,422000222,99025,22025,22025,19025,0,77000,70000,60000,10000,0,7000,7000,0,0,324,24,0,0,5185,55,100,500,180,3580
2020,422000232,74620,31020,31020,31020,0,43600,40300,37000,3300,0,3300,2300,1000,0,9000,9000,8000,1000,4810,360,200,500,200,971
2020,422000242,45215,1915,1915,1915,0,43300,42000,27000,15000,0,1300,1300,0,0,0,0,0,0,1487,240,25,240,72,184
2020,422000252,56540,12120,12120,12120,0,44420,39500,38000,1500,0,4920,1920,3000,0,0,0,0,0,1410,240,120,150,100,177
2020,422000262,50,50,50,50,0,0,0,0,0,0,0,0,0,0,0,0,0,0,1350,240,500,20,30,1
2020,422000292,19760,1010,1010,1010,0,18750,13000,13000,0,0,5750,2700,50,3000,5900,5900,5900,0,2304,240,136,480,180,48
2020,422000302,4,4,4,4,0,0,0,0,0,0,0,0,0,0,0,0,0,0,960,50,130,40,30,3
2020,422000312,5020,2020,2020,2020,0,3000,3000,3000,0,0,0,0,0,0,0,0,0,0,458,79,95,38,35,6
2020,422000322,55200,3000,3000,3000,0,52200,49500,6000,43500,0,2700,2700,0,0,6000,6000,6000,0,2536,312,300,720,90,52
2020,422000332,700,700,400,400,300,0,0,0,0,0,0,0,0,0,0,0,0,0,1266,466,20,10,72,1
2020,422000352,2343,2173,173,173,2000,170,0,0,0,0,170,170,0,0,0,0,0,0,2039,120,84,210,300,35
2020,422600211,136236,21956,21956,21956,0,114280,112000,95000,17000,0,2280,2200,80,0,0,0,0,0,5060,216,105,100,109,185
2020,422600241,76070,6700,6700,6700,0,69370,67000,67000,0,0,2370,1870,500,0,34834,34834,34834,0,7000,400,300,1000,600,799
2020,422600251,4032,4032,3032,3032,1000,0,0,0,0,0,0,0,0,0,0,0,0,0,1570,360,100,40,60,174
2020,422600261,12991,12811,811,811,12000,180,0,0,0,0,180,180,0,0,11000,11000,9600,1400,1644,350,10,150,84,31
2020,422600271,82150,19150,19150,19150,0,63000,62000,32000,30000,0,1000,400,600,0,0,0,0,0,2115,370,100,350,200,115
2020,422600281,28342,19172,8672,6672,10500,9170,0,0,0,0,9170,5670,1000,2500,8000,8000,8000,0,2480,310,40,420,250,64
2020,422600301,234,234,234,234,0,0,0,0,0,0,0,0,0,0,0,0,0,0,662,120,45,70,32,1
2020,422600321,10456,476,476,476,0,9980,9500,7000,2500,0,480,480,0,0,5500,5500,0,5500,2460,450,20,50,220,655
2020,422600341,4210,1000,1000,1000,0,3210,2500,2500,0,0,710,700,10,0,0,0,0,0,1648,280,40,504,96,42
2020,422700201,8455,1785,1785,1785,0,6670,6600,6600,0,0,70,0,70,0,0,0,0,0,1417,120,500,20,50,9
2020,422700211,63450,8450,8450,8450,0,55000,55000,55000,0,0,0,0,0,0,0,0,0,0,3452,400,1000,10,72,136
2020,422700241,23494,4424,4424,4424,0,19070,19000,19000,0,0,70,70,0,0,16700,16700,10800,1900,4420,300,100,400,200,99
2020,422700261,26756,10256,10256,9256,0,16500,15000,15000,0,0,1500,400,600,500,0,0,0,0,2270,900,500,70,100,98
2020,422700311,29350,3550,3550,3550,0,25800,24000,17000,7000,0,1800,1800,0,0,0,0,0,0,1735,320,120,170,55,86
2020,422700321,965,905,605,605,300,60,0,0,0,0,60,0,60,0,0,0,0,0,1247,420,140,30,36,1
2020,422700331,20798,3718,3718,3718,0,17080,17000,4000,13000,0,80,80,0,0,0,0,0,0,958,274,12,160,43,68
2020,422700341,29676,9224,9224,9224,0,20452,18000,3500,10000,4500,2452,1900,552,0,700,700,0,700,1883,236,220,600,120,46
2020,422700351,18000,2200,2200,2200,0,15800,15000,15000,0,0,800,800,0,0,0,0,0,0,2300,600,50,600,100,46
2020,422700361,9592,3125,3125,3125,0,6467,6000,6000,0,0,467,0,467,0,320,320,0,0,1092,180,300,72,48,4
2020,422800231,8020,8020,20,20,8000,0,0,0,0,0,0,0,0,0,0,0,0,0,577,190,40,15,12,1
2020,422800251,5658,5458,1958,1958,3500,200,0,0,0,0,200,100,100,0,0,0,0,0,1040,180,120,120,72,13
2020,422800271,211,211,11,11,200,0,0,0,0,0,0,0,0,0,0,0,0,0,1052,120,400,30,12,0
2020,422800291,12913,12313,313,313,12000,600,0,0,0,0,600,600,0,0,12100,12100,10000,2000,3220,580,80,600,240,35
2020,422800301,317640,19230,19230,19230,0,298410,296240,6000,290240,0,2170,1800,370,0,50000,0,0,0,4500,300,800,600,120,709
2020,422800311,44550,5800,5800,5800,0,38750,38750,12000,26750,0,0,0,0,0,0,0,0,0,1274,160,120,80,24,103
2020,422800321,23020,3800,3800,3800,0,19220,18000,5000,13000,0,1220,1220,0,0,0,0,0,0,1550,480,300,100,60,105
2020,422800331,32552,13520,13520,13520,0,19032,6000,6000,0,0,13032,2530,502,10000,20,20,0,0,1852,320,420,120,120,81
2020,422800341,20455,2955,2955,2955,0,17500,12000,12000,0,0,5500,5500,0,0,10700,10700,0,10700,4290,230,50,600,300,798
2020,422800351,38200,6500,6500,6500,0,31700,30000,30000,0,0,1700,1700,0,0,0,0,0,0,3381,1370,567,360,96,61
2020,422900231,91594,6474,6474,6474,0,85120,84000,78000,6000,0,1120,1000,120,0,13200,0,0,0,2372,360,700,240,72,138
2020,422900241,41214,5864,5864,5864,0,35350,32000,22000,10000,0,3350,150,3200,0,13200,13200,12000,1200,1570,300,100,100,180,31
2020,422900251,12765,265,265,265,0,12500,10000,10000,0,0,2500,2500,0,0,9300,9300,6000,2000,2190,420,50,300,150,58
2020,422900261,2260,2195,1195,1195,1000,65,0,0,0,0,65,0,65,0,0,0,0,0,1497,599,47,25,41,5
2020,422900271,35525,7125,7125,7125,0,28400,28000,28000,0,0,400,0,400,0,40,40,0,0,974,240,12,52,70,41
2020,422900281,49831,34401,34401,34401,0,15430,15000,15000,0,0,430,200,230,0,0,0,0,0,4500,240,200,500,360,812
2020,422900291,42100,7400,7400,7400,0,34700,32000,24000,8000,0,2700,2700,0,0,8750,8750,8750,0,3770,400,70,600,300,87
2020,422900301,49020,4220,4220,4220,0,44800,44000,20000,24000,0,800,800,0,0,5000,5000,5000,0,1980,200,500,360,130,46
2020,422900311,9266,766,766,766,0,8500,5000,5000,0,0,3500,3500,0,0,1139,1139,0,0,2117,150,150,180,180,55
2020,422900331,21108,2908,2908,2908,0,18200,14500,14500,0,0,3700,3700,0,0,100,100,0,0,2840,350,150,500,120,86
2020,422900341,17459,6079,6079,6079,0,11380,7000,7000,0,0,4380,4380,0,0,1540,1540,1440,0,3412,240,500,400,300,819
2020,422900351,27403,1003,1003,1003,0,26400,26000,9000,17000,0,400,400,0,0,4500,4500,2500,2000,1790,390,50,200,120,33
2020,423000202,14400,1400,1400,1400,0,13000,13000,13000,0,0,0,0,0,0,4000,4000,4000,0,1272,180,180,120,72,15
2020,423000212,37314,5614,5614,5614,0,31700,31000,31000,0,0,700,700,0,0,20300,20300,19400,900,4050,300,200,360,180,126
2020,423000222,20920,4400,4400,4400,0,16520,16000,16000,0,0,520,400,120,0,0,0,0,0,1452,240,120,120,72,46
2020,423000252,12650,100,100,100,0,12550,12000,12000,0,0,550,550,0,0,4060,4060,4000,60,6828,360,260,548,420,780
2020,423600211,53062,3972,3972,3972,0,49090,45000,45000,0,0,4090,4000,90,0,17480,17480,17380,0,3750,250,100,500,200,661
2020,423600221,81308,20758,20758,20758,0,60550,41000,37000,4000,0,19550,1200,18350,0,0,0,0,0,1376,240,120,156,80,104
2020,423600251,5344,1944,50,50,1894,3400,0,0,0,0,3400,3400,0,0,3000,3000,0,3000,4820,360,2800,600,260,51
2020,423700201,46405,9205,9205,9205,0,37200,35000,12000,23000,0,2200,2200,0,0,16400,16400,16400,0,2240,400,290,100,150,584
2020,423700221,14352,332,332,332,0,14020,14000,14000,0,0,20,20,0,0,20,20,0,0,752,120,30,40,72,33
2020,423700241,9992,9742,9742,9742,0,250,0,0,0,0,250,0,250,0,40,40,0,0,1037,228,120,15,84,1
2020,423700251,92570,6300,6300,6300,0,86270,85000,25000,60000,0,1270,950,320,0,0,0,0,0,1130,132,480,12,24,42
2020,423800201,250,250,250,250,0,0,0,0,0,0,0,0,0,0,0,0,0,0,565,110,30,50,15,8
2020,423800211,52471,22471,22471,22471,0,30000,27000,27000,0,0,3000,3000,0,0,2840,2840,0,2840,3400,300,100,100,100,434
2020,423800221,36578,978,978,978,0,35600,35000,18000,17000,0,600,600,0,0,7100,7100,7000,0,1980,160,100,300,120,89
2020,423800251,7200,7070,70,70,7000,130,0,0,0,0,130,130,0,0,790,790,0,0,1310,185,250,180,70,80
2020,423900201,38488,11588,11588,11588,0,26900,24000,24000,0,0,2900,2900,0,0,4000,4000,4000,0,4220,300,100,450,200,141
2020,423900221,551,371,271,271,100,180,0,0,0,0,180,0,180,0,720,720,0,0,1779,480,5,60,144,21
2020,423900231,31600,10600,10600,10600,0,21000,21000,21000,0,0,0,0,0,0,0,0,0,0,1570,240,36,84,50,69
2020,423900251,215,215,15,15,200,0,0,0,0,0,0,0,0,0,0,0,0,0,695,200,10,80,20,87
2020,430000222,18660,18360,360,360,18000,300,0,0,0,0,300,300,0,0,0,0,0,0,1192,198,60,180,84,13
2020,430000252,21730,230,230,230,0,21500,19500,12500,7000,0,2000,2000,0,0,27372,22872,13000,0,2955,240,100,200,480,132
2020,430000262,16200,200,200,200,0,16000,16000,16000,0,0,0,0,0,0,0,0,0,0,1073,180,200,40,50,21
2020,430000272,21540,18040,40,40,18000,3500,0,0,0,0,3500,3500,0,0,14200,14200,14000,0,3060,480,100,480,360,124
2020,430000282,33328,8198,8198,8148,0,25130,24000,24000,0,0,1130,1130,0,0,0,0,0,0,3730,210,250,360,360,470
2020,430000302,1268,850,850,450,0,418,0,0,0,0,418,350,68,0,360,360,0,360,1377,123,410,240,108,33
2020,430000312,9100,420,420,420,0,8680,4500,4500,0,0,4180,0,4180,0,0,0,0,0,801,152,120,240,60,23
2020,430000352,8160,5160,660,160,4500,3000,0,0,0,0,3000,0,2000,1000,0,0,0,0,2451,587,10,120,72,1
2020,430000362,49476,3776,3776,3776,0,45700,44500,40000,4500,0,1200,1200,0,0,38000,25500,16000,9500,3886,360,1200,240,180,307
2020,430000372,57056,9656,9656,9656,0,47400,46500,42000,4500,0,900,900,0,0,4000,4000,3000,1000,6862,396,150,500,276,567
2020,430000392,50362,28712,28712,25212,0,21650,17000,17000,0,0,4650,4300,350,0,0,0,0,0,1753,300,55,300,150,465
2020,430600211,56115,5663,5663,5663,0,50452,50000,20000,30000,0,452,452,0,0,20700,20700,11000,9700,2426,156,10,120,144,113
2020,430600241,20620,300,300,300,0,20320,20000,0,20000,0,320,320,0,0,19300,17300,17300,0,2062,480,480,120,170,130
2020,430600251,9396,8940,8940,8940,0,456,0,0,0,0,456,0,456,0,0,0,0,0,879,154,120,36,60,1
2020,430600271,46732,29382,8382,8382,21000,17350,17000,0,0,17000,350,350,0,0,6000,6000,6000,0,3900,220,210,300,140,486
2020,430600321,96820,45120,45120,45120,0,51700,51000,30000,21000,0,700,700,0,0,0,0,0,0,3532,254,150,240,108,205
2020,430600331,8177,2606,2606,2606,0,5571,5000,5000,0,0,571,300,271,0,2210,2210,2210,0,1984,264,10,260,240,38
2020,430600381,39212,21792,21792,21792,0,17420,17420,17420,0,0,0,0,0,0,16988,16988,11988,5000,2864,216,160,240,98,36
2020,430600391,38151,12551,12551,12551,0,25600,25000,25000,0,0,600,600,0,0,10673,10673,10173,500,4681,340,130,266,170,867
2020,430700221,3139,1739,129,129,1610,1400,0,0,0,0,1400,1400,0,0,4130,4130,1540,0,1190,252,400,96,60,13
2020,430700231,21170,20970,4970,4970,16000,200,0,0,0,0,200,200,0,0,14000,14000,12800,600,1730,200,500,80,100,49
2020,430700241,58446,4446,4446,4446,0,54000,49000,49000,0,0,5000,4500,500,0,17500,17500,15300,0,1846,264,50,136,240,152
2020,430700261,51900,5400,5400,5400,0,46500,46500,30000,16500,0,0,0,0,0,2400,0,0,0,1310,380,90,10,45,59
2020,430700301,6600,800,800,800,0,5800,4000,4000,0,0,1800,400,400,1000,1000,1000,0,1000,872,96,80,172,96,38
2020,430700321,11152,6652,6652,6652,0,4500,0,0,0,0,4500,4500,0,0,1900,1900,1900,0,2805,240,100,360,280,396
2020,430700331,315876,10546,10546,10546,0,305330,102200,25000,77200,0,203130,2000,201130,0,21500,15000,15000,0,4714,354,346,1200,180,79
2020,430700351,5200,200,200,200,0,5000,5000,5000,0,0,0,0,0,0,0,0,0,0,1708,170,1100,50,18,2
2020,430700361,4607,4607,2607,2607,2000,0,0,0,0,0,0,0,0,0,88,88,0,88,2870,240,20,180,228,33
2020,430700371,210,210,210,210,0,0,0,0,0,0,0,0,0,0,0,0,0,0,840,240,60,60,40,1
2020,430800211,4660,4560,4560,4560,0,100,0,0,0,0,100,100,0,0,0,0,0,0,1633,240,80,209,162,41
2020,430800241,8005,505,505,505,0,7500,7500,7500,0,0,0,0,0,0,5000,5000,5000,0,1399,126,30,340,153,4
2020,430800251,23220,3690,3690,3690,0,19530,17000,17000,0,0,2530,2530,0,0,4700,4700,4700,0,1660,120,20,552,228,266
2020,430800261,39691,6680,6680,6680,0,33011,30000,30000,0,0,3011,3011,0,0,18381,18381,12931,3750,2440,360,120,260,150,392
2020,430800281,28000,1000,1000,1000,0,27000,19000,19000,0,0,8000,7000,0,1000,17780,17780,11680,0,3200,300,120,200,240,101
2020,430800291,86980,5680,5680,5680,0,81300,78000,49000,29000,0,3300,3300,0,0,20000,0,0,0,4350,600,250,180,360,409
2020,430800301,6010,10,10,10,0,6000,6000,6000,0,0,0,0,0,0,0,0,0,0,531,89,30,20,42,7
2020,430800311,17298,1072,1072,1072,0,16226,16000,10000,6000,0,226,0,226,0,1200,1200,1200,0,2144,360,60,60,84,9
2020,430800321,23860,6860,6860,6860,0,17000,17000,14000,3000,0,0,0,0,0,13000,13000,13000,0,2880,510,300,930,120,100
2020,430800331,23518,740,740,740,0,22778,22378,10378,12000,0,400,400,0,0,1773,1773,1400,373,952,150,88,150,36,64
2020,430800341,48919,17344,17344,17344,0,31575,30000,10000,20000,0,1575,1400,175,0,250,50,0,0,2468,360,150,300,168,360
2020,430800361,1004,1004,1004,1004,0,0,0,0,0,0,0,0,0,0,0,0,0,0,282,70,36,10,11,1
2020,430800371,48058,18858,18858,18858,0,29200,29000,9000,20000,0,200,200,0,0,0,0,0,0,3000,240,30,500,250,86
2020,430800381,135520,6320,6320,6320,0,129200,126000,30000,96000,0,3200,3200,0,0,17000,12700,7000,5700,2528,420,100,360,192,177
2020,430800391,224540,62840,62840,62840,0,161700,160000,40000,120000,0,1700,1700,0,0,20000,15000,0,15000,6370,350,300,300,120,1662
2020,430900201,38680,3680,3680,3680,0,35000,35000,35000,0,0,0,0,0,0,2200,0,0,0,871,200,35,12,24,41
2020,430900231,146,146,1,1,145,0,0,0,0,0,0,0,0,0,50,50,0,0,632,150,82,30,100,1
2020,430900251,54520,8320,8320,2320,0,46200,28000,28000,0,0,18200,4600,10600,3000,16700,16700,16700,0,6030,300,600,150,480,119
2020,430900261,124193,37660,37660,32660,0,86533,70000,70000,0,0,16533,6533,10000,0,50635,50635,15635,35000,7040,600,100,1200,240,678
2020,430900271,46368,43452,13452,13452,30000,2916,1020,0,1020,0,1896,1896,0,0,45,45,0,0,3244,330,5,72,170,61
2020,430900281,50444,4444,4444,444,0,46000,45000,45000,0,0,1000,1000,0,0,6100,6100,0,6000,4738,240,200,500,98,2615
2020,430900291,87348,6848,6848,6848,0,80500,80000,0,80000,0,500,400,100,0,13000,5000,0,0,6162,288,1600,500,102,562
2020,430900301,30112,12112,12112,12112,0,18000,15000,15000,0,0,3000,500,2000,500,175,175,155,0,2338,536,262,540,120,46
2020,430900311,2348,2348,1848,1848,500,0,0,0,0,0,0,0,0,0,0,0,0,0,2383,228,42,55,168,1
2020,430900321,13646,4766,4766,4066,0,8880,5000,5000,0,0,3880,1380,500,2000,6000,6000,2800,0,3901,1060,25,200,276,35
2020,430900331,4810,4810,310,310,4500,0,0,0,0,0,0,0,0,0,3100,3100,2600,0,1796,183,10,110,95,3
2020,430900341,10070,2370,2370,2370,0,7700,7000,7000,0,0,700,700,0,0,1752,1752,1752,0,1672,360,5,424,84,103
2020,430900351,9810,1360,1360,360,0,8450,7000,7000,0,0,1450,450,1000,0,2250,2250,0,1500,1925,180,20,240,120,42
2020,430900361,26804,5534,5534,5534,0,21270,17000,17000,0,0,4270,4270,0,0,9000,9000,0,9000,3932,240,360,72,180,279
2020,430900371,10342,3342,3342,3342,0,7000,7000,7000,0,0,0,0,0,0,1070,1070,1000,0,2826,276,130,180,240,201
2020,430900391,50254,5614,5414,5414,200,44640,43000,0,43000,0,1640,1140,500,0,15000,15000,15000,0,2538,460,360,240,108,48
2020,431000202,253680,9780,9780,9780,0,243900,230000,85000,145000,0,13900,7300,6600,0,104000,104000,104000,0,8680,540,1000,720,300,1416
2020,431000232,137030,9430,9430,9430,0,127600,125000,45000,80000,0,2600,2400,200,0,27790,25290,25290,0,4120,420,100,540,240,531
2020,431000282,28962,22000,2000,2000,20000,6962,5000,0,0,5000,1962,1362,600,0,0,0,0,0,2274,144,45,432,240,191
2020,431000292,35340,4653,4653,4653,0,30687,30000,30000,0,0,687,550,137,0,7000,7000,7000,0,2637,300,10,240,180,154
2020,431000312,57379,9329,9329,8829,0,48050,38300,18000,20300,0,9750,4350,1400,4000,21000,20900,14400,4500,5310,400,50,460,600,944
2020,431000352,12950,10450,10450,7450,0,2500,0,0,0,0,2500,500,2000,0,200,200,0,200,2046,180,50,360,120,90
2020,431000372,1940,1940,240,240,1700,0,0,0,0,0,0,0,0,0,0,0,0,0,373,156,12,24,12,0
2020,431000382,28293,27093,22593,7593,4500,1200,0,0,0,0,1200,700,500,0,1800,1800,1800,0,4230,240,230,360,380,63
2020,431600201,5529,5417,2417,2417,3000,112,0,0,0,0,112,112,0,0,0,0,0,0,2894,120,100,180,276,18
2020,431600251,4586,1010,1010,1010,0,3576,3000,3000,0,0,576,350,226,0,560,560,0,0,1366,165,24,156,144,293
2020,431600271,6840,3240,3240,3240,0,3600,3500,3500,0,0,100,100,0,0,0,0,0,0,2316,240,120,240,120,297
2020,431600291,5208,5208,3208,3208,2000,0,0,0,0,0,0,0,0,0,0,0,0,0,516,51,36,72,25,11
2020,431600301,3906,1976,1676,1376,300,1930,0,0,0,0,1930,830,600,500,750,750,0,250,2937,638,25,220,394,52
2020,431600311,38492,10140,10140,10140,0,28352,25800,11800,14000,0,2552,100,2452,0,0,0,0,0,1604,260,200,120,62,53
2020,431600331,68724,6656,6656,6656,0,62068,59500,34500,25000,0,2568,2500,68,0,15700,15700,15700,0,3639,120,120,96,173,17
2020,431600341,30150,1060,1060,1060,0,29090,29000,15000,14000,0,90,0,90,0,0,0,0,0,733,214,120,60,27,18
2020,431600351,27544,7563,7563,7563,0,19981,18500,8500,10000,0,1481,1300,181,0,1030,1030,0,1000,3445,240,450,360,95,245
2020,431600361,2558,2508,408,408,2100,50,0,0,0,0,50,50,0,0,0,0,0,0,2762,360,1200,230,72,13
2020,431600371,37004,6191,6191,6191,0,30813,29500,21500,8000,0,1313,1200,113,0,4327,3327,3312,0,3520,360,200,360,240,650
2020,431600381,61220,5520,5520,5520,0,55700,33000,3000,30000,0,22700,700,22000,0,0,0,0,0,1724,264,700,230,90,84
2020,431700201,25080,80,80,80,0,25000,25000,25000,0,0,0,0,0,0,0,0,0,0,1120,360,240,30,20,37
2020,431700221,45253,11313,11313,10313,0,33940,31640,12000,9000,10640,2300,600,1000,700,11472,11472,6300,5140,3476,150,200,252,324,34
2020,431700241,8231,7731,7731,7731,0,500,0,0,0,0,500,500,0,0,1310,1310,1050,0,2027,135,100,78,246,37
2020,431700251,15963,2413,2413,2413,0,13550,13000,13000,0,0,550,550,0,0,0,0,0,0,1366,144,70,180,132,53
2020,431700261,133121,15425,15425,15425,0,117696,114000,43000,25000,46000,3696,3470,226,0,44000,28000,28000,0,5670,360,80,700,200,7338
2020,431700271,50112,8492,8492,8492,0,41620,41000,41000,0,0,620,390,230,0,0,0,0,0,4266,420,70,336,120,304
2020,431700281,14676,4556,4556,4556,0,10120,10000,10000,0,0,120,120,0,0,4250,4250,3830,0,2610,160,30,290,250,109
2020,431700321,13950,3100,3100,3100,0,10850,10000,0,10000,0,850,200,650,0,3000,3000,3000,0,845,144,36,240,48,24
2020,431700331,51429,9979,9979,9979,0,41450,39000,24000,15000,0,2450,950,1500,0,300,300,0,300,3610,800,100,500,360,314
2020,431700341,7010,10,10,10,0,7000,7000,7000,0,0,0,0,0,0,620,620,620,0,475,180,120,12,18,17
2020,431700351,44610,12510,12510,7510,0,32100,25000,25000,0,0,7100,3300,3800,0,11100,11100,9100,2000,6010,240,80,360,240,513
2020,431700361,80266,3616,3616,3616,0,76650,73000,55000,18000,0,3650,1450,2200,0,25440,25040,25000,0,2837,140,5,120,216,220
2020,431700381,31172,18722,3722,3722,15000,12450,9000,0,9000,0,3450,3150,300,0,10000,2000,0,0,2760,300,520,260,170,99
2020,431800221,45772,12812,12812,12812,0,32960,32000,20000,12000,0,960,700,260,0,0,0,0,0,2970,840,100,300,150,103
2020,431800231,59238,11982,11982,11982,0,47256,46800,20300,26500,0,456,0,456,0,14900,14400,14000,0,2410,280,120,120,120,38
2020,431800311,34793,10343,10343,10343,0,24450,23500,23500,0,0,950,950,0,0,0,0,0,0,1740,380,150,150,70,474
2020,431800321,80,30,30,30,0,50,0,0,0,0,50,0,50,0,0,0,0,0,762,120,20,10,12,1
2020,431800331,31206,7106,7106,7106,0,24100,23000,23000,0,0,1100,300,800,0,0,0,0,0,2540,200,150,310,130,29
2020,431800341,30750,5670,5670,5670,0,25080,25000,25000,0,0,80,80,0,0,400,400,0,400,4840,360,50,780,200,187
2020,431800351,20495,16895,3395,3395,13500,3600,3000,0,0,3000,600,600,0,0,0,0,0,0,2540,240,300,240,240,97
2020,431800361,83550,8250,8250,8250,0,75300,75000,43000,32000,0,300,100,200,0,40000,14000,14000,0,4300,280,300,300,170,456
2020,431800371,19450,650,650,650,0,18800,14800,5600,9200,0,4000,800,3200,0,3300,3300,0,3300,1400,150,240,180,0,9
2020,431800381,200,200,200,200,0,0,0,0,0,0,0,0,0,0,0,0,0,0,510,90,80,30,15,1
2020,431900211,9800,800,800,800,0,9000,9000,9000,0,0,0,0,0,0,0,0,0,0,849,50,360,20,24,13
2020,431900221,2760,2760,1760,1760,1000,0,0,0,0,0,0,0,0,0,4900,4900,0,3400,3408,888,120,360,360,205
2020,431900231,24016,5646,5646,5646,0,18370,18000,15000,3000,0,370,280,90,0,5906,5906,5906,0,3056,240,36,360,360,582
2020,431900251,106990,2390,2390,2390,0,104600,100000,100000,0,0,4600,2100,0,2500,50500,27500,27000,500,2277,341,120,180,192,303
2020,431900261,5270,5270,1770,1770,3500,0,0,0,0,0,0,0,0,0,0,0,0,0,487,213,30,14,14,1
2020,431900271,7430,6430,5930,5930,500,1000,0,0,0,0,1000,1000,0,0,930,930,0,0,2460,620,30,120,260,56
2020,431900291,45354,18832,18832,18832,0,26522,26000,26000,0,0,522,342,180,0,70,70,0,0,2981,216,40,300,264,138
2020,431900301,11270,10270,2270,2270,8000,1000,0,0,0,0,1000,1000,0,0,4200,4200,4000,200,3230,430,105,350,300,122
2020,431900331,7106,6106,3106,2906,3000,1000,0,0,0,0,1000,1000,0,0,3268,3268,0,0,4876,514,70,980,276,308
2020,431900341,120,20,20,20,0,100,0,0,0,0,100,100,0,0,2000,2000,0,0,1182,240,60,240,72,27
2020,431900351,14332,6182,6182,6182,0,8150,8000,8000,0,0,150,150,0,0,0,0,0,0,2140,230,30,410,180,69
2020,431900361,26436,3376,3376,3376,0,23060,23000,23000,0,0,60,60,0,0,0,0,0,0,5020,440,240,280,300,407
2020,431900371,36975,400,400,400,0,36575,36400,22000,14400,0,175,0,175,0,0,0,0,0,1442,300,340,30,72,42
2020,431900391,4440,390,390,390,0,4050,4000,4000,0,0,50,0,50,0,0,0,0,0,1352,800,60,42,40,4
2020,432000202,19600,18600,3100,3100,15500,1000,0,0,0,0,1000,1000,0,0,12000,12000,12000,0,1568,264,20,120,200,35
2020,432000222,37206,10056,10056,8456,0,27150,26000,26000,0,0,1150,1150,0,0,4544,4544,4544,0,3913,221,24,120,396,58
2020,432000242,49350,13700,13700,13700,0,35650,35000,35000,0,0,650,650,0,0,0,0,0,0,3340,360,1000,240,200,1041
2020,432000262,40887,8637,8637,8637,0,32250,31500,17000,12000,2500,750,700,50,0,17000,7000,7000,0,7422,264,600,800,168,119
2020,432000272,19418,5862,5562,4562,300,13556,9843,0,0,9843,3713,2363,1000,350,0,0,0,0,2990,360,20,1200,192,125
2020,432000282,880,880,380,380,500,0,0,0,0,0,0,0,0,0,0,0,0,0,1444,480,180,120,144,11
2020,432000292,16410,16410,3410,3410,13000,0,0,0,0,0,0,0,0,0,1500,1500,1500,0,712,240,10,36,66,1
2020,432000302,14950,6580,6580,6580,0,8370,6000,6000,0,0,2370,1920,450,0,0,0,0,0,1112,72,50,180,140,37
2020,432000312,106854,38696,38696,38696,0,68158,63810,3810,60000,0,4348,2470,1878,0,0,0,0,0,2262,243,200,260,168,224
2020,432600201,1170,1170,1170,1170,0,0,0,0,0,0,0,0,0,0,0,0,0,0,1220,140,200,60,30,1
2020,432600241,2015,2015,15,15,2000,0,0,0,0,0,0,0,0,0,2028,2028,2000,0,1154,372,5,10,17,1
2020,432600251,341570,11570,11570,11230,0,330000,330000,60000,270000,0,0,0,0,0,153000,91000,91000,0,5090,480,500,500,360,2055
2020,432600271,11180,1680,1680,1680,0,9500,9000,9000,0,0,500,500,0,0,5400,5400,5400,0,1702,300,260,120,120,38
2020,432600311,10490,1460,1460,1460,0,9030,9000,6000,3000,0,30,0,30,0,0,0,0,0,1320,50,230,20,70,42
2020,432600321,14890,5690,5690,5690,0,9200,8000,8000,0,0,1200,1150,50,0,300,300,0,300,1727,188,60,200,156,39
2020,432600331,17210,1660,1660,1660,0,15550,15000,15000,0,0,550,50,500,0,10000,10000,10000,0,2128,132,300,350,336,77
2020,432600341,31556,5606,5606,5106,0,25950,25000,18000,7000,0,950,950,0,0,22492,22492,16492,6000,3146,600,36,380,210,501
2020,432700201,13780,9500,8500,8500,1000,4280,4000,0,0,4000,280,280,0,0,0,0,0,0,1266,234,10,140,132,132
2020,432700251,34660,8920,8920,8920,0,25740,11000,11000,0,0,14740,6300,8440,0,5100,5100,5000,0,3216,150,642,250,84,198
2020,432700281,485,435,150,150,285,50,0,0,0,0,50,50,0,0,0,0,0,0,1369,194,60,244,120,6
2020,432700301,30,30,30,30,0,0,0,0,0,0,0,0,0,0,0,0,0,0,568,130,240,30,40,3
2020,432700311,7970,520,520,520,0,7450,6000,6000,0,0,1450,800,650,0,1200,1200,0,1200,1270,180,60,180,60,88
2020,432700321,37585,10160,10160,10160,0,27425,25600,3800,21800,0,1825,900,925,0,300,300,0,0,2700,260,240,260,90,127
2020,432700331,8693,4880,4880,4880,0,3813,3000,0,3000,0,813,700,113,0,101,101,0,1,2138,460,50,104,132,144
2020,432800221,7897,7897,6897,6897,1000,0,0,0,0,0,0,0,0,0,1000,1000,1000,0,1618,432,300,0,144,1
2020,432800231,61870,21420,21420,21420,0,40450,40000,40000,0,0,450,450,0,0,12800,12800,10500,2300,3600,300,120,240,240,959
2020,432800271,17155,5855,4855,4855,1000,11300,10000,0,10000,0,1300,1300,0,0,10200,1200,0,0,2668,296,340,180,348,163
2020,432800311,39390,12100,12100,12100,0,27290,17000,6000,11000,0,10290,3000,7290,0,7000,7000,3000,4000,3812,490,120,820,192,233
2020,432800331,24512,512,512,512,0,24000,22000,2000,20000,0,2000,500,1500,0,950,950,0,950,1686,134,60,54,228,38
2020,432900201,82288,9354,9354,6754,0,72934,72000,27000,45000,0,934,734,200,0,26554,8554,6754,0,2482,216,440,250,96,145
2020,432900211,25280,22950,3950,3950,19000,2330,0,0,0,0,2330,2330,0,0,2800,2800,2800,0,2552,276,166,320,198,363
2020,432900231,135490,8590,8590,8090,0,126900,114000,30000,84000,0,12900,2400,10500,0,33300,21300,20000,0,5014,1240,240,150,240,339
2020,432900241,17046,6046,6046,6046,0,11000,11000,11000,0,0,0,0,0,0,6430,6430,6380,0,2457,240,10,240,360,17
2020,432900251,12300,8000,2000,1000,6000,4300,0,0,0,0,4300,1300,500,2500,4160,4160,0,3000,1714,84,220,240,140,39
2020,432900271,14650,13650,1650,1650,12000,1000,0,0,0,0,1000,1000,0,0,2000,2000,2000,0,2719,84,10,184,72,484
2020,432900311,11800,1000,1000,1000,0,10800,10800,800,10000,0,0,0,0,0,0,0,0,0,731,80,110,40,36,4
2020,432900321,6310,850,850,850,0,5460,4800,1800,3000,0,660,180,480,0,0,0,0,0,1134,80,160,144,90,10
2020,433000202,3370,2570,570,70,2000,800,0,0,0,0,800,800,0,0,0,0,0,0,2226,840,40,324,176,35
2020,433000222,152530,6500,6500,6500,0,146030,144400,30000,114400,0,1630,1100,530,0,0,0,0,0,2040,450,150,240,120,65
2020,433600221,77767,827,827,827,0,76940,68000,50000,18000,0,8940,1000,940,7000,9000,1000,1000,0,1044,200,60,150,24,80
2020,433700201,23370,220,220,220,0,23150,23000,23000,0,0,150,150,0,0,4300,4300,4300,0,1332,180,60,180,96,52
2020,433700211,37830,5325,5325,5325,0,32505,27000,27000,0,0,5505,5049,456,0,17815,17815,9000,5000,8820,300,600,600,360,1671
2020,433700221,33614,4480,4480,4280,0,29134,27000,27000,0,0,2134,1678,456,0,0,0,0,0,4660,400,100,200,160,374
2020,433800201,29930,9780,3280,2780,6500,20150,20000,0,20000,0,150,100,50,0,16500,0,0,0,1948,109,80,360,120,58
2020,433900201,26310,280,280,280,0,26030,26000,26000,0,0,30,0,30,0,0,0,0,0,595,100,70,5,30,9
2020,440000212,86471,5905,5905,5905,0,80566,80000,75000,5000,0,566,340,226,0,4000,0,0,0,2924,536,200,390,138,4347
2020,440000232,45575,22525,22525,22525,0,23050,20000,20000,0,0,3050,3050,0,0,300,300,0,0,5057,303,102,601,156,1730
2020,440000242,6217,6217,1217,1217,5000,0,0,0,0,0,0,0,0,0,0,0,0,0,2744,181,61,241,182,4
2020,440000252,215,215,15,15,200,0,0,0,0,0,0,0,0,0,0,0,0,0,437,121,5,15,36,0
2020,440000262,2691,1241,1141,841,100,1450,0,0,0,0,1450,600,550,300,39,39,0,0,3044,156,42,276,545,256
2020,440000272,16323,360,360,360,0,15963,15500,15500,0,0,463,0,463,0,100,0,0,0,1496,84,72,96,84,16
2020,440000282,56856,31446,31446,28446,0,25410,21000,21000,0,0,4410,3900,510,0,0,0,0,0,2645,278,72,216,210,257
2020,440000292,17450,5450,5450,5450,0,12000,12000,12000,0,0,0,0,0,0,0,0,0,0,1905,188,243,190,89,19
2020,440000302,75544,36466,36466,36466,0,39078,35000,30000,5000,0,4078,3400,678,0,0,0,0,0,8350,1360,200,720,600,1152
2020,440000312,23620,2720,2720,2720,0,20900,20000,20000,0,0,900,900,0,0,13020,13020,13000,0,4180,500,800,240,480,26
2020,440000322,2000,500,300,300,200,1500,0,0,0,0,1500,1500,0,0,450,450,0,400,3360,600,48,360,240,72
2020,440000332,25612,14612,12312,12312,2300,11000,3000,0,3000,0,8000,0,8000,0,2800,2800,0,2800,1800,50,50,50,50,55
2020,440000342,17560,16360,5360,5360,11000,1200,0,0,0,0,1200,1200,0,0,10500,10500,6000,4500,1405,130,10,180,60,67
2020,440000352,10800,7100,1600,1600,5500,3700,0,0,0,0,3700,3700,0,0,0,0,0,0,2240,120,400,180,90,319
2020,440000372,22700,22400,2400,2400,20000,300,0,0,0,0,300,300,0,0,0,0,0,0,1031,216,30,120,60,18
2020,440000382,6006,6006,6,6,6000,0,0,0,0,0,0,0,0,0,6050,6050,6000,0,567,166,120,10,120,0
2020,440600211,12864,12818,8818,7728,4000,46,0,0,0,0,46,0,46,0,0,0,0,0,850,68,10,50,84,1
2020,440600221,25422,8066,8066,8066,0,17356,17300,17300,0,0,56,0,56,0,0,0,0,0,1923,276,96,50,27,37
2020,440600231,36046,15769,15769,15769,0,20277,20000,20000,0,0,277,190,87,0,0,0,0,0,1507,168,420,240,58,41
2020,440600241,160685,35885,35885,35885,0,124800,120000,50000,70000,0,4800,3300,1500,0,21000,21000,21000,0,7905,421,436,980,209,1264
2020,440600251,4729,1316,1316,1316,0,3413,2600,2600,0,0,813,700,113,0,0,0,0,0,1850,134,456,243,62,51
2020,440600261,69214,10634,10634,10634,0,58580,53100,29000,24100,0,5480,2930,1550,1000,10000,0,0,0,6608,295,350,540,268,669
2020,440600271,46111,13431,13431,13431,0,32680,31000,31000,0,0,1680,1500,180,0,5000,5000,5000,0,5380,350,40,480,420,834
2020,440600311,41390,1710,1710,1710,0,39680,36000,1000,35000,0,3680,0,3680,0,0,0,0,0,800,300,150,10,40,145
2020,440600321,12450,200,200,200,0,12250,12000,8000,4000,0,250,250,0,0,500,0,0,0,631,180,150,50,36,53
2020,440600331,7200,6400,1400,1400,5000,800,0,0,0,0,800,800,0,0,20,20,0,0,790,150,30,100,70,156
2020,440600351,9450,450,450,450,0,9000,9000,9000,0,0,0,0,0,0,0,0,0,0,385,90,30,10,10,14
2020,440600361,4722,3922,3422,3422,500,800,0,0,0,0,800,800,0,0,0,0,0,0,2304,330,500,300,204,89
2020,440600371,38417,9017,9017,9017,0,29400,27000,27000,0,0,2400,400,2000,0,3000,3000,0,3000,3660,420,60,300,240,75
2020,440600381,41054,9004,9004,8004,0,32050,28000,16000,12000,0,4050,2050,2000,0,7475,7475,7475,0,2612,300,20,360,180,206
2020,440700231,117076,8837,8837,8837,0,108239,105000,83000,22000,0,3239,2990,249,0,30200,5000,5000,0,9692,287,390,630,360,809
2020,440700281,36331,5033,5033,5033,0,31298,31000,18000,13000,0,298,120,178,0,75,75,0,0,1599,228,288,184,60,100
2020,440700321,17715,1815,1815,1815,0,15900,14000,14000,0,0,1900,1900,0,0,1000,1000,1000,0,988,156,60,180,72,63
2020,440700331,15670,5870,5870,5870,0,9800,8000,7000,0,1000,1800,1800,0,0,0,0,0,0,2840,220,150,460,110,190
2020,440700371,55026,14226,14226,14226,0,40800,40000,40000,0,0,800,800,0,0,7800,7800,7800,0,3810,276,860,300,300,575
2020,440700391,17660,3200,3200,3200,0,14460,14460,3500,10960,0,0,0,0,0,8000,1500,0,1500,1972,156,800,120,60,18
2020,440800201,9594,9484,7734,7434,1750,110,0,0,0,0,110,110,0,0,1530,1530,0,1500,2072,384,9,477,288,30
2020,440800251,32597,1722,1722,1722,0,30875,29000,28000,1000,0,1875,1450,425,0,24720,24720,16120,600,3494,160,35,500,230,53
2020,440800271,43249,7819,7819,7819,0,35430,31000,31000,0,0,4430,4010,420,0,0,0,0,0,4460,228,98,432,158,1403
2020,440800311,3540,2240,240,240,2000,1300,0,0,0,0,1300,1300,0,0,3967,3967,0,2187,6300,1500,50,1000,300,128
2020,440800321,4635,1535,1535,1535,0,3100,0,0,0,0,3100,3100,0,0,200,200,0,0,2570,140,10,350,170,180
2020,440800341,35304,10854,10854,10854,0,24450,20000,20000,0,0,4450,3780,670,0,8642,8642,7342,1300,3930,400,100,550,430,765
2020,440800361,11756,9306,2906,2906,6400,2450,0,0,0,0,2450,2450,0,0,3100,3100,3100,0,1892,180,100,420,200,64
2020,440800371,6888,1888,1888,1888,0,5000,5000,5000,0,0,0,0,0,0,0,0,0,0,1530,240,240,180,120,53
2020,440800381,30898,12220,12220,12220,0,18678,15000,15000,0,0,3678,3000,678,0,0,0,0,0,4570,320,900,300,50,83
2020,440900201,30404,1169,1169,1169,0,29235,29000,29000,0,0,235,0,235,0,0,0,0,0,2236,385,143,198,207,55
2020,440900221,5480,5090,2090,2090,3000,390,0,0,0,0,390,0,390,0,936,936,0,936,3381,152,31,602,181,35
2020,440900231,27494,26650,18650,18650,8000,844,0,0,0,0,844,50,794,0,0,0,0,0,3987,332,351,484,444,367
2020,440900241,35734,11972,11972,11972,0,23762,22000,22000,0,0,1762,1530,232,0,7000,3000,3000,0,2244,780,120,50,120,39
2020,440900251,59923,17753,17753,17753,0,42170,40000,15000,25000,0,2170,1650,520,0,11000,8000,0,8000,5340,810,120,240,120,323
2020,440900261,22527,680,680,680,0,21847,21500,13000,4000,4500,347,330,17,0,8000,8000,4000,4000,2064,170,540,324,98,44
2020,440900271,24235,5566,5566,5566,0,18669,16000,16000,0,0,2669,2620,49,0,4390,4390,4360,0,1513,216,203,300,132,125
2020,440900281,35138,13675,13675,13675,0,21463,17500,17500,0,0,3963,3670,293,0,3000,3000,3000,0,4212,305,95,840,190,215
2020,440900301,42700,550,550,550,0,42150,40000,13000,27000,0,2150,1850,300,0,0,0,0,0,2490,150,250,250,280,145
2020,440900311,9360,360,360,360,0,9000,9000,9000,0,0,0,0,0,0,3904,3904,3904,0,1800,150,20,70,200,21
2020,440900341,9210,3540,3540,2340,0,5670,4000,4000,0,0,1670,1400,270,0,1506,1506,0,1200,1997,456,115,160,316,46
2020,440900371,13544,12344,3344,3344,9000,1200,0,0,0,0,1200,1200,0,0,0,0,0,0,1453,168,10,420,60,134
2020,440900381,164930,7430,7430,7430,0,157500,155000,25000,130000,0,2500,1600,900,0,89500,80000,60000,0,2254,360,120,60,80,5021
2020,441000202,186,186,126,126,60,0,0,0,0,0,0,0,0,0,0,0,0,0,1897,228,15,12,181,1
2020,441000222,17262,305,305,305,0,16957,13000,13000,0,0,3957,3957,0,0,3000,0,0,0,4089,96,10,500,244,632
2020,441000232,11348,4033,4033,4033,0,7315,7230,7230,0,0,85,0,85,0,0,0,0,0,1107,64,186,17,58,19
2020,441000242,38367,9283,9283,9283,0,29084,28000,10000,18000,0,1084,1000,84,0,0,0,0,0,924,120,48,84,48,57
2020,441000252,11532,4132,4132,4132,0,7400,7000,7000,0,0,400,400,0,0,0,0,0,0,1709,89,560,280,72,14
2020,441000272,78171,27741,1741,1741,26000,50430,50000,0,50000,0,430,430,0,0,19000,19000,19000,0,2979,372,58,531,114,367
2020,441000282,13924,5724,5724,5724,0,8200,8000,8000,0,0,200,200,0,0,0,0,0,0,1210,180,300,240,60,8
2020,441000292,310,310,110,110,200,0,0,0,0,0,0,0,0,0,0,0,0,0,595,372,20,10,20,0
2020,441000302,13400,1300,1300,1300,0,12100,9000,9000,0,0,3100,3100,0,0,2000,2000,0,0,1550,120,300,600,150,280
2020,441000312,26723,423,423,423,0,26300,8000,8000,0,0,18300,15300,0,3000,13979,13979,4400,1550,4330,300,120,1440,480,105
2020,441000322,7800,600,600,600,0,7200,6000,6000,0,0,1200,1200,0,0,0,0,0,0,1410,100,10,400,40,463
2020,441000342,46690,13540,13540,13540,0,33150,33000,12000,21000,0,150,150,0,0,0,0,0,0,2020,200,20,120,180,162
2020,441000352,885,185,185,85,0,700,0,0,0,0,700,700,0,0,0,0,0,0,2211,600,50,180,300,19
2020,441000372,6055,25,25,25,0,6030,6000,2000,4000,0,30,0,30,0,0,0,0,0,512,120,48,60,36,4
2020,441000382,21221,251,251,251,0,20970,18000,3000,15000,0,2970,2970,0,0,10100,10100,9500,0,2245,200,100,360,120,64
2020,441000392,17580,4360,4360,4360,0,13220,13100,11000,2100,0,120,120,0,0,0,0,0,0,1350,230,80,10,120,19
2020,441600201,16645,445,445,445,0,16200,16200,16200,0,0,0,0,0,0,100,0,0,0,1381,166,250,135,124,31
2020,441600231,620,620,620,620,0,0,0,0,0,0,0,0,0,0,0,0,0,0,2978,586,1242,25,36,2
2020,441600271,103394,5424,5424,5424,0,97970,96500,28000,68500,0,1470,1100,370,0,52200,51200,50400,800,4626,500,410,700,240,1055
2020,441600281,21063,10600,10600,10600,0,10463,10000,10000,0,0,463,350,113,0,0,0,0,0,2369,741,301,301,84,79
2020,441600291,1410,1410,110,110,1300,0,0,0,0,0,0,0,0,0,0,0,0,0,793,276,83,12,22,1
2020,441600301,71291,15891,15891,15891,0,55400,37000,17000,20000,0,18400,3400,15000,0,4500,4000,4000,0,6666,472,106,140,630,414
2020,441600311,9563,3247,3247,3247,0,6316,5866,5866,0,0,450,450,0,0,1250,1250,400,0,3388,252,355,820,392,168
2020,441600361,100857,5421,5421,5421,0,95436,90100,8500,81600,0,5336,3060,2276,0,500,500,0,500,3050,300,900,550,120,222
2020,441600371,20106,5706,5706,5706,0,14400,13000,13000,0,0,1400,1400,0,0,0,0,0,0,1606,360,60,350,96,96
2020,441600381,27432,8072,8072,7072,0,19360,19000,14000,5000,0,360,190,170,0,50,50,0,50,2892,432,400,240,180,63
2020,441600391,34841,6541,6541,6541,0,28300,22000,22000,0,0,6300,6300,0,0,0,0,0,0,4414,240,480,360,144,419
2020,441700231,21828,12915,7915,4915,5000,8913,8000,0,0,8000,913,600,313,0,0,0,0,0,2638,122,48,256,248,125
2020,441700261,2240,2240,2240,1240,0,0,0,0,0,0,0,0,0,0,0,0,0,0,1363,156,27,375,120,1
2020,441700311,77340,15540,12540,8540,3000,61800,55000,0,55000,0,6800,4800,2000,0,32000,32000,27000,0,7640,840,500,500,200,337
2020,441700321,65978,32978,32978,32978,0,33000,30000,30000,0,0,3000,3000,0,0,0,0,0,0,3040,240,350,60,90,1006
2020,441700331,5215,1215,1215,1215,0,4000,4000,4000,0,0,0,0,0,0,50,50,0,0,2390,240,100,330,240,78
2020,441700371,3000,1500,1500,1500,0,1500,1500,1500,0,0,0,0,0,0,0,0,0,0,727,84,190,15,48,4
2020,441700381,233375,11910,11910,11910,0,221465,190000,50000,140000,0,31465,1165,30300,0,33000,32000,28000,4000,1834,530,180,144,120,343
2020,441700391,44740,4080,4080,4080,0,40660,35000,32000,3000,0,5660,5100,560,0,0,0,0,0,5540,360,350,420,360,864
2020,441800201,48349,15369,15369,15369,0,32980,30500,29000,1500,0,2480,2300,180,0,0,0,0,0,2772,276,360,456,180,225
2020,441800211,39132,13756,13756,13756,0,25376,25000,20000,5000,0,376,150,226,0,0,0,0,0,2879,216,74,436,204,97
2020,441800231,36900,7650,7650,7650,0,29250,28400,28400,0,0,850,850,0,0,20000,20000,10000,10000,6576,384,54,670,195,983
2020,441800241,35525,645,645,645,0,34880,33500,33500,0,0,1380,1380,0,0,13380,13380,5880,7500,2181,225,53,232,54,594
2020,441800251,5306,5290,4790,4790,500,16,0,0,0,0,16,0,16,0,0,0,0,0,2889,604,7,288,300,23
2020,441800261,12503,12128,9128,9128,3000,375,0,0,0,0,375,200,175,0,600,600,0,600,3782,652,15,430,195,14
2020,441800271,2258,2208,408,408,1800,50,0,0,0,0,50,0,50,0,0,0,0,0,580,76,213,61,16,0
2020,441800281,1543,1543,43,43,1500,0,0,0,0,0,0,0,0,0,0,0,0,0,903,280,48,15,42,1
2020,441800301,6603,5003,4003,4003,1000,1600,0,0,0,0,1600,1600,0,0,700,700,0,0,2870,1120,100,200,130,31
2020,441800341,7300,1500,1500,1500,0,5800,5000,5000,0,0,800,0,800,0,200,0,0,0,622,72,72,5,24,5
2020,441800361,10,10,10,10,0,0,0,0,0,0,0,0,0,0,0,0,0,0,950,196,10,36,53,1
2020,441800371,20320,20040,13040,13040,7000,280,0,0,0,0,280,280,0,0,0,0,0,0,1705,90,400,65,120,1202
2020,441900201,75576,20436,20436,20436,0,55140,48000,48000,0,0,7140,4540,2600,0,0,0,0,0,2319,241,67,135,182,373
2020,441900231,1806,1606,1406,1406,200,200,0,0,0,0,200,200,0,0,0,0,0,0,1428,384,11,108,48,29
2020,441900251,3441,1291,791,791,500,2150,0,0,0,0,2150,150,2000,0,1460,1460,0,500,2598,670,493,10,95,1
2020,441900261,15166,1311,1311,1311,0,13855,13000,13000,0,0,855,700,155,0,35,35,0,0,2284,184,380,120,36,293
2020,441900271,37647,3615,3615,3615,0,34032,34000,34000,0,0,32,0,32,0,18134,18134,16484,1600,4265,250,500,600,600,137
2020,441900281,55550,20900,20900,20900,0,34650,29600,29000,600,0,5050,4800,250,0,0,0,0,0,4365,456,128,664,358,796
2020,441900291,35417,24424,20824,15824,3600,10993,10000,0,10000,0,993,900,93,0,5000,5000,0,5000,2217,365,125,691,261,66
2020,441900301,34365,19365,19365,11365,0,15000,12000,8000,4000,0,3000,3000,0,0,0,0,0,0,5320,350,600,400,310,222
2020,441900311,40825,1125,1125,1125,0,39700,27000,7000,20000,0,12700,400,12300,0,0,0,0,0,4340,300,1000,200,210,24
2020,441900331,19955,2189,2189,2189,0,17766,17386,2386,15000,0,380,350,30,0,520,520,0,270,1551,114,100,326,109,33
2020,441900371,52230,33950,33950,33950,0,18280,16900,16900,0,0,1380,1080,300,0,0,0,0,0,1700,180,240,300,40,165
2020,441900381,8292,5892,5892,5892,0,2400,2000,2000,0,0,400,0,400,0,300,300,0,300,644,170,80,14,35,8
2020,442000212,18815,4705,3705,3705,1000,14110,13000,0,0,13000,1110,1000,110,0,3000,3000,0,3000,1183,552,10,149,48,113
2020,442000222,2194,704,204,204,500,1490,0,0,0,0,1490,1490,0,0,0,0,0,0,3210,624,204,204,408,45
2020,442000232,1427,1427,1127,1127,300,0,0,0,0,0,0,0,0,0,35000,35000,0,35000,841,181,201,36,61,4
2020,442000242,3335,2335,2235,2235,100,1000,0,0,0,0,1000,1000,0,0,2400,2400,0,2000,1328,324,10,172,132,42
2020,442000312,24150,1130,1130,1130,0,23020,23000,23000,0,0,20,0,20,0,3540,1540,1500,0,934,150,150,10,24,49
2020,442000322,23324,9000,9000,9000,0,14324,14324,3000,11324,0,0,0,0,0,0,0,0,0,628,163,70,20,29,9
2020,442000332,21560,2222,2222,2222,0,19338,18879,1500,17379,0,459,0,459,0,0,0,0,0,1544,91,730,40,103,7
2020,442000342,9970,2120,2120,2120,0,7850,6470,5400,1070,0,1380,0,1380,0,0,0,0,0,1074,194,50,35,85,5
2020,442000352,7094,4644,3644,3644,1000,2450,0,0,0,0,2450,2450,0,0,100,100,0,0,3990,780,220,500,150,607
2020,442000372,6856,6356,4356,4356,2000,500,0,0,0,0,500,500,0,0,0,0,0,0,1642,315,250,120,84,40
2020,442000392,131050,1350,1350,1350,0,129700,116000,21000,95000,0,13700,1700,12000,0,51970,49470,40000,6800,4044,360,120,360,240,2091
2020,442600201,46150,5811,5811,5811,0,40339,40000,40000,0,0,339,0,339,0,18733,18733,18733,0,1905,235,32,57,120,47
2020,442600221,45458,17208,17208,17208,0,28250,28000,28000,0,0,250,250,0,0,11220,11220,10720,500,2525,357,32,188,230,206
2020,442600231,4553,4433,733,733,3700,120,0,0,0,0,120,0,120,0,1800,1800,0,0,1248,324,96,90,108,16
2020,442600301,14062,384,384,384,0,13678,12300,5000,7300,0,1378,1000,378,0,7120,7120,6500,0,1906,225,95,560,55,30
2020,442600311,32877,6814,6814,6814,0,26063,25850,1500,24350,0,213,0,213,0,0,0,0,0,899,231,240,50,58,19
2020,442600321,1243,1215,1215,1215,0,28,0,0,0,0,28,28,0,0,0,0,0,0,1320,100,50,240,90,7
2020,442600331,10312,2216,2216,2216,0,8096,6660,6660,0,0,1436,1436,0,0,845,845,0,0,1241,169,110,176,38,31
2020,442700201,46144,28700,28700,28700,0,17444,17000,17000,0,0,444,200,244,0,0,0,0,0,3579,192,50,459,288,1033
2020,442700211,23464,5112,5112,5112,0,18352,17000,17000,0,0,1352,900,452,0,4664,4664,3664,1000,2533,192,120,370,180,62
2020,442700231,62769,12099,12099,12099,0,50670,50000,50000,0,0,670,450,220,0,0,0,0,0,5939,572,110,385,240,1281
2020,442700301,15964,1840,1840,1840,0,14124,14000,7000,7000,0,124,0,124,0,0,0,0,0,1010,230,210,30,69,3
2020,442700321,6384,2384,2384,2384,0,4000,4000,4000,0,0,0,0,0,0,0,0,0,0,958,190,60,10,30,5
2020,442700331,9493,4493,4493,4493,0,5000,5000,5000,0,0,0,0,0,0,0,0,0,0,1592,154,180,148,180,293
2020,442700341,10128,2428,2428,2428,0,7700,5000,5000,0,0,2700,2700,0,0,2500,2500,0,0,1590,150,10,200,240,67
2020,442700351,9752,3132,3132,3132,0,6620,6000,4000,2000,0,620,500,120,0,0,0,0,0,1066,60,240,240,36,9
2020,442800221,4883,4843,1443,1443,3400,40,0,0,0,0,40,0,40,0,2613,2613,2600,0,931,170,30,120,100,0
2020,442800341,2500,1000,1000,1000,0,1500,1500,1500,0,0,0,0,0,0,0,0,0,0,776,96,360,10,29,3
2020,442800351,12560,550,550,550,0,12010,11000,2600,8400,0,1010,0,1010,0,0,0,0,0,646,180,36,60,36,6
2020,442800361,3870,700,700,700,0,3170,3000,3000,0,0,170,0,170,0,0,0,0,0,595,83,180,10,15,31
2020,442800391,22296,6246,6246,6246,0,16050,15000,15000,0,0,1050,1050,0,0,10300,10300,4500,5800,1740,180,100,300,240,423
2020,442900201,250,250,50,50,200,0,0,0,0,0,0,0,0,0,5,5,0,0,658,108,12,12,4,3
2020,442900211,11235,1415,1415,1415,0,9820,8000,8000,0,0,1820,1820,0,0,0,0,0,0,888,132,12,48,60,80
2020,442900221,3201,3001,101,101,2900,200,0,0,0,0,200,200,0,0,1000,1000,0,1000,2180,336,215,138,227,36
2020,442900231,34510,33141,21341,21341,11800,1369,0,0,0,0,1369,1188,181,0,0,0,0,0,4785,379,621,433,341,619
2020,442900241,26177,3064,3064,3064,0,23113,22000,22000,0,0,1113,1000,113,0,9400,9400,0,0,1492,144,30,360,120,65
2020,442900301,5027,3327,1027,1027,2300,1700,0,0,0,0,1700,1700,0,0,4100,4100,1500,0,3202,348,10,180,480,51
2020,442900321,14500,400,400,400,0,14100,13400,5400,8000,0,700,200,500,0,800,800,400,400,1396,230,120,320,62,99
2020,442900331,16315,215,215,215,0,16100,16000,7000,9000,0,100,100,0,0,0,0,0,0,1746,144,1000,180,72,55
2020,442900351,25780,3654,3654,3654,0,22126,16500,12000,4500,0,5626,3900,1726,0,7400,7400,7400,0,3146,180,200,360,216,89
2020,442900361,4502,522,522,522,0,3980,3980,3980,0,0,0,0,0,0,0,0,0,0,804,180,60,60,36,2
2020,442900371,9828,6380,6380,6380,0,3448,2835,0,2835,0,613,300,313,0,1000,1000,1000,0,1448,144,350,130,80,19
2020,442900381,8138,1795,1795,1795,0,6343,6140,5000,1140,0,203,90,113,0,80,80,0,0,2096,114,800,240,108,15
2020,442900391,10445,995,995,995,0,9450,9000,9000,0,0,450,450,0,0,9390,9390,6700,2600,2545,150,120,550,120,189
2020,443000302,3501,2701,2701,2701,0,800,0,0,0,0,800,800,0,0,0,0,0,0,1892,392,100,360,120,1
2020,443000312,51902,2502,2502,2502,0,49400,47400,30000,17400,0,2000,2000,0,0,15000,15000,15000,0,3360,750,20,600,480,108
2020,443000322,19400,5700,5700,5700,0,13700,12000,0,12000,0,1700,1500,200,0,3600,3100,2700,0,845,80,60,120,72,145
2020,450000202,19738,2838,2838,2838,0,16900,16300,15300,1000,0,600,600,0,0,4800,4800,3000,1500,1997,216,100,420,312,49
2020,450000212,14000,6000,6000,6000,0,8000,8000,8000,0,0,0,0,0,0,0,0,0,0,1110,180,150,15,72,48
2020,450000232,28410,10010,6510,6510,3500,18400,15000,0,15000,0,3400,3400,0,0,2400,2400,2000,400,2913,204,180,480,214,35
2020,450000242,870,870,870,870,0,0,0,0,0,0,0,0,0,0,100,100,0,0,236,30,10,10,11,1
2020,450000252,28,28,28,28,0,0,0,0,0,0,0,0,0,0,0,0,0,0,1434,344,140,10,240,1
2020,450000272,2960,2960,1960,1960,1000,0,0,0,0,0,0,0,0,0,0,0,0,0,1590,600,30,120,180,13
2020,450000292,17,17,17,17,0,0,0,0,0,0,0,0,0,0,0,0,0,0,706,300,6,48,127,1
2020,450000302,21804,9804,9804,9804,0,12000,11500,11500,0,0,500,500,0,0,1400,1400,700,700,1418,270,120,120,168,33
2020,450000322,57680,1090,1090,1090,0,56590,56000,14000,42000,0,590,590,0,0,38900,3400,3400,0,983,230,98,180,62,111
2020,450000352,42600,37600,36600,36600,1000,5000,0,0,0,0,5000,5000,0,0,0,0,0,0,4410,780,100,500,96,1021
2020,450000372,30084,3484,3484,3484,0,26600,16500,16500,0,0,10100,1600,8500,0,13180,13180,12000,740,5738,324,200,1444,300,86
2020,450000382,146826,33526,33526,33526,0,113300,110000,50000,60000,0,3300,3300,0,0,36850,34850,31350,3500,4900,300,50,100,400,519
2020,450000392,136851,13399,13399,13299,0,123452,117000,50000,67000,0,6452,1000,5452,0,0,0,0,0,5393,320,160,360,230,219
2020,450600221,257,257,17,17,240,0,0,0,0,0,0,0,0,0,160,160,0,0,597,120,0,10,15,0
2020,450600231,51570,4770,4770,4770,0,46800,37000,30000,7000,0,9800,800,0,9000,1480,1480,1300,0,1592,200,60,60,72,19
2020,450600251,65498,50048,50048,10048,0,15450,15000,0,15000,0,450,450,0,0,5000,0,0,0,2410,300,180,200,100,307
2020,450600281,2180,2030,1530,1530,500,150,0,0,0,0,150,150,0,0,10030,10030,7000,3000,3750,300,20,700,300,285
2020,450600291,25255,2895,2895,2695,0,22360,22360,15000,7360,0,0,0,0,0,3500,3500,3000,500,482,80,50,12,30,9
2020,450600301,43574,3284,3284,3284,0,40290,40000,15000,25000,0,290,290,0,0,3000,0,0,0,4173,414,1100,530,154,538
2020,450600311,27846,1076,1076,1076,0,26770,15000,15000,0,0,11770,1500,270,10000,2000,0,0,0,3134,762,840,156,64,33
2020,450600321,39732,11432,11432,11432,0,28300,23000,16000,7000,0,5300,4800,500,0,700,700,700,0,3290,300,100,500,120,194
2020,450600331,22822,13722,13722,13722,0,9100,8000,8000,0,0,1100,1100,0,0,100,100,0,0,2980,220,50,300,120,203
2020,450600361,100,100,100,100,0,0,0,0,0,0,0,0,0,0,0,0,0,0,545,100,110,13,32,1
2020,450600371,129600,600,600,600,0,129000,129000,9000,120000,0,0,0,0,0,0,0,0,0,837,170,270,37,20,526
2020,450600381,36602,9002,9002,9002,0,27600,25000,25000,0,0,2600,2500,100,0,4492,4492,3200,0,4304,480,60,360,300,929
2020,450600391,30059,27059,7559,7559,19500,3000,0,0,0,0,3000,3000,0,0,0,0,0,0,3324,324,20,360,220,113
2020,450700201,21345,12945,12945,12205,0,8400,7000,0,7000,0,1400,1300,100,0,8180,8180,3000,4000,5400,400,500,300,200,376
2020,450700211,9055,55,55,55,0,9000,9000,9000,0,0,0,0,0,0,200,200,200,0,577,204,48,12,24,11
2020,450700231,16332,16332,11132,10484,5200,0,0,0,0,0,0,0,0,0,0,0,0,0,1920,400,60,150,100,168
2020,450700241,6360,260,260,260,0,6100,5000,5000,0,0,1100,1100,0,0,1330,1330,0,0,1670,180,240,240,180,10
2020,450700251,12400,4400,4400,4400,0,8000,8000,8000,0,0,0,0,0,0,0,0,0,0,975,240,300,50,85,19
2020,450700271,30600,16450,16450,16450,0,14150,12000,5000,7000,0,2150,0,1150,1000,0,0,0,0,1018,136,300,15,84,98
2020,450700281,28800,8800,8800,8800,0,20000,20000,20000,0,0,0,0,0,0,0,0,0,0,1704,240,700,36,28,40
2020,450700291,47000,27000,27000,27000,0,20000,20000,20000,0,0,0,0,0,0,0,0,0,0,1180,360,180,50,60,150
2020,450700311,13210,1210,1210,210,0,12000,12000,12000,0,0,0,0,0,0,958,958,0,958,1006,136,150,216,64,17
2020,450700321,1116,1116,991,991,125,0,0,0,0,0,0,0,0,0,300,300,0,300,892,180,10,72,170,0
2020,450700351,223,133,133,133,0,90,0,0,0,0,90,90,0,0,0,0,0,0,1355,245,55,180,78,7
2020,450700361,5850,150,150,150,0,5700,5700,5700,0,0,0,0,0,0,0,0,0,0,785,150,50,30,20,7
2020,450800221,12250,250,250,250,0,12000,12000,12000,0,0,0,0,0,0,300,0,0,0,434,120,36,15,15,27
2020,450800231,579,579,16,16,563,0,0,0,0,0,0,0,0,0,0,0,0,0,550,120,20,10,30,1
2020,450800261,3436,3136,1136,1136,2000,300,0,0,0,0,300,300,0,0,1000,1000,0,0,1780,60,100,360,240,25
2020,450800271,113860,13260,13260,13260,0,100600,100000,45000,55000,0,600,600,0,0,7200,200,0,200,2140,320,10,240,130,199
2020,450800281,26472,10222,10222,10222,0,16250,16000,16000,0,0,250,250,0,0,3400,3400,3400,0,3080,400,20,300,360,54
2020,450800291,10330,1130,1130,1130,0,9200,9000,9000,0,0,200,200,0,0,250,250,0,250,4075,300,1000,300,135,27
2020,450800311,43452,23432,23432,23432,0,20020,19000,18000,1000,0,1020,1020,0,0,4185,4185,4185,0,4260,450,1050,720,360,139
2020,450800321,31343,3130,3130,3130,0,28213,17000,17000,0,0,11213,1100,113,10000,2445,2445,2445,0,2670,260,70,500,120,58
2020,450800331,18904,5814,5814,5814,0,13090,13000,13000,0,0,90,0,90,0,0,0,0,0,1192,106,527,10,62,15
2020,450800341,24833,6633,6633,6633,0,18200,18000,18000,0,0,200,200,0,0,8800,8800,8800,0,2380,340,180,360,180,223
2020,450800351,226500,67100,67100,37100,0,159400,155000,155000,0,0,4400,4400,0,0,81050,42050,42050,0,2900,300,200,250,150,357
2020,450800361,42694,13874,13874,13874,0,28820,27000,27000,0,0,1820,1520,300,0,0,0,0,0,4048,360,120,240,240,1020
2020,450800371,4582,2282,1282,1282,1000,2300,0,0,0,0,2300,2300,0,0,0,0,0,0,2108,488,5,420,240,43
2020,450800381,19500,8900,8900,8900,0,10600,8800,8800,0,0,1800,1800,0,0,9500,9500,9500,0,2620,400,200,500,120,105
2020,450800391,70824,21774,21774,21774,0,49050,48050,25800,22250,0,1000,900,100,0,19000,0,0,0,7520,200,50,1000,420,1431
2020,450900211,880,880,580,580,300,0,0,0,0,0,0,0,0,0,9000,9000,0,0,1266,516,24,48,48,1
2020,450900221,7012,512,512,512,0,6500,6500,6500,0,0,0,0,0,0,0,0,0,0,572,109,180,30,29,5
2020,450900231,9862,9862,362,362,9500,0,0,0,0,0,0,0,0,0,9500,9500,0,0,784,360,10,24,0,1
2020,450900241,10560,10160,3660,3660,6500,400,0,0,0,0,400,400,0,0,6283,6283,0,5503,2170,240,100,600,330,74
2020,450900271,123700,12300,12300,12300,0,111400,111400,37000,74400,0,0,0,0,0,3010,10,0,0,1760,600,60,60,96,95
2020,450900281,16456,6556,6556,6556,0,9900,9400,9400,0,0,500,500,0,0,5521,5521,5321,0,2382,216,70,240,180,45
2020,450900311,656250,21550,21550,21550,0,634700,631000,21000,610000,0,3700,3700,0,0,265000,150000,100000,50000,3630,300,50,240,180,3539
2020,450900331,30055,29435,17435,17435,12000,620,0,0,0,0,620,620,0,0,500,500,0,500,3080,300,50,650,380,352
2020,450900341,36349,2349,2349,2349,0,34000,32000,32000,0,0,2000,2000,0,0,6362,6362,3936,0,1850,360,300,240,120,53
2020,450900361,23166,13866,5866,3866,8000,9300,9000,0,9000,0,300,100,200,0,11000,0,0,0,2580,400,100,550,360,33
2020,450900371,30590,11540,11540,6540,0,19050,17500,16000,1500,0,1550,1550,0,0,8484,8484,1984,6500,3470,276,50,820,324,646
2020,450900391,75680,2880,2880,2880,0,72800,71000,11000,60000,0,1800,1800,0,0,48000,35000,23000,12000,3000,200,50,400,150,586
2020,451000212,2130,2030,30,30,2000,100,0,0,0,0,100,100,0,0,2000,2000,0,0,2376,150,36,600,156,51
2020,451000222,1970,1670,1570,1570,100,300,0,0,0,0,300,300,0,0,130,130,0,0,1280,420,60,240,60,52
2020,451000232,10390,10190,8190,8190,2000,200,0,0,0,0,200,200,0,0,0,0,0,0,1250,480,50,120,120,103
2020,451000262,16574,3374,3374,3374,0,13200,12000,12000,0,0,1200,1200,0,0,3640,3640,3640,0,3006,336,10,400,300,114
2020,451000292,21700,8400,8400,8400,0,13300,13000,13000,0,0,300,300,0,0,0,0,0,0,1081,324,60,120,97,121
2020,451000302,59234,10434,10434,10434,0,48800,47000,13000,34000,0,1800,1800,0,0,25000,0,0,0,3828,220,350,660,192,902
2020,451000312,28092,2692,2692,2692,0,25400,23000,11000,12000,0,2400,2400,0,0,0,0,0,0,2500,250,200,400,150,100
2020,451000322,10315,9915,315,315,9600,400,0,0,0,0,400,400,0,0,8530,8530,7980,0,4164,240,300,240,124,31
2020,451000332,15593,15243,4378,4298,10865,350,0,0,0,0,350,350,0,0,11,11,0,0,2393,348,150,220,120,14
2020,451000352,24720,2720,2720,2720,0,22000,22000,10000,12000,0,0,0,0,0,0,0,0,0,592,100,18,24,60,48
2020,451000362,38000,5500,5500,5500,0,32500,32500,5500,27000,0,0,0,0,0,0,0,0,0,785,110,30,15,40,9
2020,451000372,520,520,520,520,0,0,0,0,0,0,0,0,0,0,0,0,0,0,2648,240,10,70,220,141
2020,451000392,32116,10516,10516,10516,0,21600,20000,12000,8000,0,1600,1600,0,0,553,553,553,0,1439,204,180,190,144,31
2020,451600221,180922,19122,19122,17122,0,161800,150000,95000,55000,0,11800,8800,3000,0,10000,10000,10000,0,6280,1200,300,500,360,2246
2020,451600261,9300,8400,5200,5200,3200,900,0,0,0,0,900,500,400,0,40,40,0,0,1881,340,20,51,100,20
2020,451600271,22860,3060,3060,3060,0,19800,19000,19000,0,0,800,800,0,0,13820,13820,11560,0,3024,360,120,360,324,67
2020,451600281,31514,8264,8264,8264,0,23250,22000,22000,0,0,1250,1100,150,0,0,0,0,0,1463,360,50,240,96,76
2020,451600291,5520,5520,20,20,5500,0,0,0,0,0,0,0,0,0,13,13,0,0,399,55,5,36,18,2
2020,451600301,280,280,80,80,200,0,0,0,0,0,0,0,0,0,0,0,0,0,923,150,30,50,43,0
2020,451600311,45058,14518,14518,14518,0,30540,26000,21000,5000,0,4540,4540,0,0,1700,1700,0,1700,5560,590,30,800,290,1019
2020,451600321,31928,9726,9726,4726,0,22202,21000,21000,0,0,1202,750,452,0,4000,4000,0,4000,2660,300,120,300,120,192
2020,451600341,15550,50,50,50,0,15500,15500,15500,0,0,0,0,0,0,0,0,0,0,640,180,120,30,30,7
2020,451600351,32070,70,70,70,0,32000,32000,12000,20000,0,0,0,0,0,0,0,0,0,570,70,150,40,20,41
2020,451600371,24920,4420,4420,4420,0,20500,19500,19500,0,0,1000,1000,0,0,1000,1000,1000,0,4470,300,130,480,240,467
2020,451600381,22593,10793,10793,10793,0,11800,11000,10000,1000,0,800,800,0,0,200,0,0,0,1802,240,380,300,162,34
2020,451700201,50022,1472,1472,1472,0,48550,45000,45000,0,0,3550,1550,0,2000,20050,20050,19950,0,2260,360,60,480,120,72
2020,451700211,5550,5050,4550,4550,500,500,0,0,0,0,500,500,0,0,2800,2800,2800,0,2306,100,12,100,144,272
2020,451700221,6250,250,250,250,0,6000,6000,6000,0,0,0,0,0,0,0,0,0,0,394,0,10,15,24,10
2020,451700271,2840,640,140,140,500,2200,0,0,0,0,2200,2200,0,0,980,980,0,860,2114,526,60,180,144,121
2020,451700321,184,184,4,4,180,0,0,0,0,0,0,0,0,0,0,0,0,0,678,168,30,96,24,0
2020,451700341,19409,4729,4729,4729,0,14680,11000,11000,0,0,3680,2680,1000,0,7500,7500,6100,1400,2320,270,20,300,200,98
2020,451700351,6525,715,715,415,0,5810,4200,4200,0,0,1610,1300,310,0,300,300,300,0,3010,240,120,320,370,167
2020,451700371,10182,3332,3332,3032,0,6850,0,0,0,0,6850,6850,0,0,2467,2467,0,2467,4140,720,240,240,420,29
2020,451700381,115210,79110,79110,79110,0,36100,25500,18500,7000,0,10600,9800,800,0,0,0,0,0,4860,360,100,360,240,1570
2020,451800201,24900,400,400,400,0,24500,14000,14000,0,0,10500,200,10300,0,20000,20000,10000,0,3116,540,60,300,240,49
2020,451800211,22750,20500,20500,20500,0,2250,0,0,0,0,2250,1700,550,0,0,0,0,0,4400,360,100,120,120,51
2020,451800231,15182,6882,6882,6882,0,8300,8000,8000,0,0,300,300,0,0,650,650,650,0,1888,240,200,350,228,84
2020,451800311,18700,1250,1250,1250,0,17450,17000,0,17000,0,450,0,450,0,0,0,0,0,850,100,55,40,45,11
2020,451800321,4250,250,250,250,0,4000,4000,4000,0,0,0,0,0,0,0,0,0,0,530,150,70,20,30,7
2020,451800331,16,16,16,16,0,0,0,0,0,0,0,0,0,0,0,0,0,0,715,192,15,72,54,0
2020,451800341,3774,1874,1874,1874,0,1900,1200,0,1200,0,700,700,0,0,0,0,0,0,1410,120,120,360,96,61
2020,451800351,4250,4010,2810,2810,1200,240,0,0,0,0,240,240,0,0,0,0,0,0,1043,276,3,204,60,13
2020,451800361,9800,9050,7850,3850,1200,750,0,0,0,0,750,750,0,0,2000,2000,0,2000,1744,240,2,360,72,51
2020,451800381,2726,2726,2426,2426,300,0,0,0,0,0,0,0,0,0,1300,1300,0,0,1318,480,60,20,108,32
2020,451800391,3400,3400,400,400,3000,0,0,0,0,0,0,0,0,0,0,0,0,0,860,180,20,30,60,1
2020,451900201,16080,980,980,980,0,15100,15000,15000,0,0,100,100,0,0,0,0,0,0,1604,180,60,264,120,69
2020,451900211,93538,1888,1888,1888,0,91650,90000,50000,40000,0,1650,1200,450,0,48000,25000,24000,1000,3086,313,100,380,288,152
2020,451900221,13330,2330,1330,1330,1000,11000,8000,0,0,8000,3000,0,3000,0,8000,8000,0,0,2040,600,60,36,120,4
2020,451900231,57170,32770,32770,32770,0,24400,22200,21000,1200,0,2200,2200,0,0,0,0,0,0,5900,500,200,600,300,110
2020,451900241,33400,5900,5900,5900,0,27500,25000,25000,0,0,2500,2500,0,0,9600,7000,7000,0,2846,216,80,600,180,88
2020,451900271,81310,6010,6010,6010,0,75300,74000,10000,64000,0,1300,1300,0,0,2160,1160,1000,0,2753,240,120,450,203,94
2020,451900281,20800,500,500,500,0,20300,10500,10500,0,0,9800,800,0,9000,0,0,0,0,2455,240,250,600,140,88
2020,451900291,40451,35451,451,451,35000,5000,0,0,0,0,5000,5000,0,0,28000,28000,28000,0,3967,960,5,300,120,938
2020,451900301,5590,1890,890,890,1000,3700,3000,0,3000,0,700,700,0,0,0,0,0,0,2526,300,50,460,216,73
2020,451900311,250,250,250,250,0,0,0,0,0,0,0,0,0,0,0,0,0,0,540,80,30,30,25,1
2020,451900331,12198,1268,1268,1268,0,10930,10000,10000,0,0,930,870,60,0,0,0,0,0,960,260,200,60,50,40
2020,451900341,3580,3580,1080,1080,2500,0,0,0,0,0,0,0,0,0,0,0,0,0,603,120,15,10,18,1
2020,451900371,18350,4650,4650,4650,0,13700,12000,12000,0,0,1700,1700,0,0,5656,5656,4856,0,2280,240,50,160,120,71
2020,451900391,3182,182,182,182,0,3000,3000,3000,0,0,0,0,0,0,2005,2005,1685,300,944,194,300,64,32,5
2020,452000212,21136,16936,4936,4936,12000,4200,0,0,0,0,4200,3500,700,0,3200,3200,0,3200,2794,120,350,120,144,387
2020,452000222,19900,17400,400,400,17000,2500,0,0,0,0,2500,2500,0,0,4000,4000,0,3000,2460,300,20,360,240,176
2020,452000242,72436,41788,41788,41788,0,30648,27000,27000,0,0,3648,2518,1130,0,0,0,0,0,5640,360,200,200,180,1084
2020,452000262,600,600,100,100,500,0,0,0,0,0,0,0,0,0,0,0,0,0,837,342,0,10,83,1
2020,452000272,21654,21230,1230,1230,20000,424,0,0,0,0,424,424,0,0,0,0,0,0,2670,360,50,410,40,88
2020,452000282,114142,25142,25142,25142,0,89000,85000,40000,45000,0,4000,1000,3000,0,26000,5000,5000,0,4040,320,100,360,240,241
2020,452000292,45260,44660,23660,23660,21000,600,0,0,0,0,600,600,0,0,14700,14700,14700,0,3120,360,60,240,180,201
2020,452000302,4120,4120,120,120,4000,0,0,0,0,0,0,0,0,0,0,0,0,0,750,300,250,20,25,2
2020,452000312,87700,200,200,200,0,87500,80000,80000,0,0,7500,7500,0,0,20100,20000,20000,0,3556,900,10,800,156,243
2020,452000322,6050,50,50,50,0,6000,6000,6000,0,0,0,0,0,0,500,500,0,0,580,216,50,10,24,5
2020,452000332,24971,5100,5100,5100,0,19871,19600,10000,9600,0,271,0,271,0,0,0,0,0,978,138,170,30,60,11
2020,452000342,4000,4000,4000,4000,0,0,0,0,0,0,0,0,0,0,0,0,0,0,966,124,120,18,48,0
2020,452000352,19300,3640,3640,3640,0,15660,14630,12000,2630,0,1030,1030,0,0,4174,4174,4174,0,2366,240,40,260,246,172
2020,452000362,35292,3832,3832,3832,0,31460,31000,6000,25000,0,460,180,280,0,0,0,0,0,2062,250,240,174,26,46
2020,452000372,1005,5,5,5,0,1000,1000,1000,0,0,0,0,0,0,0,0,0,0,811,114,442,12,36,2
2020,452000392,8080,80,80,80,0,8000,8000,8000,0,0,0,0,0,0,0,0,0,0,596,132,48,12,48,7
2020,452600211,546910,1730,1730,1530,0,545180,545000,45000,500000,0,180,180,0,0,6565,6565,4600,1965,11426,804,120,312,240,2297
2020,452600241,73220,43120,23120,23120,20000,30100,30000,0,30000,0,100,100,0,0,20000,0,0,0,1444,240,100,120,24,44
2020,452600251,29050,12850,12850,12850,0,16200,11500,11500,0,0,4700,4700,0,0,0,0,0,0,2920,200,100,480,280,96
2020,452600261,37486,4986,4986,4986,0,32500,30000,13000,17000,0,2500,2500,0,0,13460,13460,11700,0,2928,240,36,240,288,179
2020,452600291,8947,4172,4172,4172,0,4775,3800,3800,0,0,975,600,375,0,0,0,0,0,2414,110,60,456,200,180
2020,452600301,48880,7180,7180,7180,0,41700,38700,4700,34000,0,3000,3000,0,0,12580,12580,12580,0,4530,450,150,200,300,235
2020,452600311,50054,17254,17254,17254,0,32800,32500,2500,30000,0,300,300,0,0,0,0,0,0,2400,750,60,180,60,29
2020,452600331,7500,1000,1000,1000,0,6500,6500,6500,0,0,0,0,0,0,0,0,0,0,870,100,300,72,48,4
2020,452600341,28114,5364,5364,5364,0,22750,20000,20000,0,0,2750,2300,450,0,0,0,0,0,3290,200,300,600,150,74
2020,452600351,5670,1670,1670,1670,0,4000,4000,4000,0,0,0,0,0,0,0,0,0,0,1384,150,120,20,124,12
2020,452600361,190,190,190,190,0,0,0,0,0,0,0,0,0,0,0,0,0,0,577,89,100,20,48,1
2020,452600371,3900,400,400,400,0,3500,3500,3500,0,0,0,0,0,0,0,0,0,0,334,90,50,10,24,4
2020,452700221,178540,64940,64940,64940,0,113600,110000,110000,0,0,3600,2600,1000,0,3000,3000,3000,0,7420,360,300,800,360,1394
2020,452700231,31600,5500,5500,2500,0,26100,25000,25000,0,0,1100,1100,0,0,0,0,0,0,2970,200,10,300,130,854
2020,452700261,35307,30957,8957,8957,22000,4350,0,0,0,0,4350,3600,750,0,8080,8080,7000,0,3470,300,200,360,140,111
2020,452700281,15070,20,20,20,0,15050,15000,15000,0,0,50,50,0,0,332,332,0,332,1072,240,90,240,84,35
2020,452700291,41780,280,280,280,0,41500,38000,26000,12000,0,3500,3500,0,0,15760,15760,14600,1000,3032,300,12,120,240,276
2020,452700301,10228,5028,5028,5028,0,5200,5000,5000,0,0,200,150,50,0,0,0,0,0,2340,840,20,480,120,17
2020,452700321,10862,12,12,12,0,10850,3200,3200,0,0,7650,650,0,7000,800,800,0,800,1645,180,500,180,150,189
2020,452700341,5018,4818,218,218,4600,200,0,0,0,0,200,200,0,0,0,0,0,0,1490,144,10,360,96,13
2020,452700351,21000,800,800,800,0,20200,17700,8500,9200,0,2500,1600,900,0,4000,4000,4000,0,1480,300,60,280,120,57
2020,452700361,790,290,290,290,0,500,500,500,0,0,0,0,0,0,0,0,0,0,442,82,120,24,24,2
2020,452700371,5250,450,450,450,0,4800,4800,1200,3600,0,0,0,0,0,0,0,0,0,557,98,120,24,42,25
2020,452800201,41852,20352,20352,20352,0,21500,20000,20000,0,0,1500,1500,0,0,12000,12000,12000,0,4400,400,50,360,240,1374
2020,452800231,16444,744,744,744,0,15700,12000,12000,0,0,3700,3200,500,0,60,60,0,0,2257,227,150,410,120,134
2020,452800241,61731,10231,10231,10231,0,51500,46000,46000,0,0,5500,5000,500,0,7000,7000,7000,0,9300,500,700,500,300,751
2020,452800261,65280,60000,25000,25000,35000,5280,0,0,0,0,5280,5000,280,0,28000,28000,28000,0,3240,240,10,500,180,32
2020,452800281,38620,1620,1620,620,0,37000,30000,0,30000,0,7000,2000,0,5000,1900,1900,0,900,2080,360,360,360,360,300
2020,452800311,16500,500,500,500,0,16000,14500,14500,0,0,1500,1500,0,0,14800,14800,8800,6000,2723,240,36,330,180,366
2020,452800331,54933,8655,8655,8655,0,46278,19200,5300,13900,0,27078,1050,25828,200,0,0,0,0,2790,150,1000,300,180,83
2020,452800341,29228,10328,10328,10328,0,18900,17000,15000,2000,0,1900,1900,0,0,0,0,0,0,1510,400,200,60,50,115
2020,452800361,5800,800,800,800,0,5000,5000,5000,0,0,0,0,0,0,0,0,0,0,610,120,60,12,48,5
2020,452800371,100,100,100,100,0,0,0,0,0,0,0,0,0,0,0,0,0,0,465,102,60,12,36,1
2020,452900251,1045,1045,1045,1045,0,0,0,0,0,0,0,0,0,0,0,0,0,0,1106,70,720,30,36,1
2020,452900261,550,550,400,400,150,0,0,0,0,0,0,0,0,0,0,0,0,0,1585,350,15,160,120,54
2020,452900271,15120,4120,4120,4120,0,11000,11000,11000,0,0,0,0,0,0,0,0,0,0,788,163,237,35,73,13
2020,452900281,5990,5490,290,290,5200,500,0,0,0,0,500,500,0,0,4530,4530,0,4500,1636,322,120,300,84,46
2020,452900301,6767,267,267,267,0,6500,5000,5000,0,0,1500,1500,0,0,150,150,0,0,1032,60,60,156,96,299
2020,452900311,10480,3480,3480,3480,0,7000,3000,3000,0,0,4000,4000,0,0,0,0,0,0,3590,430,240,480,180,76
2020,452900321,29155,10485,10485,10485,0,18670,17000,6000,11000,0,1670,1500,170,0,1000,1000,0,1000,4232,192,20,200,480,353
2020,452900331,3104,2089,1589,1589,500,1015,0,0,0,0,1015,900,115,0,500,500,0,500,1730,180,200,300,140,402
2020,452900341,630,600,600,600,0,30,0,0,0,0,30,30,0,0,0,0,0,0,950,102,60,58,30,15
2020,452900351,12100,600,600,600,0,11500,11500,3500,8000,0,0,0,0,0,5500,5500,5500,0,850,180,50,120,50,9
2020,452900361,25850,2400,2400,2400,0,23450,15000,8000,7000,0,8450,950,7500,0,0,0,0,0,980,150,150,180,150,36
2020,452900371,37150,550,550,550,0,36600,33200,20000,13200,0,3400,3400,0,0,0,0,0,0,1020,180,100,200,70,148
2020,453000232,46040,2060,2060,2060,0,43980,31080,18000,10000,3080,12900,3200,200,9500,0,0,0,0,2434,432,100,360,240,163
2020,453600201,42991,8591,8591,7091,0,34400,19000,19000,0,0,15400,400,15000,0,27050,27050,8650,12000,3000,240,30,400,170,92
2020,453900201,106470,15700,15700,15700,0,90770,90000,70000,20000,0,770,470,300,0,9900,7900,5900,2000,4290,360,500,500,180,309
2020,460000212,35300,3700,3700,3700,0,31600,23000,15000,8000,0,8600,7000,1600,0,0,0,0,0,1796,372,156,300,168,1232
2020,460000262,451,151,151,151,0,300,0,0,0,0,300,300,0,0,0,0,0,0,3488,240,20,150,216,33
2020,460000272,104890,14970,14970,14970,0,89920,85000,55000,30000,0,4920,4000,920,0,10100,10100,10000,0,5230,240,500,50,240,1536
2020,460000282,50260,5260,5260,5260,0,45000,45000,45000,0,0,0,0,0,0,13690,13690,13690,0,2064,360,240,240,144,253
2020,460000292,68390,15890,1890,1890,14000,52500,50000,0,50000,0,2500,2200,300,0,10500,10500,0,9700,6645,240,10,600,480,130
2020,460000302,15825,5575,5575,5575,0,10250,10200,10200,0,0,50,50,0,0,6860,6860,6760,0,3050,350,700,600,200,42
2020,460000312,4100,0,0,0,0,4100,4000,4000,0,0,100,0,100,0,0,0,0,0,1140,240,360,0,60,5
2020,460000332,360,360,360,360,0,0,0,0,0,0,0,0,0,0,0,0,0,0,819,248,20,10,72,3
2020,460000362,12490,1490,1490,1490,0,11000,11000,11000,0,0,0,0,0,0,3915,3915,3915,0,2114,104,110,36,84,60
2020,460000382,43990,31540,14540,14540,17000,12450,11000,0,11000,0,1450,1450,0,0,0,0,0,0,2282,332,120,240,180,176
2020,460600201,10068,7368,6268,6268,1100,2700,0,0,0,0,2700,2700,0,0,0,0,0,0,1908,408,60,360,60,147
2020,460600221,88564,83164,58164,55664,25000,5400,0,0,0,0,5400,4100,1300,0,100,100,0,0,3000,324,96,600,300,1752
2020,460600271,213270,14270,14270,14270,0,199000,161500,30000,131500,0,37500,2600,34900,0,0,0,0,0,4650,300,60,780,240,322
2020,460600311,4170,70,70,70,0,4100,4100,4100,0,0,0,0,0,0,0,0,0,0,520,250,120,10,20,5
2020,460600321,18520,6020,4020,4020,2000,12500,8000,0,8000,0,4500,4500,0,0,7500,2500,2500,0,704,36,12,120,156,104
2020,460600341,2804,2104,604,604,1500,700,0,0,0,0,700,700,0,0,200,200,0,0,2342,276,40,120,156,105
2020,460600351,18752,5672,5672,5312,0,13080,11000,7000,4000,0,2080,1880,200,0,200,0,0,0,2526,116,460,520,150,54
2020,460600361,21250,8230,8230,8230,0,13020,13000,10000,3000,0,20,20,0,0,0,0,0,0,1908,98,50,250,120,20
2020,460600371,58416,9236,9236,9236,0,49180,48500,20900,27600,0,680,150,530,0,300,0,0,0,2264,380,48,250,116,114
2020,460600381,13559,5459,5459,5459,0,8100,6500,6500,0,0,1600,1000,600,0,4000,4000,4000,0,2142,350,60,168,144,44
2020,460600391,13060,4060,4060,4060,0,9000,9000,9000,0,0,0,0,0,0,30,30,0,0,776,142,34,120,48,20
2020,460700211,16100,7600,7600,7600,0,8500,8500,8500,0,0,0,0,0,0,0,0,0,0,975,120,80,65,20,104
2020,460700221,10326,1826,1826,1826,0,8500,8500,8500,0,0,0,0,0,0,18,18,0,0,1058,150,300,60,48,8
2020,460700231,67595,23070,23070,23070,0,44525,40000,40000,0,0,4525,4350,175,0,871,871,0,871,5440,700,200,240,360,1612
2020,460700261,31479,8679,8679,8679,0,22800,22000,22000,0,0,800,500,300,0,0,0,0,0,2770,260,50,240,140,154
2020,460700271,32892,3492,3492,3492,0,29400,29000,29000,0,0,400,400,0,0,0,0,0,0,1030,150,200,130,60,74
2020,460700281,85344,6094,6094,6094,0,79250,78000,21000,57000,0,1250,900,350,0,14000,5000,5000,0,3948,198,30,240,160,997
2020,460700291,30844,27894,9894,9894,18000,2950,2000,0,2000,0,950,650,0,300,0,0,0,0,3620,180,50,210,240,322
2020,460700311,231565,4565,4565,4565,0,227000,220000,200000,20000,0,7000,500,6500,0,42032,42032,42032,0,1640,276,0,200,84,432
2020,460700331,39226,15226,15226,15226,0,24000,21000,21000,0,0,3000,2500,500,0,0,0,0,0,1197,210,60,190,144,143
2020,460700351,24390,15580,15580,15580,0,8810,8000,8000,0,0,810,700,110,0,0,0,0,0,2114,120,120,360,84,59
2020,460700361,57140,56390,56390,56390,0,750,0,0,0,0,750,750,0,0,0,0,0,0,3584,348,400,390,200,1768
2020,460700371,490,490,490,490,0,0,0,0,0,0,0,0,0,0,0,0,0,0,460,120,30,30,23,1
2020,460700391,41990,20740,20740,20740,0,21250,17000,9000,8000,0,4250,250,4000,0,0,0,0,0,5182,408,1880,720,194,178
2020,460800201,1502,1502,2,2,1500,0,0,0,0,0,0,0,0,0,1800,1800,0,0,647,456,15,15,16,1
2020,460800221,71798,16898,16898,16898,0,54900,54000,54000,0,0,900,900,0,0,0,0,0,0,2779,270,1200,124,220,216
2020,460800241,1400,1400,1400,1400,0,0,0,0,0,0,0,0,0,0,0,0,0,0,730,60,10,50,96,6
2020,460800271,45468,6718,6718,6718,0,38750,38500,13000,25500,0,250,250,0,0,0,0,0,0,1770,200,50,250,100,501
2020,460800291,87708,54588,21588,21588,33000,33120,30000,0,30000,0,3120,3000,120,0,25000,0,0,0,3810,250,40,500,120,1416
2020,460800301,25793,180,180,180,0,25613,24000,0,24000,0,1613,1500,113,0,20320,20320,20170,0,3028,152,400,120,216,43
2020,460800321,49744,6644,6644,6644,0,43100,42500,28500,14000,0,600,600,0,0,400,400,0,400,2720,280,100,240,180,946
2020,460800331,57862,17312,17312,17312,0,40550,38000,0,18000,20000,2550,1550,1000,0,12630,11630,11000,600,5126,600,36,180,300,55
2020,460800341,127930,20930,20930,11430,0,107000,105000,70000,35000,0,2000,2000,0,0,3500,1000,1000,0,2428,300,400,360,48,226
2020,460800351,4200,200,200,200,0,4000,4000,2000,2000,0,0,0,0,0,0,0,0,0,440,50,10,10,30,3
2020,460800361,32582,5912,5912,5912,0,26670,21000,2000,19000,0,5670,4170,1500,0,8745,8745,2500,0,3644,300,140,240,264,96
2020,460800371,7140,4140,3940,3940,200,3000,0,0,0,0,3000,3000,0,0,1400,1400,0,700,2320,480,20,180,120,187
2020,460800391,25050,7700,7700,4700,0,17350,16000,16000,0,0,1350,650,700,0,3000,0,0,0,2244,264,120,480,240,73
2020,460900211,25980,5580,5580,5580,0,20400,20000,18000,2000,0,400,200,200,0,0,0,0,0,3480,180,20,240,180,323
2020,460900221,19700,1300,1300,1300,0,18400,18000,18000,0,0,400,400,0,0,500,500,0,500,2370,190,50,360,240,110
2020,460900231,54252,7252,7252,6252,0,47000,45000,45000,0,0,2000,2000,0,0,26700,26700,23500,3000,4880,1500,120,240,180,2005
2020,460900241,26150,8250,8250,8250,0,17900,17000,17000,0,0,900,900,0,0,0,0,0,0,2450,240,800,150,60,46
2020,460900251,31570,1470,1470,1470,0,30100,28000,28000,0,0,2100,2100,0,0,0,0,0,0,2660,240,50,360,120,220
2020,460900261,4588,4238,3888,3888,350,350,0,0,0,0,350,350,0,0,0,0,0,0,1362,220,20,370,72,14
2020,460900281,32148,7448,7448,7448,0,24700,24000,24000,0,0,700,700,0,0,8000,8000,8000,0,2820,450,100,100,240,237
2020,460900291,3108,2958,1258,1258,1700,150,0,0,0,0,150,150,0,0,650,650,0,0,1540,540,30,144,128,17
2020,460900321,16500,1700,1700,1700,0,14800,13000,13000,0,0,1800,1800,0,0,20,20,0,0,1760,300,40,120,300,72
2020,460900331,108284,29484,29484,29484,0,78800,72000,18000,54000,0,6800,5700,1100,0,1000,0,0,0,3126,292,240,480,120,133
2020,460900341,38090,6400,6400,5400,0,31690,21000,17000,4000,0,10690,3690,7000,0,8300,8300,0,8300,3530,284,36,240,360,871
2020,460900351,29751,3702,3702,3702,0,26049,25000,25000,0,0,1049,499,550,0,3800,3800,0,3800,3074,252,180,118,168,796
2020,460900361,27000,2000,2000,2000,0,25000,25000,0,25000,0,0,0,0,0,0,0,0,0,552,96,36,24,36,1
2020,460900371,88952,23402,23402,20402,0,65550,49500,31000,18500,0,16050,2550,10500,3000,10304,10304,6974,3000,3564,240,200,680,300,69
2020,461000202,32050,1450,1450,1450,0,30600,30000,30000,0,0,600,600,0,0,0,0,0,0,1240,360,0,120,60,211
2020,461000212,108400,8500,6500,1500,2000,99900,83000,0,83000,0,16900,400,16500,0,70000,70000,70000,0,5460,1000,360,120,240,1241
2020,461000232,20,20,20,20,0,0,0,0,0,0,0,0,0,0,0,0,0,0,460,30,10,10,10,1
2020,461000242,611,411,111,111,300,200,0,0,0,0,200,200,0,0,3000,3000,0,3000,1403,408,10,200,72,57
2020,461000252,9910,9810,7310,7310,2500,100,0,0,0,0,100,0,100,0,0,0,0,0,988,108,10,25,120,2
2020,461000262,18835,7935,7935,7935,0,10900,10000,10000,0,0,900,700,200,0,0,0,0,0,1490,180,50,150,180,91
2020,461000282,48510,460,460,460,0,48050,48000,40000,8000,0,50,0,50,0,0,0,0,0,432,120,60,60,36,17
2020,461000302,27006,4906,4906,4906,0,22100,17700,15000,2700,0,4400,4400,0,0,0,0,0,0,1882,21,55,650,180,435
2020,461000312,8000,1000,1000,1000,0,7000,7000,7000,0,0,0,0,0,0,0,0,0,0,1413,288,360,120,60,10
2020,461000322,218,150,150,150,0,68,0,0,0,0,68,0,68,0,0,0,0,0,491,63,96,60,55,1
2020,461000332,30840,6310,6310,5310,0,24530,22000,22000,0,0,2530,2530,0,0,9100,9100,6800,700,4203,253,36,900,312,85
2020,461000342,22208,20271,5271,5271,15000,1937,0,0,0,0,1937,1937,0,0,3430,3430,3400,0,1912,234,36,228,132,67
2020,461000362,19359,5659,5659,5659,0,13700,13000,6000,7000,0,700,700,0,0,0,0,0,0,1563,172,60,104,100,26
2020,461000372,20838,6218,6218,6218,0,14620,10500,7000,3500,0,4120,300,3820,0,0,0,0,0,1515,135,50,180,128,28
2020,461000382,6333,583,583,583,0,5750,4150,3000,1150,0,1600,500,900,200,0,0,0,0,985,166,28,306,15,35
2020,461600231,660,530,30,30,500,130,0,0,0,0,130,100,30,0,2672,2672,0,0,1790,380,50,300,160,64
2020,461600241,29988,1588,1588,1088,0,28400,28000,28000,0,0,400,400,0,0,1500,1500,0,1500,1103,240,50,15,48,14
2020,461600261,8729,8579,6579,6579,2000,150,0,0,0,0,150,150,0,0,5000,5000,0,0,2610,276,204,84,480,247
2020,461600271,14428,3428,3428,3428,0,11000,11000,11000,0,0,0,0,0,0,7860,7860,5400,1160,1486,156,400,84,96,11
2020,461600281,380,380,380,380,0,0,0,0,0,0,0,0,0,0,0,0,0,0,670,120,20,20,60,1
2020,461600291,28340,2440,2440,2440,0,25900,25000,25000,0,0,900,900,0,0,8430,8430,8430,0,2190,170,20,200,100,83
2020,461600301,98048,58598,58598,58598,0,39450,32000,32000,0,0,7450,6700,750,0,0,0,0,0,5988,288,25,455,240,736
2020,461600311,67400,26100,26100,26100,0,41300,36000,32000,0,4000,5300,5300,0,0,0,0,0,0,3652,228,47,396,210,763
2020,461600331,27204,7324,7324,7324,0,19880,19200,6000,13200,0,680,660,20,0,2515,2015,1000,0,2882,156,462,300,288,244
2020,461600361,36639,459,459,459,0,36180,36180,4500,31680,0,0,0,0,0,0,0,0,0,976,190,24,108,54,15
2020,461600371,25769,5500,5500,5500,0,20269,19000,8000,11000,0,1269,800,469,0,6054,6054,5000,1000,1801,100,310,123,216,37
2020,461600381,36030,14252,14252,14252,0,21778,20000,10000,10000,0,1778,1100,678,0,1870,1870,1220,600,4512,72,280,700,270,1050
2020,461600391,46923,13331,13331,11831,0,33592,28000,0,28000,0,5592,200,1392,4000,10500,10500,10000,500,2229,260,200,400,120,52
2020,461700201,26673,2793,2793,2793,0,23880,23000,23000,0,0,880,800,80,0,4590,4590,2090,2500,3106,210,50,300,216,185
2020,461700211,2975,2930,2930,2930,0,45,0,0,0,0,45,45,0,0,0,0,0,0,708,60,20,120,48,13
2020,461700221,94387,9087,9087,9087,0,85300,78000,78000,0,0,7300,2300,5000,0,21500,21500,21500,0,6150,480,20,200,250,382
2020,461700231,5060,60,60,60,0,5000,5000,5000,0,0,0,0,0,0,0,0,0,0,1730,100,1200,100,30,24
2020,461700241,20,20,20,20,0,0,0,0,0,0,0,0,0,0,0,0,0,0,890,60,100,250,130,1
2020,461700251,24672,5672,5672,5672,0,19000,19000,19000,0,0,0,0,0,0,0,0,0,0,1655,300,300,125,60,68
2020,461700271,10134,1134,1134,1134,0,9000,9000,9000,0,0,0,0,0,0,700,700,700,0,1426,186,24,72,168,14
2020,461700281,7370,270,270,270,0,7100,7000,7000,0,0,100,100,0,0,4850,4850,4700,0,820,112,10,50,48,73
2020,461700291,13390,3050,3050,3050,0,10340,9000,9000,0,0,1340,1200,140,0,2600,2600,2600,0,4232,200,100,310,300,168
2020,461700301,19660,6860,6860,6860,0,12800,9000,9000,0,0,3800,3800,0,0,0,0,0,0,2223,180,500,360,120,69
2020,461700311,376720,19320,19320,19320,0,357400,26000,26000,0,0,331400,3400,328000,0,30000,30000,30000,0,3185,420,5,750,180,359
2020,461700321,38990,14190,14190,11190,0,24800,18000,18000,0,0,6800,5300,1500,0,7500,7500,2500,0,3670,340,180,480,360,185
2020,461700341,23040,12110,8010,7510,4100,10930,7000,0,7000,0,3930,2800,1130,0,0,0,0,0,3332,780,10,240,360,61
2020,461700351,19886,7996,7996,7996,0,11890,11000,11000,0,0,890,890,0,0,7482,7482,7382,0,2161,182,402,312,120,61
2020,461700361,7,7,7,7,0,0,0,0,0,0,0,0,0,0,0,0,0,0,687,78,6,48,20,0
2020,461700381,4300,2300,2300,2300,0,2000,0,0,0,0,2000,2000,0,0,7193,7193,300,0,1140,160,70,150,90,30
2020,461700391,27468,2210,2210,2210,0,25258,25000,20000,5000,0,258,100,158,0,3000,3000,3000,0,1671,502,259,306,60,53
2020,461800201,43570,7470,7470,5470,0,36100,33000,33000,0,0,3100,2000,100,1000,14000,14000,14000,0,4600,1600,40,240,240,158
2020,461800211,26648,6548,6548,6548,0,20100,19000,11000,8000,0,1100,1100,0,0,300,0,0,0,2736,216,300,480,240,489
2020,461800221,16964,3814,3814,3814,0,13150,11000,11000,0,0,2150,2100,50,0,16000,16000,11100,4900,3373,320,500,200,300,101
2020,461800231,12560,4060,4060,4060,0,8500,8500,8500,0,0,0,0,0,0,0,0,0,0,1831,200,560,94,132,55
2020,461800241,18002,2002,2002,2002,0,16000,16000,16000,0,0,0,0,0,0,0,0,0,0,1504,130,100,50,240,102
2020,461800251,95748,56968,56968,56468,0,38780,38000,20000,18000,0,780,600,180,0,0,0,0,0,4328,588,140,240,216,142
2020,461800261,270520,4520,4520,4520,0,266000,266000,36000,230000,0,0,0,0,0,130000,90000,90000,0,5080,360,300,480,240,1159
2020,461800301,369990,67890,67890,41390,0,302100,288000,38000,250000,0,14100,2100,2000,10000,67000,57000,52000,0,6770,380,300,550,300,1240
2020,461800311,7772,7446,2446,2446,5000,326,0,0,0,0,326,100,226,0,100,100,0,0,1508,180,60,120,48,13
2020,461800321,27984,27984,2984,2984,25000,0,0,0,0,0,0,0,0,0,46553,46553,46553,0,2630,300,30,240,200,269
2020,461800331,17116,7916,7916,7916,0,9200,0,0,0,0,9200,1200,0,8000,15,15,0,0,1104,204,200,80,120,5
2020,461800341,20745,8145,8145,8145,0,12600,9000,9000,0,0,3600,3600,0,0,1132,1132,1000,0,3580,240,200,420,360,504
2020,461800351,6095,55,55,55,0,6040,6000,3000,3000,0,40,0,40,0,0,0,0,0,864,120,60,240,60,2
2020,461800361,13903,73,73,73,0,13830,13700,3700,10000,0,130,0,130,0,0,0,0,0,696,120,120,120,60,6
2020,461800381,24326,22776,8376,8016,14400,1550,0,0,0,0,1550,1550,0,0,6000,6000,6000,0,4695,240,430,300,144,148
2020,461800391,3646,46,46,46,0,3600,3600,3600,0,0,0,0,0,0,0,0,0,0,740,210,100,20,60,3
2020,461900201,2620,2620,1420,1420,1200,0,0,0,0,0,0,0,0,0,500,500,0,500,2090,150,1500,30,50,1
2020,461900231,27356,5786,5786,5786,0,21570,21500,18000,3500,0,70,70,0,0,120,120,0,0,4514,156,1320,360,240,78
2020,461900241,21640,2140,2140,2140,0,19500,18500,12500,6000,0,1000,1000,0,0,700,700,0,0,1380,300,30,360,170,92
2020,461900251,7500,1000,1000,1000,0,6500,6500,6500,0,0,0,0,0,0,0,0,0,0,714,116,15,120,22,16
2020,461900281,35440,8140,8140,7140,0,27300,26000,26000,0,0,1300,0,300,1000,7000,7000,7000,0,4325,350,10,60,600,40
2020,461900311,7892,642,642,642,0,7250,6000,6000,0,0,1250,1250,0,0,4582,4582,4582,0,1410,144,30,240,300,189
2020,461900321,20388,2088,2088,2088,0,18300,18200,5200,13000,0,100,100,0,0,0,0,0,0,2079,189,1036,140,94,27
2020,461900351,3450,450,450,450,0,3000,1800,1800,0,0,1200,1200,0,0,0,0,0,0,1302,250,20,260,150,64
2020,461900361,29998,8440,8440,8440,0,21558,20000,5000,15000,0,1558,1400,158,0,0,0,0,0,1708,320,363,216,80,73
2020,461900371,3820,910,910,910,0,2910,2700,2700,0,0,210,0,210,0,0,0,0,0,667,96,150,50,41,2
2020,461900381,9255,2840,2840,2840,0,6415,6000,1500,4500,0,415,80,335,0,0,0,0,0,912,160,170,200,72,15
2020,461900391,3210,210,210,210,0,3000,3000,3000,0,0,0,0,0,0,0,0,0,0,477,70,40,20,35,2
2020,462000302,11846,1588,1588,1588,0,10258,10200,4200,6000,0,58,0,58,0,0,0,0,0,1166,180,700,30,36,5
2020,462000312,18650,350,350,350,0,18300,18300,7000,11300,0,0,0,0,0,0,0,0,0,368,36,100,12,24,3
2020,462000332,2300,1300,1300,1300,0,1000,1000,1000,0,0,0,0,0,0,0,0,0,0,675,160,70,20,30,2
2020,462000342,24829,10997,10997,10997,0,13832,10000,2000,8000,0,3832,150,3682,0,5000,5000,0,5000,1834,193,36,51,49,49
2020,462000352,12203,703,703,703,0,11500,7600,2600,5000,0,3900,900,3000,0,10000,10000,0,10000,1838,123,243,136,128,51
2020,462000362,1206,606,606,606,0,600,600,600,0,0,0,0,0,0,0,0,0,0,352,48,54,10,20,2
2020,462000372,2850,0,0,0,0,2850,2800,800,2000,0,50,0,50,0,3000,3000,0,0,958,130,144,120,24,3
2020,462600301,42516,9658,9658,9658,0,32858,31000,13000,18000,0,1858,1700,158,0,500,0,0,0,1931,142,72,300,156,61
2020,462600311,12695,1087,1087,1087,0,11608,11500,5700,5800,0,108,0,108,0,0,0,0,0,605,139,120,50,48,15
2020,462600321,7279,2911,2911,2911,0,4368,4300,4300,0,0,68,0,68,0,760,760,760,0,662,137,152,48,60,3
2020,462600331,5050,5050,5050,5050,0,0,0,0,0,0,0,0,0,0,0,0,0,0,965,150,180,10,25,4
2020,462600341,28,10,10,10,0,18,0,0,0,0,18,0,18,0,0,0,0,0,696,100,240,50,16,1
2020,462600361,69413,4008,4008,4008,0,65405,27905,0,27905,0,37500,11500,26000,0,21903,21903,19000,2000,4646,366,1000,240,240,346
2020,462600371,49130,7930,7930,7930,0,41200,40000,0,40000,0,1200,1200,0,0,28900,2900,0,2900,1714,252,40,310,192,351
2020,462700301,7295,295,295,295,0,7000,7000,7000,0,0,0,0,0,0,0,0,0,0,1097,162,120,51,60,12
2020,462700311,43080,20580,20580,20580,0,22500,3300,3000,300,0,19200,1700,11500,6000,0,0,0,0,3440,270,150,560,210,90
2020,462700321,200,200,200,200,0,0,0,0,0,0,0,0,0,0,0,0,0,0,678,90,70,26,25,1
2020,462700341,2800,100,100,100,0,2700,2700,1200,1500,0,0,0,0,0,0,0,0,0,431,159,100,40,0,3
2020,462700361,11716,3386,3386,3386,0,8330,8000,8000,0,0,330,230,100,0,2000,2000,0,2000,2400,180,60,360,120,77
2020,462700371,102416,58852,58852,58852,0,43564,38000,0,38000,0,5564,1400,4164,0,0,0,0,0,3260,200,50,300,120,291
2020,462800301,7730,450,450,450,0,7280,7280,1000,6280,0,0,0,0,0,0,0,0,0,627,88,142,50,30,6
2020,462800311,10509,273,273,273,0,10236,10100,2000,8100,0,136,0,136,0,0,0,0,0,1050,228,60,30,62,6
2020,462800321,9050,1087,1087,1087,0,7963,7850,3850,4000,0,113,0,113,0,0,0,0,0,861,174,165,30,36,8
2020,462800331,10198,3998,3998,3998,0,6200,5900,700,5200,0,300,300,0,0,338,338,0,338,1382,110,650,200,40,8
2020,462800341,13012,9112,3112,3112,6000,3900,3000,0,3000,0,900,900,0,0,2000,2000,0,2000,3320,660,240,300,240,380
2020,462800351,10042,1274,1274,1274,0,8768,8700,8000,700,0,68,0,68,0,0,0,0,0,1532,148,900,60,34,10
2020,462800361,66476,41026,41026,41026,0,25450,10350,9000,1350,0,15100,5600,2500,7000,18550,18550,15550,0,2957,218,0,588,240,67
2020,462900311,43266,5816,5816,5816,0,37450,34000,10000,24000,0,3450,1350,2100,0,11320,11320,0,0,2400,330,10,420,144,39
2020,462900321,1079,779,779,779,0,300,300,0,300,0,0,0,0,0,0,0,0,0,1073,60,15,120,120,2
2020,462900331,36365,10365,10365,10365,0,26000,20500,17800,0,2700,5500,3500,2000,0,3000,3000,0,3000,2909,446,101,123,282,162
2020,462900341,2108,2108,2108,2108,0,0,0,0,0,0,0,0,0,0,0,0,0,0,1051,204,165,0,42,2
2020,462900351,11030,2540,2540,2540,0,8490,6390,3990,2400,0,2100,2100,0,0,1500,1500,0,1500,1894,178,96,600,120,420
2020,462900361,16086,7986,7986,7986,0,8100,6100,6100,0,0,2000,2000,0,0,3970,3970,3470,500,3858,266,120,820,160,293
2020,470000302,460,60,60,60,0,400,0,0,0,0,400,400,0,0,9700,9700,3700,1000,2424,540,360,500,144,217
2020,470000312,8,8,8,8,0,0,0,0,0,0,0,0,0,0,1400,1400,0,1400,900,150,240,60,100,3
2020,470000322,30830,2030,2030,2030,0,28800,27000,0,27000,0,1800,1800,0,0,20000,2000,2000,0,4678,660,380,480,216,99
2020,470000332,67,17,17,17,0,50,0,0,0,0,50,50,0,0,80,80,0,0,1658,186,30,240,130,15
2020,470000342,35550,26180,3180,2680,23000,9370,7000,0,7000,0,2370,2370,0,0,5400,5400,0,3400,5831,360,240,260,125,69
2020,470000382,29627,8329,8329,8329,0,21298,20000,16000,4000,0,1298,800,498,0,0,0,0,0,2180,300,120,300,80,112
2020,470000392,41340,1840,1840,1840,0,39500,27000,10000,17000,0,12500,200,12300,0,12400,12400,12400,0,756,100,60,180,36,60
2020,470600311,95870,14100,14100,12900,0,81770,79000,34000,45000,0,2770,1570,1200,0,28000,0,0,0,2006,216,500,250,160,116
2020,470600321,21870,20520,3520,3520,17000,1350,0,0,0,0,1350,1150,200,0,5000,5000,0,5000,3170,270,30,360,180,578
2020,470600331,11771,4971,4971,4971,0,6800,6000,6000,0,0,800,200,600,0,0,0,0,0,1691,150,10,240,216,26
2020,470600361,17490,1420,1420,1420,0,16070,15500,6000,9500,0,570,500,70,0,2350,2350,2000,350,6260,960,100,260,360,85
2020,470600371,26210,14910,14910,14910,0,11300,8700,8700,0,0,2600,2600,0,0,3900,3900,3800,0,2836,216,32,340,240,594
2020,470600381,50,50,50,50,0,0,0,0,0,0,0,0,0,0,0,0,0,0,630,120,120,25,10,1
2020,470600391,400,400,400,400,0,0,0,0,0,0,0,0,0,0,0,0,0,0,540,50,20,30,15,1
2020,470700301,50,50,50,50,0,0,0,0,0,0,0,0,0,0,0,0,0,0,310,0,120,24,0,1
2020,470700311,26078,14778,14778,14778,0,11300,10000,10000,0,0,1300,1100,200,0,90,90,0,0,6722,546,1600,336,420,1609
2020,470700321,350,170,70,70,100,180,0,0,0,0,180,180,0,0,1924,1924,0,924,2681,416,10,400,150,25
2020,470700331,18810,8810,8810,6810,0,10000,10000,10000,0,0,0,0,0,0,0,0,0,0,1852,228,200,250,69,21
2020,470700351,34110,13710,13710,13710,0,20400,19000,19000,0,0,1400,1300,100,0,0,0,0,0,4270,360,400,360,240,695
2020,470700361,5468,1688,688,688,1000,3780,0,0,0,0,3780,3000,780,0,4332,4332,0,832,2718,650,30,360,168,33
2020,470700371,24190,8540,540,540,8000,15650,14000,0,14000,0,1650,1650,0,0,1000,0,0,0,2010,250,40,150,30,31
2020,470700381,42100,600,600,600,0,41500,37000,15000,22000,0,4500,1500,3000,0,10000,0,0,0,1400,130,200,100,50,54
2020,470700391,6140,3080,3080,3080,0,3060,3000,3000,0,0,60,0,60,0,0,0,0,0,1072,72,60,20,24,5
2020,470800301,6834,734,734,734,0,6100,5500,5500,0,0,600,600,0,0,4380,4380,4380,0,2280,240,10,360,240,104
2020,470800321,43231,16284,16284,16284,0,26947,23000,23000,0,0,3947,3947,0,0,0,0,0,0,2714,192,120,360,192,290
2020,470800331,1505,1505,5,5,1500,0,0,0,0,0,0,0,0,0,700,700,0,0,810,180,300,6,144,1
2020,470800341,70162,15710,15710,15210,0,54452,53000,26000,27000,0,1452,1000,452,0,0,0,0,0,3498,520,10,320,108,163
2020,470800361,120,120,120,120,0,0,0,0,0,0,0,0,0,0,0,0,0,0,890,120,50,20,30,1
2020,470800371,31456,7856,7856,7856,0,23600,18000,4500,13500,0,5600,600,5000,0,19000,19000,13000,4000,2063,192,25,480,180,92
2020,470800381,8084,1884,1884,1884,0,6200,4500,4500,0,0,1700,1700,0,0,50,50,0,0,1941,237,1000,120,58,92
2020,470900301,13000,10500,10500,10500,0,2500,2500,2500,0,0,0,0,0,0,0,0,0,0,930,200,120,50,60,50
2020,470900311,5210,20,20,20,0,5190,5000,5000,0,0,190,150,40,0,2500,2500,2500,0,1700,250,100,300,150,31
2020,470900321,1217,1217,1217,1217,0,0,0,0,0,0,0,0,0,0,2924,2924,0,2624,942,120,20,60,120,1
2020,470900331,15180,180,180,180,0,15000,15000,0,15000,0,0,0,0,0,6798,6798,6798,0,2304,348,10,360,84,11
2020,470900341,5820,4820,3320,3320,1500,1000,0,0,0,0,1000,1000,0,0,0,0,0,0,1730,360,100,240,120,41
2020,470900351,64940,10090,10090,9890,0,54850,50000,35000,15000,0,4850,3850,1000,0,30900,19900,19900,0,4150,588,100,300,240,893
2020,470900371,535,535,35,35,500,0,0,0,0,0,0,0,0,0,0,0,0,0,877,456,15,8,20,1
2020,470900381,26226,5176,5176,5176,0,21050,20500,12000,8500,0,550,550,0,0,0,0,0,0,4700,700,120,600,230,103
2020,471000302,66283,13031,12731,12731,300,53252,50000,0,50000,0,3252,2800,452,0,570,570,0,570,5710,750,100,960,120,553
2020,471000312,49300,25600,25600,25100,0,23700,23000,18000,5000,0,700,700,0,0,200,0,0,0,3790,600,150,400,300,789
2020,471000322,36120,13720,13720,13720,0,22400,19000,19000,0,0,3400,3400,0,0,9000,9000,9000,0,2954,240,240,420,204,243
2020,471000332,24800,2300,1000,1000,1300,22500,21000,0,21000,0,1500,1500,0,0,1900,1400,0,1400,2663,233,70,360,120,295
2020,471000352,11900,3900,3900,3900,0,8000,8000,3000,5000,0,0,0,0,0,0,0,0,0,1125,159,30,10,46,10
2020,471000362,18250,4250,4250,4250,0,14000,14000,9000,5000,0,0,0,0,0,100,100,0,0,1587,185,400,24,48,10
2020,471000372,56776,15812,15812,15812,0,40964,39500,22500,17000,0,1464,1170,294,0,11642,11142,0,11000,7992,380,340,600,266,877
2020,471000392,16060,5000,5000,5000,0,11060,11000,5000,6000,0,60,50,10,0,0,0,0,0,964,130,360,120,84,9
2020,471600301,126792,9692,9692,9692,0,117100,114000,34000,80000,0,3100,3100,0,0,103000,102000,53000,49000,5896,600,200,800,204,7495
2020,471600311,19241,2218,2218,2218,0,17023,8000,8000,0,0,9023,1000,23,8000,0,0,0,0,1385,195,50,40,70,39
2020,471600331,126840,27340,27340,27340,0,99500,95000,25000,70000,0,4500,500,1000,3000,61700,28200,28200,0,6350,550,100,700,300,1079
2020,471600361,91554,48554,37554,37554,11000,43000,41000,0,41000,0,2000,2000,0,0,0,0,0,0,2430,130,30,150,120,119
2020,471600371,27972,6372,6372,6372,0,21600,21000,21000,0,0,600,600,0,0,5969,5969,5901,0,1580,170,50,300,120,69
2020,471600381,5430,30,30,30,0,5400,5000,5000,0,0,400,400,0,0,0,0,0,0,1170,180,40,200,48,5
2020,471600391,90384,17884,17884,17884,0,72500,70000,25000,45000,0,2500,200,2300,0,11030,3030,3030,0,1580,130,240,240,70,73
2020,471700301,8944,3144,3144,3144,0,5800,5000,5000,0,0,800,800,0,0,1600,1600,0,1600,2600,210,30,300,260,39
2020,471700311,18918,1718,1718,1718,0,17200,15000,15000,0,0,2200,2100,100,0,0,0,0,0,4720,660,50,350,360,103
2020,471700341,2962,2962,2762,2762,200,0,0,0,0,0,0,0,0,0,0,0,0,0,1294,624,60,160,60,5
2020,471700351,21019,319,319,319,0,20700,20700,20700,0,0,0,0,0,0,0,0,0,0,1125,130,110,300,15,25
2020,471700371,17653,953,953,453,0,16700,12500,6500,6000,0,4200,2100,2100,0,1300,1300,0,1300,2914,280,32,152,108,118
2020,471700381,35339,21959,21959,21959,0,13380,12000,5000,7000,0,1380,600,780,0,0,0,0,0,2105,105,50,400,100,13
2020,471800301,49760,16900,16900,16900,0,32860,32500,32500,0,0,360,360,0,0,7000,7000,7000,0,5677,496,100,300,223,1595
2020,471800311,17453,133,133,133,0,17320,14000,6000,8000,0,3320,320,3000,0,16000,8000,8000,0,1604,208,66,35,38,31
2020,471800321,7652,5732,5732,5732,0,1920,0,0,0,0,1920,1900,20,0,35,35,0,0,1158,60,10,160,180,27
2020,471800331,51826,2950,2950,2950,0,48876,47000,19000,28000,0,1876,1150,726,0,22040,22040,12040,0,2516,244,10,120,96,128
2020,471800341,7770,1970,1970,1970,0,5800,5000,0,5000,0,800,400,400,0,0,0,0,0,1821,294,16,360,240,79
2020,471800351,58120,1920,1920,1920,0,56200,55000,25000,30000,0,1200,1000,200,0,0,0,0,0,11740,2000,7000,600,240,432
2020,471800361,23825,800,800,800,0,23025,23000,23000,0,0,25,25,0,0,4478,4478,4478,0,1810,240,80,72,78,86
2020,471800371,37452,2802,2802,2802,0,34650,34000,14000,20000,0,650,600,50,0,2000,1500,1500,0,1490,600,100,250,80,81
2020,471800391,28597,6437,4637,4637,1800,22160,21000,0,21000,0,1160,300,860,0,8000,8000,3000,5000,2610,210,100,180,240,24
2020,471900311,45780,12280,12280,12280,0,33500,30000,30000,0,0,3500,3500,0,0,0,0,0,0,4680,500,50,1100,130,1648
2020,471900341,32490,4590,4590,4590,0,27900,21500,12000,9500,0,6400,3400,3000,0,9000,9000,0,9000,2195,95,30,480,120,106
2020,471900351,13772,3772,3772,3772,0,10000,10000,10000,0,0,0,0,0,0,1300,1300,1300,0,885,144,180,48,102,6
2020,471900361,42041,2270,2270,2270,0,39771,38600,12600,26000,0,1171,300,871,0,5000,5000,5000,0,2816,144,36,72,90,41
2020,471900371,23110,1300,1300,1300,0,21810,21700,3000,18700,0,110,0,110,0,0,0,0,0,1350,250,70,100,20,13
2020,471900381,2524,1124,1124,1124,0,1400,0,0,0,0,1400,1400,0,0,400,400,0,400,2088,340,48,65,60,64
2020,471900391,5095,1045,1045,1045,0,4050,4000,4000,0,0,50,0,50,0,5000,5000,1700,3200,2605,1200,110,55,340,71
2020,472000302,22200,3000,3000,3000,0,19200,16000,10000,6000,0,3200,3200,0,0,1500,1200,1000,200,1580,400,100,500,90,71
2020,472000312,45000,4200,4200,4200,0,40800,20000,10000,10000,0,20800,800,20000,0,6000,6000,6000,0,1938,180,100,120,120,63
2020,472000332,408,408,408,408,0,0,0,0,0,0,0,0,0,0,0,0,0,0,825,126,90,20,96,1
2020,472000352,4620,180,180,180,0,4440,4340,4340,0,0,100,0,100,0,0,0,0,0,749,110,240,88,33,3
2020,472000362,12820,420,420,420,0,12400,11500,11500,0,0,900,800,100,0,1500,1500,0,1500,853,140,40,180,120,29
2020,472000372,1813,1700,1700,1700,0,113,0,0,0,0,113,0,113,0,0,0,0,0,594,136,60,0,17,2
2020,472000382,58814,36564,36564,36564,0,22250,20850,15000,5850,0,1400,1400,0,0,0,0,0,0,4665,84,10,600,145,57
2020,472600301,175559,17210,17210,17210,0,158349,148000,24000,124000,0,10349,1200,9149,0,61000,61000,34000,27000,3405,202,880,120,252,645
2020,472600321,18120,1000,1000,1000,0,17120,17000,17000,0,0,120,120,0,0,0,0,0,0,2782,480,360,360,72,24
2020,472600331,31486,3886,3886,3886,0,27600,25000,25000,0,0,2600,2600,0,0,17490,17490,16820,0,2190,420,240,150,120,201
2020,472600341,27812,8812,8812,8812,0,19000,15000,2000,13000,0,4000,1000,3000,0,0,0,0,0,2100,300,100,400,70,22
2020,472600351,45730,16630,16630,16630,0,29100,24000,12000,12000,0,5100,1850,3250,0,500,500,0,500,3130,250,30,600,200,123
2020,472600361,600,600,600,600,0,0,0,0,0,0,0,0,0,0,0,0,0,0,977,240,150,36,24,1
2020,472700301,16743,2478,2478,2118,0,14265,9500,3500,6000,0,4765,2600,1665,500,5370,5370,800,2000,3562,110,70,480,288,52
2020,472700321,2180,780,280,280,500,1400,0,0,0,0,1400,1200,200,0,400,400,0,0,1722,472,10,120,240,43
2020,472700351,43832,3432,3432,3432,0,40400,39000,8000,31000,0,1400,400,1000,0,1500,1500,1000,500,1224,226,148,180,65,19
2020,472700361,15900,3200,3200,3200,0,12700,11500,9000,2500,0,1200,700,500,0,0,0,0,0,1437,250,500,70,77,50
2020,472700371,32320,9720,9720,9720,0,22600,20900,20000,900,0,1700,700,1000,0,1000,0,0,0,2104,600,50,180,264,54
2020,472800311,16938,88,88,88,0,16850,16500,8500,8000,0,350,350,0,0,2370,2370,2070,300,4396,276,240,420,366,101
2020,472800331,37356,6046,6046,6046,0,31310,29220,6220,23000,0,2090,1800,290,0,19200,4200,0,1200,2174,140,200,540,182,216
2020,472800351,33440,25340,25340,25340,0,8100,6000,6000,0,0,2100,2000,100,0,0,0,0,0,4556,280,200,600,286,887
2020,472800361,14818,2218,2218,2218,0,12600,12000,12000,0,0,600,600,0,0,0,0,0,0,950,130,120,120,100,37
2020,472900321,120000,11500,11500,11500,0,108500,105000,50000,55000,0,3500,2400,1100,0,0,0,0,0,2880,360,200,480,180,212
2020,472900331,1613,1613,1413,1413,200,0,0,0,0,0,0,0,0,0,0,0,0,0,1344,840,20,24,30,1
2020,472900351,14430,900,900,900,0,13530,13450,6700,6750,0,80,0,80,0,0,0,0,0,669,110,200,48,40,5
2020,480000302,28601,4951,4951,4951,0,23650,22000,12000,10000,0,1650,1650,0,0,14500,14500,14500,0,3376,492,500,420,352,174
2020,480000312,689,689,189,189,500,0,0,0,0,0,0,0,0,0,0,0,0,0,1080,234,1,60,84,1
2020,480000332,76979,34779,34779,34779,0,42200,40000,16000,24000,0,2200,2200,0,0,0,0,0,0,5414,240,210,960,240,977
2020,480000342,55653,2800,2800,2800,0,52853,52000,17000,35000,0,853,340,513,0,23550,23550,23550,0,2901,192,136,294,180,45
2020,480000362,24327,3327,3327,3327,0,21000,20000,20000,0,0,1000,1000,0,0,8000,8000,8000,0,1340,203,30,45,131,95
2020,480000382,43240,13720,13720,13720,0,29520,29000,19000,10000,0,520,400,120,0,1500,0,0,0,6085,240,360,120,360,879
2020,480000392,39339,20040,5040,5040,15000,19299,16000,0,16000,0,3299,3299,0,0,14900,3900,0,3000,5708,360,100,480,240,949
2020,480600321,12236,200,200,200,0,12036,12000,12000,0,0,36,0,36,0,0,0,0,0,892,160,120,36,18,15
2020,480600361,21953,6753,6753,6693,0,15200,15000,15000,0,0,200,200,0,0,10745,10745,9500,0,4998,238,350,560,300,171
2020,480600381,79148,14148,14148,14148,0,65000,65000,35000,30000,0,0,0,0,0,0,0,0,0,2176,480,720,50,156,214
2020,480700311,6768,6768,768,768,6000,0,0,0,0,0,0,0,0,0,2000,2000,2000,0,2222,680,12,280,180,1
2020,480700321,6058,58,58,58,0,6000,6000,6000,0,0,0,0,0,0,0,0,0,0,698,80,120,48,25,6
2020,480700331,48810,2730,530,530,2200,46080,45800,0,45800,0,280,200,80,0,23300,23300,23000,300,1530,438,100,280,36,26
2020,480700341,29445,20370,5370,870,15000,9075,4375,0,4375,0,4700,3400,1300,0,14300,14300,13000,1250,4186,336,36,840,144,83
2020,480700351,18378,3278,3278,3278,0,15100,14000,10000,4000,0,1100,1100,0,0,5700,5700,5700,0,2690,240,240,720,120,57
2020,480700361,28425,225,225,225,0,28200,28000,8000,20000,0,200,200,0,0,500,0,0,0,1038,60,316,30,72,29
2020,480700391,7040,2440,440,440,2000,4600,4000,0,4000,0,600,500,100,0,0,0,0,0,958,408,10,120,60,32
2020,480800301,18967,6967,4967,4967,2000,12000,12000,0,12000,0,0,0,0,0,10880,10880,10880,0,3821,548,250,73,274,17
2020,480800321,5330,30,30,30,0,5300,5300,5300,0,0,0,0,0,0,0,0,0,0,598,102,39,10,29,7
2020,480800331,14596,528,528,528,0,14068,14000,10000,4000,0,68,0,68,0,500,0,0,0,910,126,128,36,24,21
2020,480800341,22461,2066,2066,2066,0,20395,20045,17000,3045,0,350,130,220,0,500,0,0,0,998,100,40,140,40,51
2020,480800351,29100,7805,7805,7805,0,21295,20000,20000,0,0,1295,670,625,0,0,0,0,0,3366,300,30,390,130,49
2020,480800361,38024,12274,12274,9274,0,25750,19000,19000,0,0,6750,3250,2000,1500,50,50,0,0,6060,850,30,640,480,470
2020,480800371,44330,1000,1000,1000,0,43330,42000,22000,20000,0,1330,350,980,0,20,20,0,0,1051,70,25,320,36,83
2020,480800391,81290,78340,45340,45340,33000,2950,0,0,0,0,2950,2500,450,0,300,300,0,0,4184,384,580,360,360,1297
2020,480900301,11855,2855,2855,2855,0,9000,9000,9000,0,0,0,0,0,0,2760,2760,2700,0,770,120,310,26,24,2
2020,480900311,2458,1158,558,558,600,1300,0,0,0,0,1300,600,200,500,100,100,0,0,1431,240,4,108,49,23
2020,480900321,12940,6040,6040,6040,0,6900,6900,6900,0,0,0,0,0,0,0,0,0,0,939,75,270,40,24,9
2020,480900331,14913,6845,6845,6845,0,8068,8000,8000,0,0,68,0,68,0,1300,300,0,0,4352,175,2500,120,192,46
2020,480900341,63401,5611,5611,5611,0,57790,55140,6000,49140,0,2650,650,2000,0,45300,35300,28500,6800,3881,402,140,600,240,279
2020,480900351,17408,7108,7108,7108,0,10300,9600,9600,0,0,700,700,0,0,0,0,0,0,2096,180,50,360,156,131
2020,480900361,10270,9320,2320,320,7000,950,0,0,0,0,950,350,600,0,0,0,0,0,1524,144,150,120,120,25
2020,480900371,47580,11430,11430,11430,0,36150,36000,14000,22000,0,150,0,150,0,0,0,0,0,1687,258,192,150,84,163
2020,480900381,14070,4870,4870,4870,0,9200,8000,8000,0,0,1200,1200,0,0,0,0,0,0,3844,240,120,360,324,54
2020,480900391,52612,5762,5762,5762,0,46850,44000,27000,17000,0,2850,2550,300,0,29218,16718,14828,1200,4270,480,50,480,300,130
2020,481000302,21110,1110,1110,1110,0,20000,20000,20000,0,0,0,0,0,0,0,0,0,0,818,162,185,60,61,29
2020,481000362,1400,1400,1400,1400,0,0,0,0,0,0,0,0,0,0,0,0,0,0,562,108,10,24,50,1
2020,481000382,35480,11340,11340,11340,0,24140,21000,21000,0,0,3140,3140,0,0,10500,0,0,0,1989,169,60,480,90,321
2020,481000392,805,805,605,605,200,0,0,0,0,0,0,0,0,0,2000,2000,0,0,1389,576,8,45,120,23
2020,481600311,14948,5148,5148,5148,0,9800,7000,7000,0,0,2800,2800,0,0,11634,11634,10320,1300,3480,240,200,600,190,442
2020,481600331,26910,7660,7660,7660,0,19250,18000,18000,0,0,1250,950,300,0,120,120,0,0,4686,360,50,110,136,260
2020,481600341,70574,10374,10374,10374,0,60200,58500,52000,6500,0,1700,1600,100,0,27200,26500,26500,0,3710,360,200,720,240,169
2020,481600351,17700,100,100,100,0,17600,17600,17600,0,0,0,0,0,0,0,0,0,0,311,70,20,25,16,17
2020,481600371,98660,33660,23160,23160,10500,65000,65000,0,65000,0,0,0,0,0,33216,16216,16016,0,2220,120,500,50,200,337
2020,481600381,36290,90,90,90,0,36200,36000,31000,5000,0,200,200,0,0,5000,5000,5000,0,3465,200,60,312,276,99
2020,481600391,57849,18460,18460,18460,0,39389,39000,22000,17000,0,389,50,339,0,1660,0,0,0,1788,120,430,180,48,88
2020,481700311,15579,5200,5200,2200,0,10379,10000,0,10000,0,379,200,179,0,0,0,0,0,1042,54,60,240,60,22
2020,481700331,68252,4416,4416,4416,0,63836,62000,9000,53000,0,1836,1700,136,0,1000,1000,1000,0,3504,306,500,370,432,46
2020,481700341,36968,14768,14768,14768,0,22200,22000,22000,0,0,200,200,0,0,0,0,0,0,2388,138,110,290,120,341
2020,481700371,7800,800,800,800,0,7000,7000,7000,0,0,0,0,0,0,2801,2801,2761,0,1320,170,180,100,40,20
2020,481700391,6306,3106,706,706,2400,3200,0,0,0,0,3200,3200,0,0,5258,5258,1440,670,3484,360,100,480,300,38
2020,481800301,10045,8800,4800,4800,4000,1245,0,0,0,0,1245,1200,45,0,100,100,0,100,1928,278,100,120,120,40
2020,481800311,6500,6400,1400,400,5000,100,0,0,0,0,100,100,0,0,0,0,0,0,2148,426,60,150,200,46
2020,481800321,30240,6740,6740,6740,0,23500,22500,12000,10500,0,1000,1000,0,0,1250,1250,500,750,3525,200,720,180,275,74
2020,481800331,98455,10885,8885,8885,2000,87570,87000,0,87000,0,570,570,0,0,68000,60000,60000,0,4141,1248,100,520,83,118
2020,481800351,19920,50,50,50,0,19870,19800,11800,8000,0,70,0,70,0,11888,5888,5888,0,1462,180,120,120,48,9
2020,481800381,12870,2644,2644,2644,0,10226,10000,10000,0,0,226,0,226,0,0,0,0,0,1557,180,200,62,50,144
2020,481800391,26720,120,120,120,0,26600,26000,26000,0,0,600,600,0,0,23700,23700,20400,3000,4220,360,20,150,240,284
2020,481900311,29042,6744,6744,6744,0,22298,18000,18000,0,0,4298,3800,498,0,3000,3000,0,2000,5525,336,80,780,384,685
2020,481900321,1101,801,801,801,0,300,0,0,0,0,300,300,0,0,500,500,0,0,1380,436,118,130,78,27
2020,481900341,28832,7782,7782,7782,0,21050,18000,13000,5000,0,3050,2850,200,0,1000,1000,0,0,5426,360,400,720,420,654
2020,481900371,20962,8561,8561,8561,0,12401,12000,12000,0,0,401,250,151,0,0,0,0,0,3230,246,230,240,260,286
2020,481900381,14100,620,620,620,0,13480,13000,13000,0,0,480,480,0,0,0,0,0,0,2370,180,200,260,177,19
2020,482000312,440,440,440,440,0,0,0,0,0,0,0,0,0,0,0,0,0,0,1110,120,60,240,72,1
2020,482000322,15295,3048,3048,3048,0,12247,11700,11700,0,0,547,321,226,0,10000,10000,10000,0,2293,144,60,180,180,50
2020,482000332,51230,3500,3500,3500,0,47730,47200,38000,9200,0,530,530,0,0,5020,5020,5000,0,3771,375,350,300,216,159
2020,482000342,45680,230,230,230,0,45450,40350,38000,2350,0,5100,5100,0,0,5700,5700,1000,0,3460,240,300,240,120,200
2020,482000352,30774,774,774,774,0,30000,30000,15000,15000,0,0,0,0,0,1400,0,0,0,1264,328,289,10,20,55
2020,482000372,6230,280,280,280,0,5950,5600,5600,0,0,350,350,0,0,4580,4580,4400,0,1208,100,120,130,120,111
2020,482000392,24356,4916,4916,4916,0,19440,18220,5920,12300,0,1220,920,300,0,1572,1572,0,1500,1764,130,84,50,97,27
2020,482600301,81780,81000,71000,52500,10000,780,0,0,0,0,780,780,0,0,0,0,0,0,1894,124,75,280,200,140
2020,482600311,92767,9096,9096,9096,0,83671,82885,62885,20000,0,786,560,226,0,46190,31190,19000,2000,4939,430,240,575,300,610
2020,482600321,50816,27874,27874,27874,0,22942,21000,21000,0,0,1942,1090,852,0,0,0,0,0,4850,380,10,360,300,214
2020,482600331,11740,3340,3340,2840,0,8400,8000,8000,0,0,400,400,0,0,11970,11970,4600,3800,1614,144,10,120,240,24
2020,482600341,95528,59028,44028,44028,15000,36500,36000,0,0,36000,500,500,0,0,24000,24000,0,24000,2823,240,180,340,276,88
2020,482600351,38290,10550,10550,10550,0,27740,16000,16000,0,0,11740,1400,340,10000,0,0,0,0,2894,270,70,360,264,376
2020,482600371,4580,80,80,80,0,4500,4500,4500,0,0,0,0,0,0,0,0,0,0,489,111,144,18,8,5
2020,482600381,30303,8703,8703,8703,0,21600,21000,17000,0,4000,600,600,0,0,7970,7970,7970,0,3250,480,250,720,60,266
2020,482700301,161464,41074,29074,29074,12000,120390,116400,0,116400,0,3990,3790,200,0,3000,0,0,0,3672,360,240,480,192,854
2020,482700311,63000,1300,1300,1300,0,61700,61000,36000,25000,0,700,700,0,0,42150,42150,37350,4500,4960,300,800,180,300,136
2020,482700331,54165,1041,1041,1041,0,53124,50000,50000,0,0,3124,3000,124,0,30025,12025,10600,0,5298,214,30,346,360,100
2020,482700351,20750,1450,1450,1450,0,19300,17000,11000,6000,0,2300,1000,300,1000,6200,6200,5000,1000,3000,320,210,340,350,85
2020,482700371,8328,328,328,328,0,8000,8000,8000,0,0,0,0,0,0,0,0,0,0,602,72,160,12,24,5
2020,482700381,3035,35,35,35,0,3000,3000,3000,0,0,0,0,0,0,0,0,0,0,478,62,48,10,18,2
2020,482700391,40283,7603,7603,7603,0,32680,24100,8500,15600,0,8580,1480,100,7000,70,70,0,0,1954,128,86,252,254,235
2020,482800301,52350,26400,26400,26400,0,25950,10000,8000,2000,0,15950,15650,0,300,0,0,0,0,1750,240,20,180,180,69
2020,482800321,433,433,433,433,0,0,0,0,0,0,0,0,0,0,1200,1200,0,1200,1155,50,5,10,180,93
2020,482800341,835,35,35,35,0,800,800,0,800,0,0,0,0,0,0,0,0,0,1041,98,360,24,84,3
2020,482800351,43859,12983,12983,12983,0,30876,22000,9000,13000,0,8876,1650,7226,0,12674,12674,9674,2000,2832,528,100,240,144,84
2020,482800361,34394,894,894,894,0,33500,33500,6500,27000,0,0,0,0,0,0,0,0,0,2929,84,2000,30,54,39
2020,482800371,10937,2916,2916,2916,0,8021,6500,6500,0,0,1521,1449,72,0,2712,2712,2712,0,3236,130,1200,240,228,100
2020,482800381,928,778,278,278,500,150,0,0,0,0,150,150,0,0,0,0,0,0,1888,118,20,120,84,27
2020,482900301,287500,62500,62500,42500,0,225000,190000,70000,120000,0,35000,0,35000,0,110000,110000,110000,0,5022,382,50,600,230,558
2020,482900311,41020,5770,5770,5770,0,35250,35000,35000,0,0,250,250,0,0,13,13,0,0,2158,192,710,183,60,55
2020,482900321,47397,12357,12357,11757,0,35040,31500,31500,0,0,3540,2640,900,0,0,0,0,0,6487,207,50,370,280,301
2020,482900331,35103,9023,9023,9023,0,26080,24000,23500,500,0,2080,1680,400,0,0,0,0,0,3430,340,160,480,240,104
2020,482900341,2113,1913,1513,1513,400,200,0,0,0,0,200,200,0,0,0,0,0,0,2261,361,60,90,100,13
2020,482900351,5,5,5,5,0,0,0,0,0,0,0,0,0,0,37,37,0,0,533,86,140,12,68,1
2020,482900371,3094,3094,94,94,3000,0,0,0,0,0,0,0,0,0,0,0,0,0,786,84,60,36,56,1
2020,482900381,500,500,500,500,0,0,0,0,0,0,0,0,0,0,0,0,0,0,894,150,150,10,24,1
2020,482900391,12500,1480,1480,1480,0,11020,10820,2120,8700,0,200,0,200,0,0,0,0,0,682,102,78,36,36,9
2020,483000302,14106,4606,4606,4606,0,9500,8500,8500,0,0,1000,1000,0,0,20,20,0,0,1410,172,20,120,36,52
2020,483000312,8400,1900,1900,1900,0,6500,6100,4900,1200,0,400,350,50,0,0,0,0,0,984,282,120,100,82,14
2020,483600311,43697,11647,11647,11647,0,32050,28600,10000,18600,0,3450,300,3150,0,0,0,0,0,2340,70,120,320,140,40
2020,483700301,13007,1647,1647,1647,0,11360,9000,0,9000,0,2360,400,1960,0,1520,1520,0,1500,4369,78,3000,360,96,30
2020,483700311,10700,4200,4200,4200,0,6500,6500,4500,2000,0,0,0,0,0,0,0,0,0,1170,90,240,360,40,4
2020,483900301,240,240,240,240,0,0,0,0,0,0,0,0,0,0,0,0,0,0,940,64,600,50,36,1
2020,490000202,21742,590,590,590,0,21152,21000,21000,0,0,152,152,0,0,12800,12800,11000,1800,6140,300,4000,90,204,63
2020,490000212,73660,19160,19160,3160,0,54500,51000,21000,30000,0,3500,3500,0,0,4000,4000,4000,0,1720,150,150,100,140,933
2020,490000222,35560,3060,3060,2560,0,32500,29700,8700,21000,0,2800,1300,1500,0,30600,30600,30600,0,3556,1300,216,440,120,58
2020,490000252,765,365,365,365,0,400,0,0,0,0,400,400,0,0,0,0,0,0,578,154,160,70,48,26
2020,490000262,4530,4030,30,30,4000,500,0,0,0,0,500,500,0,0,0,0,0,0,922,300,30,12,120,31
2020,490000272,11350,11150,2350,2350,8800,200,0,0,0,0,200,200,0,0,0,0,0,0,826,240,30,150,180,23
2020,490000282,39172,18672,5672,5672,13000,20500,20000,0,0,20000,500,300,200,0,4000,4000,4000,0,2408,300,116,240,180,262
2020,490000292,24561,22411,11039,11039,11372,2150,0,0,0,0,2150,2150,0,0,17700,17700,8900,8800,3422,698,300,10,120,330
2020,490000302,197780,680,680,680,0,197100,180000,50000,130000,0,17100,2100,15000,0,10500,10500,10500,0,3140,400,100,500,400,188
2020,490000312,15080,30,30,30,0,15050,15000,15000,0,0,50,0,50,0,0,0,0,0,1180,150,36,10,24,23
2020,490000322,150,150,150,150,0,0,0,0,0,0,0,0,0,0,0,0,0,0,549,54,50,10,20,1
2020,490000332,28629,3029,3029,3029,0,25600,25000,25000,0,0,600,600,0,0,4360,4360,0,4000,3778,305,10,250,151,941
2020,490000342,920,820,620,620,200,100,0,0,0,0,100,100,0,0,1400,1400,0,1400,1708,536,30,100,170,131
2020,490000352,3350,2050,1050,1050,1000,1300,0,0,0,0,1300,1300,0,0,3000,3000,0,3000,1603,689,30,180,54,4
2020,490000362,84140,12000,12000,12000,0,72140,70000,45000,25000,0,2140,1800,340,0,0,0,0,0,4240,370,360,480,240,154
2020,490000382,19400,1400,1400,1400,0,18000,17000,17000,0,0,1000,1000,0,0,0,0,0,0,3300,170,200,450,400,95
2020,490600221,22128,6328,6328,5328,0,15800,11000,0,4000,7000,4800,2800,2000,0,7220,7220,0,7220,2810,200,30,200,400,129
2020,490600311,2795,2795,1675,1675,1120,0,0,0,0,0,0,0,0,0,0,0,0,0,848,120,60,60,84,1
2020,490600361,38194,13536,13536,13536,0,24658,24500,20000,4500,0,158,0,158,0,0,0,0,0,1594,120,780,10,84,38
2020,490700231,28853,2496,2496,2496,0,26357,26000,26000,0,0,357,270,87,0,0,0,0,0,1456,190,36,60,40,98
2020,490700301,10,10,10,10,0,0,0,0,0,0,0,0,0,0,0,0,0,0,930,320,80,40,20,1
2020,490700341,35648,2688,2638,2518,50,32960,30000,0,30000,0,2960,2960,0,0,14800,14800,13000,1500,6057,124,50,290,288,38
2020,490700351,34910,4860,4860,4860,0,30050,30000,30000,0,0,50,50,0,0,3460,3460,3460,0,1480,110,20,180,120,33
2020,490700371,287420,170,170,170,0,287250,262000,12000,250000,0,25250,1550,23700,0,20000,20000,10000,10000,4680,250,80,500,200,226
2020,490700381,93350,13250,13250,13250,0,80100,80000,40000,40000,0,100,100,0,0,0,0,0,0,2796,394,240,120,120,98
2020,490700391,113062,9062,9062,9062,0,104000,104000,29000,75000,0,0,0,0,0,0,0,0,0,1495,122,50,36,48,39
2020,490800201,16650,1050,1050,1050,0,15600,7000,7000,0,0,8600,5100,3500,0,1645,1645,1645,0,2200,390,40,250,120,34
2020,490800211,9625,8625,3625,3625,5000,1000,0,0,0,0,1000,1000,0,0,0,0,0,0,1080,180,20,150,100,64
2020,490800231,20700,5200,5200,3200,0,15500,15000,15000,0,0,500,500,0,0,0,0,0,0,1580,300,200,50,60,51
2020,490800241,18020,3020,3020,3020,0,15000,13000,13000,0,0,2000,2000,0,0,0,0,0,0,1580,300,200,300,90,67
2020,490800261,22720,2720,2720,2520,0,20000,12000,12000,0,0,8000,3500,2000,2500,6561,6561,5961,600,3228,156,250,550,108,197
2020,490800301,1330,1300,1300,1300,0,30,0,0,0,0,30,0,30,0,0,0,0,0,676,114,60,10,48,25
2020,490800311,33130,11630,11630,11630,0,21500,20000,20000,0,0,1500,1500,0,0,6800,6800,6600,0,4750,220,360,600,240,76
2020,490800321,34600,500,500,500,0,34100,34000,0,34000,0,100,0,100,0,0,0,0,0,523,51,120,12,30,49
2020,490800331,816,816,16,16,800,0,0,0,0,0,0,0,0,0,1600,1600,0,1600,1595,300,10,60,240,1
2020,490800341,22180,80,80,80,0,22100,22000,22000,0,0,100,100,0,0,2500,2500,2500,0,1277,180,120,120,48,27
2020,490800351,135490,8890,8890,8890,0,126600,115000,15000,100000,0,11600,1000,600,10000,12000,12000,12000,0,2880,120,10,600,360,178
2020,490800391,6192,6042,5942,5942,100,150,0,0,0,0,150,150,0,0,1200,1200,0,0,1280,210,10,120,240,16
2020,490900211,17940,2440,2440,2440,0,15500,15000,15000,0,0,500,0,500,0,0,0,0,0,2691,324,30,15,132,19
2020,490900221,296,296,296,296,0,0,0,0,0,0,0,0,0,0,0,0,0,0,554,120,60,12,12,1
2020,490900241,73770,13370,13370,13370,0,60400,60000,60000,0,0,400,400,0,0,0,0,0,0,2586,276,600,120,120,196
2020,490900251,50,50,50,50,0,0,0,0,0,0,0,0,0,0,0,0,0,0,656,60,60,120,36,1
2020,490900291,116646,4686,4686,4686,0,111960,111000,54000,57000,0,960,960,0,0,19000,0,0,0,5450,300,1000,1240,180,270
2020,490900311,1574,874,374,374,500,700,0,0,0,0,700,700,0,0,50,50,0,0,3160,620,10,150,240,7
2020,490900321,24350,4350,4350,4350,0,20000,20000,20000,0,0,0,0,0,0,0,0,0,0,2812,76,240,240,60,17
2020,490900331,21000,1000,1000,1000,0,20000,20000,20000,0,0,0,0,0,0,0,0,0,0,1187,93,17,0,24,13
2020,490900341,85110,14510,14510,14510,0,70600,69000,20000,49000,0,1600,1600,0,0,16520,16520,5600,10000,6508,330,120,840,488,183
2020,490900351,19390,4590,4490,4490,100,14800,14000,0,14000,0,800,800,0,0,0,0,0,0,810,350,10,75,29,14
2020,490900371,8790,5090,3090,3090,2000,3700,0,0,0,0,3700,700,2000,1000,0,0,0,0,3930,360,100,240,180,58
2020,490900381,56760,4710,4710,4710,0,52050,50000,50000,0,0,2050,2000,50,0,9000,9000,9000,0,2800,300,300,350,250,92
2020,491000202,24264,14364,8464,6464,5900,9900,0,0,0,0,9900,6900,3000,0,11083,11083,4900,0,4194,744,50,450,250,317
2020,491000212,93900,8600,8600,8400,0,85300,80000,80000,0,0,5300,5300,0,0,13772,13772,13772,0,3120,280,300,400,240,94
2020,491000222,75633,583,583,583,0,75050,73000,73000,0,0,2050,2050,0,0,11542,11542,11467,0,7216,324,400,400,192,813
2020,491000232,46500,39500,18500,18500,21000,7000,6000,0,3000,3000,1000,1000,0,0,0,0,0,0,4170,300,200,300,150,435
2020,491000302,194400,24550,24550,17550,0,169850,160000,20000,140000,0,9850,3350,6500,0,3000,3000,0,3000,5720,3060,50,600,360,230
2020,491000312,300,300,300,300,0,0,0,0,0,0,0,0,0,0,0,0,0,0,570,169,10,60,36,1
2020,491000322,260,260,10,10,250,0,0,0,0,0,0,0,0,0,0,0,0,0,678,86,20,15,13,1
2020,491000342,85980,40980,1080,1080,39900,45000,40000,0,40000,0,5000,5000,0,0,45200,25200,20000,3200,1270,300,30,100,100,152
2020,491600311,41140,11140,11140,11140,0,30000,30000,0,30000,0,0,0,0,0,0,0,0,0,729,250,40,0,36,56
2020,491600321,28213,10863,10863,10863,0,17350,16000,15000,1000,0,1350,1350,0,0,9000,9000,8000,0,2508,332,50,960,252,26
2020,491600351,450,450,50,50,400,0,0,0,0,0,0,0,0,0,500,500,0,0,633,100,0,0,13,1
2020,491700301,5921,5821,3321,3321,2500,100,0,0,0,0,100,100,0,0,0,0,0,0,2902,300,100,200,72,35
2020,491700311,11080,11080,9880,9880,1200,0,0,0,0,0,0,0,0,0,780,780,780,0,1721,250,15,60,156,21
2020,491700321,352300,32300,32300,32300,0,320000,320000,20000,300000,0,0,0,0,0,0,0,0,0,1644,120,120,0,24,166
2020,491700331,28040,540,540,540,0,27500,27000,0,27000,0,500,0,500,0,4700,4700,2800,1900,810,36,48,0,36,7
2020,491700341,151614,5744,5744,5744,0,145870,145000,60000,85000,0,870,870,0,0,59300,38300,38000,0,6050,500,150,1000,300,622
2020,491800201,4265,3065,1065,1065,2000,1200,0,0,0,0,1200,1200,0,0,0,0,0,0,1410,240,70,250,130,252
2020,491800211,30371,7871,7871,4871,0,22500,15000,15000,0,0,7500,4500,3000,0,11800,11800,6000,2100,1922,180,120,120,120,111
2020,491800231,74757,21957,21957,21957,0,52800,50000,22000,28000,0,2800,2800,0,0,1292,1292,1200,0,3634,594,163,113,300,212
2020,491800241,6893,6493,2693,2693,3800,400,0,0,0,0,400,400,0,0,50,50,0,0,1604,250,150,200,84,17
2020,491800251,55764,4264,4264,4264,0,51500,50500,5500,45000,0,1000,1000,0,0,3500,3500,3500,0,2295,215,20,300,170,50
2020,491800281,16370,1600,1600,1600,0,14770,14700,13700,1000,0,70,0,70,0,0,0,0,0,1177,120,30,24,48,19
2020,491800291,18926,11526,11526,7526,0,7400,6500,6500,0,0,900,900,0,0,0,0,0,0,1480,136,12,240,132,37
2020,491800301,208307,66607,15607,15607,51000,141700,138000,0,138000,0,3700,3700,0,0,52000,0,0,0,6450,400,50,500,200,1506
2020,491800311,103910,16426,16426,16426,0,87484,84000,15000,69000,0,3484,1600,1884,0,0,0,0,0,2630,240,1000,240,120,100
2020,491800321,103992,5992,5992,5792,0,98000,95000,5000,90000,0,3000,3000,0,0,0,0,0,0,664,204,10,120,180,127
2020,491800331,54370,7870,7870,7870,0,46500,43000,18000,25000,0,3500,1700,1800,0,25120,25120,25000,0,2288,244,20,308,168,240
2020,491800341,50,50,50,50,0,0,0,0,0,0,0,0,0,0,600,600,0,600,600,100,20,20,70,1
2020,491900201,57367,4517,4517,4517,0,52850,46000,46000,0,0,6850,6400,450,0,0,0,0,0,7765,300,150,380,276,815
2020,491900211,3488,2968,1968,1968,1000,520,0,0,0,0,520,520,0,0,3950,3950,0,3300,3900,1000,100,300,420,144
2020,491900221,17647,16997,5997,5997,11000,650,0,0,0,0,650,650,0,0,8800,8800,8800,0,2220,300,180,410,120,37
2020,491900231,14329,12829,7329,7329,5500,1500,0,0,0,0,1500,1500,0,0,1130,1130,0,0,3500,300,60,480,240,208
2020,491900301,71170,170,170,170,0,71000,70000,70000,0,0,1000,1000,0,0,51700,51100,39000,1200,1591,110,150,120,30,189
2020,491900321,10220,9720,4720,2420,5000,500,0,0,0,0,500,500,0,0,100,100,0,0,1826,180,50,330,126,61
2020,491900331,48100,1100,1100,1100,0,47000,46000,7000,39000,0,1000,0,1000,0,0,0,0,0,914,204,70,10,72,16
2020,491900341,47836,8936,8936,8936,0,38900,37000,37000,0,0,1900,1900,0,0,7350,7350,7000,300,5352,240,12,360,240,1386
2020,492800211,30430,400,400,400,0,30030,30000,24000,6000,0,30,0,30,0,0,0,0,0,1136,352,100,240,84,24
2020,492800261,163000,3000,3000,3000,0,160000,157000,40000,117000,0,3000,3000,0,0,116000,116000,102000,14000,5890,600,300,630,370,726
2020,492800281,548,548,48,48,500,0,0,0,0,0,0,0,0,0,1500,1500,0,600,2582,720,40,90,180,1
2020,493800201,112293,8693,8693,8693,0,103600,101000,11000,90000,0,2600,2600,0,0,12820,9820,9820,0,3050,300,500,500,250,261
2020,493800281,30670,11170,9170,9170,2000,19500,18000,0,18000,0,1500,1500,0,0,17000,0,0,0,3715,495,300,510,120,846
2020,493800291,88268,11318,11318,11318,0,76950,75000,40000,35000,0,1950,1950,0,0,34349,16349,12149,4200,4790,360,40,840,400,1951
2020,494800231,43721,7621,7621,7621,0,36100,35000,35000,0,0,1100,1100,0,0,9500,9500,9500,0,3820,300,80,500,240,296
2020,494800261,158463,11463,6463,6463,5000,147000,141800,0,124000,17800,5200,5200,0,0,90200,88200,68863,7337,8240,1200,200,800,440,2811
2020,495800201,490,140,140,140,0,350,0,0,0,0,350,350,0,0,0,0,0,0,868,240,100,120,43,108
2020,495800231,104326,4100,4100,4100,0,100226,100000,40000,60000,0,226,0,226,0,5500,2500,2500,0,2198,696,360,120,72,126
2020,495800241,67160,2010,2010,2010,0,65150,63800,37000,26800,0,1350,1350,0,0,6500,4000,4000,0,4040,300,60,460,34,550
2020,495800271,54218,6202,6202,6202,0,48016,47000,47000,0,0,1016,1000,16,0,3020,3020,3000,0,4550,380,50,100,200,38
2020,510000112,72975,2975,2975,2975,0,70000,70000,70000,0,0,0,0,0,0,0,0,0,0,1590,350,300,50,50,87
2020,510000122,62530,62530,21530,21530,41000,0,0,0,0,0,0,0,0,0,0,0,0,0,4620,140,900,150,80,807
2020,510000172,121000,71000,6000,6000,65000,50000,50000,0,50000,0,0,0,0,0,33000,0,0,0,2185,600,800,0,60,366
2020,510000202,3870,3644,1644,1644,2000,226,0,0,0,0,226,0,226,0,0,0,0,0,2382,420,800,120,72,20
2020,510000232,59485,5485,5485,5485,0,54000,54000,24000,30000,0,0,0,0,0,1800,800,0,800,3006,269,162,120,124,164
2020,510000242,3125,2025,525,25,1500,1100,0,0,0,0,1100,100,1000,0,0,0,0,0,993,408,10,120,60,9
2020,510000252,3062,3020,20,20,3000,42,0,0,0,0,42,0,42,0,500,500,0,0,1743,408,180,24,96,14
2020,510000262,206700,7700,7700,7700,0,199000,198000,38000,160000,0,1000,1000,0,0,17500,14000,14000,0,2000,240,24,240,120,438
2020,510000272,123046,10074,10074,9274,0,112972,104600,24600,80000,0,8372,7772,600,0,29300,29300,27900,1100,4540,500,100,350,480,2154
2020,510000282,32013,1400,1400,1400,0,30613,30000,30000,0,0,613,500,113,0,0,0,0,0,3420,240,60,120,144,918
2020,510000292,7760,7760,1760,1760,6000,0,0,0,0,0,0,0,0,0,0,0,0,0,1572,120,12,84,36,3
2020,510000302,14680,11880,1880,1880,10000,2800,0,0,0,0,2800,2800,0,0,0,0,0,0,3172,516,700,600,240,68
2020,510000312,195640,10160,10160,10160,0,185480,185000,0,185000,0,480,400,80,0,10040,40,0,0,1301,276,84,96,60,153
2020,510000322,15300,300,300,300,0,15000,15000,15000,0,0,0,0,0,0,0,0,0,0,499,96,80,10,48,10
2020,510000342,22430,1430,1430,1430,0,21000,21000,21000,0,0,0,0,0,0,1200,1200,1200,0,2560,360,30,50,110,26
2020,510000352,3640,3480,1480,1480,2000,160,0,0,0,0,160,160,0,0,0,0,0,0,6730,1200,30,720,360,82
2020,510000362,28400,400,400,400,0,28000,28000,28000,0,0,0,0,0,0,0,0,0,0,473,80,5,10,48,21
2020,510000372,4320,4320,3020,3020,1300,0,0,0,0,0,0,0,0,0,0,0,0,0,941,145,74,72,28,1
2020,510000382,10400,8600,100,100,8500,1800,0,0,0,0,1800,1800,0,0,6800,6800,6800,0,2442,360,3,141,120,392
2020,510000392,47088,4410,4410,4410,0,42678,42000,42000,0,0,678,0,678,0,60,60,0,0,2024,264,120,60,180,51
2020,510001102,7540,7540,40,40,7500,0,0,0,0,0,0,0,0,0,0,0,0,0,757,369,72,30,96,1
2020,510600211,17222,15222,2222,2222,13000,2000,0,0,0,0,2000,2000,0,0,2900,2900,1800,800,4165,260,300,200,180,32
2020,510600241,12850,7350,3050,1050,4300,5500,0,0,0,0,5500,0,2000,3500,0,0,0,0,2114,72,20,180,42,11
2020,510600251,1089,1089,89,89,1000,0,0,0,0,0,0,0,0,0,1200,1200,0,0,1818,540,100,96,120,1
2020,510600271,39330,980,980,980,0,38350,38000,38000,0,0,350,350,0,0,12260,6760,6760,0,2261,925,72,242,70,55
2020,510600281,66608,208,208,208,0,66400,62500,44000,18500,0,3900,1400,2500,0,14800,9500,9500,0,3296,450,55,190,80,73
2020,510600291,65565,14655,14655,14655,0,50910,50000,50000,0,0,910,550,360,0,0,0,0,0,6510,500,360,800,250,2369
2020,510600331,112440,17210,17210,17210,0,95230,95000,54000,33500,7500,230,0,230,0,63215,37215,0,1650,3910,300,360,600,360,126
2020,510600351,78284,17684,17684,17684,0,60600,58000,35000,23000,0,2600,2600,0,0,3000,0,0,0,3440,380,300,370,190,225
2020,510600361,46430,3400,3400,3400,0,43030,43000,36000,7000,0,30,0,30,0,10500,10500,10000,0,8350,400,150,100,300,1715
2020,510600371,27064,1564,1564,94,0,25500,21000,21000,0,0,4500,4500,0,0,4100,4100,0,0,4316,504,60,480,480,192
2020,510600381,211710,30840,30840,29840,0,180870,180000,60000,120000,0,870,370,500,0,0,0,0,0,6145,765,300,100,280,399
2020,510601101,208000,6300,6300,6300,0,201700,201000,100000,101000,0,700,700,0,0,132000,7000,0,0,2590,500,20,20,150,215
2020,510601111,7120,120,120,120,0,7000,7000,7000,0,0,0,0,0,0,3350,3350,3350,0,1516,480,120,120,96,41
2020,510700111,89034,48634,18634,14834,30000,40400,40000,0,40000,0,400,400,0,0,1500,0,0,0,4825,600,100,100,150,5992
2020,510700121,23080,3080,3080,3080,0,20000,20000,10000,10000,0,0,0,0,0,15000,0,0,0,1035,120,55,10,30,13
2020,510700131,5090,5090,2090,2090,3000,0,0,0,0,0,0,0,0,0,2672,2672,2280,0,5300,790,100,480,300,709
2020,510700141,30,30,30,30,0,0,0,0,0,0,0,0,0,0,0,0,0,0,680,100,100,30,30,1
2020,510700161,8619,7619,6619,1619,1000,1000,0,0,0,0,1000,1000,0,0,0,0,0,0,3246,756,10,120,120,599
2020,510700181,36605,34105,2105,2105,32000,2500,0,0,0,0,2500,2500,0,0,0,0,0,0,3260,900,150,500,200,354
2020,510700191,61684,10280,10280,9280,0,51404,51000,50000,1000,0,404,270,134,0,0,0,0,0,1680,270,50,200,50,82
2020,510700211,2100,2100,1100,1100,1000,0,0,0,0,0,0,0,0,0,0,0,0,0,1758,480,80,48,120,1
2020,510700241,34846,6271,6271,6271,0,28575,28500,4500,24000,0,75,0,75,0,19595,16595,16595,0,1810,160,60,170,120,43
2020,510700251,4020,20,20,20,0,4000,4000,4000,0,0,0,0,0,0,0,0,0,0,715,200,100,12,8,5
2020,510700271,64010,5010,5010,5010,0,59000,56000,21000,35000,0,3000,3000,0,0,4300,4300,0,0,3320,140,800,700,180,286
2020,510700291,16464,1964,1964,1964,0,14500,14500,14500,0,0,0,0,0,0,7336,7336,7236,0,1586,204,108,72,67,15
2020,510700331,147735,50035,50035,49935,0,97700,94000,52000,42000,0,3700,3200,500,0,23560,20060,20000,0,4130,400,400,450,200,2361
2020,510700341,51980,1630,1630,1630,0,50350,50000,50000,0,0,350,300,50,0,300,300,0,300,3280,380,300,300,250,402
2020,510700351,18642,18442,8942,8392,9500,200,0,0,0,0,200,200,0,0,3550,3550,0,3000,2568,228,20,540,300,45
2020,510700361,63110,9410,9410,8810,0,53700,52000,32000,20000,0,1700,950,750,0,4196,4196,4196,0,3606,480,600,570,180,695
2020,510700371,4227,4227,1027,1027,3200,0,0,0,0,0,0,0,0,0,4500,4500,0,1500,2171,370,200,96,300,1
2020,510800111,184134,54134,54134,54134,0,130000,130000,100000,30000,0,0,0,0,0,3000,0,0,0,3950,600,150,200,200,2399
2020,510800161,51605,33005,3005,3005,30000,18600,15000,0,15000,0,3600,3500,100,0,14400,7400,7400,0,2105,240,120,25,240,86
2020,510800171,25690,25690,3690,3690,22000,0,0,0,0,0,0,0,0,0,13000,13000,13000,0,1596,240,60,60,60,2
2020,510800201,24280,3150,3150,3150,0,21130,21000,21000,0,0,130,0,130,0,4800,0,0,0,2124,720,240,54,180,35
2020,510800221,65894,26281,26281,26281,0,39613,39000,11000,28000,0,613,500,113,0,20050,50,0,0,2424,248,200,240,264,153
2020,510800241,5,5,5,5,0,0,0,0,0,0,0,0,0,0,0,0,0,0,552,50,50,36,30,0
2020,510800261,40855,855,855,855,0,40000,40000,40000,0,0,0,0,0,0,2500,0,0,0,1736,216,50,200,90,130
2020,510800271,25150,3100,3100,3100,0,22050,21000,21000,0,0,1050,1000,50,0,2750,250,0,0,3690,380,500,300,250,1468
2020,510800291,11610,1360,1360,1360,0,10250,10000,10000,0,0,250,250,0,0,4000,4000,4000,0,1340,240,10,120,60,39
2020,510800301,85878,47994,7994,4994,40000,37884,20000,0,20000,0,17884,1200,13684,3000,0,0,0,0,2250,480,50,480,180,138
2020,510800321,134930,34280,34280,34280,0,100650,95000,55000,40000,0,5650,3450,1200,1000,1000,1000,0,1000,3150,300,300,500,100,668
2020,510800331,32091,31391,14391,14391,17000,700,0,0,0,0,700,600,100,0,0,0,0,0,3810,700,500,400,300,162
2020,510800361,13916,13916,3916,416,10000,0,0,0,0,0,0,0,0,0,0,0,0,0,709,68,10,10,36,13
2020,510800391,510,510,10,10,500,0,0,0,0,0,0,0,0,0,0,0,0,0,1267,510,250,100,84,2
2020,510801101,18790,18590,5090,5090,13500,200,0,0,0,0,200,200,0,0,0,0,0,0,2778,132,40,600,216,26
2020,510900101,120932,12932,12932,12932,0,108000,105000,105000,0,0,3000,3000,0,0,49000,49000,41000,8000,11100,600,1000,300,200,3895
2020,510900111,12588,6488,6488,6488,0,6100,3500,0,0,3500,2600,2500,100,0,0,0,0,0,2100,160,150,150,200,50
2020,510900141,588200,16200,16200,16200,0,572000,570000,220000,350000,0,2000,2000,0,0,33500,0,0,0,2292,500,150,100,72,1000
2020,510900161,84472,2772,2772,2772,0,81700,80000,80000,0,0,1700,1700,0,0,12500,12500,11500,0,3227,390,400,280,240,180
2020,510900201,14300,5800,5800,5800,0,8500,7000,7000,0,0,1500,1500,0,0,1300,1300,0,1300,3220,240,50,600,240,198
2020,510900211,24140,5140,5140,5140,0,19000,19000,17000,2000,0,0,0,0,0,61,61,0,0,2307,300,1068,55,140,22
2020,510900221,17280,280,280,280,0,17000,17000,17000,0,0,0,0,0,0,0,0,0,0,1386,240,300,51,65,14
2020,510900241,28510,2490,2490,2490,0,26020,25000,25000,0,0,1020,1020,0,0,2400,1200,0,0,7503,1924,1700,816,480,377
2020,510900251,18487,2864,2864,2864,0,15623,15000,15000,0,0,623,510,113,0,8380,8380,8300,0,1896,294,180,144,132,56
2020,510900261,27261,4181,4181,4181,0,23080,22000,22000,0,0,1080,1000,80,0,6680,6680,6680,0,3059,564,130,270,165,658
2020,510900271,15538,15538,3538,3538,12000,0,0,0,0,0,0,0,0,0,10000,10000,0,10000,2240,240,120,240,240,2
2020,510900291,2506,2506,506,506,2000,0,0,0,0,0,0,0,0,0,90,90,0,0,1670,610,10,80,110,0
2020,510900321,7228,7228,4928,4928,2300,0,0,0,0,0,0,0,0,0,0,0,0,0,1044,36,300,156,72,2
2020,510900331,97212,9162,9162,7662,0,88050,80000,60000,20000,0,8050,8050,0,0,19000,7000,0,7000,3392,200,77,500,408,83
2020,510900351,29720,3870,3870,3370,0,25850,19000,19000,0,0,6850,2900,250,3700,0,0,0,0,1409,50,200,360,144,156
2020,510900381,41050,500,500,500,0,40550,40000,40000,0,0,550,550,0,0,1900,1900,1900,0,2284,300,300,100,180,59
2020,510901101,2524,1374,374,374,1000,1150,0,0,0,0,1150,1150,0,0,900,900,200,0,2450,600,20,128,120,73
2020,511000122,95500,85500,71500,71500,14000,10000,0,0,0,0,10000,2000,0,8000,0,0,0,0,1732,172,136,100,84,251
2020,511000152,31970,29670,2670,2670,27000,2300,0,0,0,0,2300,2300,0,0,700,700,0,0,3130,240,100,360,190,352
2020,511000162,34350,350,350,350,0,34000,34000,34000,0,0,0,0,0,0,0,0,0,0,2205,360,420,36,96,42
2020,511000172,30218,3718,3718,3718,0,26500,26500,20000,6500,0,0,0,0,0,9400,6900,5800,300,2068,135,10,156,228,49
2020,511000202,13150,150,150,150,0,13000,13000,13000,0,0,0,0,0,0,0,0,0,0,1849,179,840,24,36,9
2020,511000212,540,540,40,40,500,0,0,0,0,0,0,0,0,0,1000,1000,0,1000,1649,552,10,72,120,1
2020,511000222,87030,10180,10180,10180,0,76850,76000,45000,31000,0,850,850,0,0,59500,59500,48700,10800,6640,280,460,360,480,2585
2020,511000232,157304,39901,39901,31901,0,117403,113000,83000,30000,0,4403,4290,113,0,14050,13050,13000,0,8035,480,110,900,300,2061
2020,511000242,27210,6610,6610,6610,0,20600,20000,5000,15000,0,600,600,0,0,13600,600,0,600,842,20,50,16,40,27
2020,511000252,20780,10280,10280,7580,0,10500,10000,5000,5000,0,500,500,0,0,1000,1000,1000,0,2700,180,120,420,180,54
2020,511000272,19664,2034,2034,2034,0,17630,16000,16000,0,0,1630,1130,500,0,4300,4300,3800,500,938,72,10,120,96,19
2020,511000282,1110,1110,610,610,500,0,0,0,0,0,0,0,0,0,0,0,0,0,1870,120,100,150,150,1
2020,511000302,58784,24634,4634,4634,20000,34150,33600,0,0,33600,550,550,0,0,33000,33000,0,33000,2451,130,5,120,168,86
2020,511000312,2690,2690,1390,1390,1300,0,0,0,0,0,0,0,0,0,0,0,0,0,1075,69,10,10,48,1
2020,511000332,14810,6310,3310,2780,3000,8500,6000,0,0,6000,2500,2500,0,0,4300,4300,4300,0,4988,948,400,696,264,261
2020,511000342,44294,19844,3844,3844,16000,24450,24000,0,24000,0,450,450,0,0,14500,0,0,0,2033,132,400,405,41,105
2020,511000352,670,670,20,20,650,0,0,0,0,0,0,0,0,0,766,766,0,766,868,360,0,120,84,25
2020,511000362,4800,2800,1300,1300,1500,2000,0,0,0,0,2000,2000,0,0,30,30,0,0,1516,300,50,144,72,4
2020,511000372,13960,13960,960,960,13000,0,0,0,0,0,0,0,0,0,2210,2210,0,2210,2864,156,150,86,240,61
2020,511600101,519930,28430,13430,13430,15000,491500,490000,0,490000,0,1500,1500,0,0,27000,0,0,0,3270,600,300,180,120,2547
2020,511600111,830280,18330,18330,18330,0,811950,810000,160000,650000,0,1950,1950,0,0,110000,34000,34000,0,6606,250,50,360,100,1115
2020,511600151,3446,3446,446,446,3000,0,0,0,0,0,0,0,0,0,0,0,0,0,1890,540,500,120,120,11
2020,511600161,10,10,10,10,0,0,0,0,0,0,0,0,0,0,90,90,0,0,1090,180,240,80,40,10
2020,511600201,3950,3950,50,50,3900,0,0,0,0,0,0,0,0,0,0,0,0,0,825,98,48,30,32,1
2020,511600211,122065,1840,1840,1840,0,120225,120000,25000,95000,0,225,200,25,0,18000,11000,11000,0,1954,240,24,120,180,210
2020,511600231,11830,2830,2830,2830,0,9000,9000,9000,0,0,0,0,0,0,0,0,0,0,1026,120,150,50,36,9
2020,511600251,23138,3138,3138,3138,0,20000,20000,20000,0,0,0,0,0,0,0,0,0,0,1636,180,80,96,60,51
2020,511600261,29860,11630,11630,11630,0,18230,18000,18000,0,0,230,0,230,0,0,0,0,0,1242,156,50,72,84,30
2020,511600281,53306,3381,3381,3381,0,49925,49000,15000,15000,19000,925,800,125,0,0,0,0,0,4936,420,400,600,240,262
2020,511600291,26377,8112,8112,8112,0,18265,16000,16000,0,0,2265,1700,565,0,0,0,0,0,2426,146,50,250,200,379
2020,511600301,1005,1005,5,5,1000,0,0,0,0,0,0,0,0,0,500,500,0,500,1944,900,10,40,84,0
2020,511600311,16198,15198,2198,2198,13000,1000,0,0,0,0,1000,1000,0,0,0,0,0,0,1072,100,50,240,72,71
2020,511700101,43795,2895,2895,2895,0,40900,40000,40000,0,0,900,900,0,0,4120,4120,4000,0,3300,336,120,480,204,476
2020,511700111,62936,776,776,776,0,62160,62160,32160,30000,0,0,0,0,0,18776,18776,18696,0,2069,240,180,105,156,81
2020,511700121,64700,2200,2200,2200,0,62500,60000,60000,0,0,2500,2300,200,0,11280,180,0,180,2170,150,70,240,270,397
2020,511700131,130040,7040,7040,7040,0,123000,120000,65000,55000,0,3000,2000,1000,0,51050,23050,16400,0,6550,360,500,360,430,608
2020,511700151,374288,122288,122288,122288,0,252000,252000,85000,167000,0,0,0,0,0,83000,80000,80000,0,9242,495,207,360,240,1165
2020,511700161,296098,71798,4798,4798,67000,224300,208000,0,208000,0,16300,1300,15000,0,128000,80000,80000,0,6102,300,150,600,300,558
2020,511700171,63100,16100,16100,5600,0,47000,47000,47000,0,0,0,0,0,0,0,0,0,0,1800,450,240,80,60,57
2020,511700181,45470,470,470,470,0,45000,45000,45000,0,0,0,0,0,0,0,0,0,0,2180,280,120,140,120,187
2020,511700191,2005,2005,5,5,2000,0,0,0,0,0,0,0,0,0,0,0,0,0,1248,660,0,30,18,0
2020,511700221,33740,3490,3490,3490,0,30250,30000,16000,14000,0,250,250,0,0,1000,0,0,0,1740,360,60,240,60,54
2020,511700251,18500,18500,5500,5500,13000,0,0,0,0,0,0,0,0,0,0,0,0,0,667,108,60,20,24,15
2020,511700261,1100,1100,100,100,1000,0,0,0,0,0,0,0,0,0,0,0,0,0,1546,360,50,56,80,6
2020,511700281,760,760,60,60,700,0,0,0,0,0,0,0,0,0,1000,1000,0,1000,1544,420,24,120,120,11
2020,511700291,90630,9200,9200,9200,0,81430,76000,30000,46000,0,5430,5430,0,0,48800,48800,39300,9500,4540,240,80,280,120,951
2020,511700301,505,505,5,5,500,0,0,0,0,0,0,0,0,0,2700,2700,0,0,1833,960,1,10,48,20
2020,511700311,214,214,214,214,0,0,0,0,0,0,0,0,0,0,15,15,0,0,1288,200,60,168,156,198
2020,511700321,34504,15704,15704,15704,0,18800,18000,18000,0,0,800,800,0,0,30,30,0,0,2916,324,30,300,222,336
2020,511700331,39880,4780,4780,4780,0,35100,35000,35000,0,0,100,100,0,0,0,0,0,0,2480,380,300,200,400,189
2020,511800121,998,998,498,498,500,0,0,0,0,0,0,0,0,0,0,0,0,0,2188,600,100,180,108,5
2020,511800141,123000,2100,2100,2100,0,120900,120000,120000,0,0,900,900,0,0,7000,0,0,0,3450,250,60,150,360,225
2020,511800151,1340,1200,1200,1200,0,140,0,0,0,0,140,0,140,0,300,300,300,0,2080,120,60,120,120,0
2020,511800161,95240,1440,1440,1440,0,93800,93000,45000,48000,0,800,700,100,0,36500,0,0,0,3080,240,240,360,360,1625
2020,511800171,136920,64770,64770,64770,0,72150,70000,70000,0,0,2150,2150,0,0,0,0,0,0,6430,360,120,500,210,4154
2020,511800191,64420,2820,2820,2820,0,61600,60000,60000,0,0,1600,1600,0,0,4600,4600,4600,0,5180,360,120,360,240,1961
2020,511800201,42593,11050,11050,11050,0,31543,30500,27500,3000,0,1043,930,113,0,4392,4392,4392,0,3256,276,100,780,180,179
2020,511800221,136878,16778,16778,8778,0,120100,118000,56000,62000,0,2100,1700,400,0,11,11,0,0,3250,270,360,170,180,927
2020,511800231,57835,7135,7135,5135,0,50700,48000,48000,0,0,2700,2700,0,0,13000,13000,13000,0,3860,280,240,250,180,359
2020,511800241,160965,4665,4665,3665,0,156300,118000,68000,50000,0,38300,3300,20000,15000,71090,68090,65090,3000,9190,3250,50,240,450,551
2020,511800251,78070,270,270,270,0,77800,60000,60000,0,0,17800,800,2000,15000,10000,10000,10000,0,7960,1200,240,684,456,108
2020,511800271,23560,300,300,300,0,23260,23000,23000,0,0,260,180,80,0,0,0,0,0,970,120,70,80,40,41
2020,511800281,18650,400,400,400,0,18250,18000,18000,0,0,250,250,0,0,0,0,0,0,1783,180,240,180,102,18
2020,511800291,73930,45830,45830,45830,0,28100,25000,25000,0,0,3100,3100,0,0,1640,1640,0,1640,2780,300,20,96,180,1734
2020,511800311,88850,8250,8250,8250,0,80600,80000,0,80000,0,600,600,0,0,24000,0,0,0,2096,240,860,120,66,91
2020,511800331,104000,20000,20000,10000,0,84000,78000,78000,0,0,6000,3000,3000,0,0,0,0,0,5560,600,200,720,360,585
2020,511800341,44240,15940,15940,15940,0,28300,27000,27000,0,0,1300,1300,0,0,6840,6840,6710,100,4910,200,1000,250,360,982
2020,511800361,188380,165880,75880,45880,90000,22500,0,0,0,0,22500,1500,21000,0,0,0,0,0,6204,840,60,360,144,46188
2020,511800371,117500,500,500,500,0,117000,117000,67000,50000,0,0,0,0,0,4800,3000,3000,0,1390,400,70,50,70,241
2020,511900121,258500,104200,104200,104200,0,154300,152000,150000,2000,0,2300,2300,0,0,0,0,0,0,5880,1000,100,320,340,3390
2020,511900181,1005,1005,5,5,1000,0,0,0,0,0,0,0,0,0,0,0,0,0,1115,700,10,15,50,1
2020,511900191,81620,16620,16620,16620,0,65000,65000,65000,0,0,0,0,0,0,0,0,0,0,3360,240,250,300,200,1065
2020,511900201,113794,20794,794,794,20000,93000,90000,0,90000,0,3000,3000,0,0,80000,80000,80000,0,1870,260,250,400,150,206
2020,511900221,7850,7150,5150,5150,2000,700,0,0,0,0,700,700,0,0,90,90,0,0,3356,336,50,240,180,74
2020,511900231,11210,1210,1210,1210,0,10000,10000,10000,0,0,0,0,0,0,0,0,0,0,812,98,160,60,24,5
2020,511900251,28604,10704,10704,10704,0,17900,10000,10000,0,0,7900,900,0,7000,0,0,0,0,1980,120,60,600,60,17
2020,511900261,1005,1005,5,5,1000,0,0,0,0,0,0,0,0,0,0,0,0,0,510,70,50,30,30,0
2020,511900271,18214,2964,2964,2964,0,15250,15000,15000,0,0,250,250,0,0,7309,7309,7309,0,4935,230,355,1400,290,706
2020,511900281,108550,19600,4600,4600,15000,88950,80000,0,80000,0,8950,8500,450,0,57600,20600,15000,500,3610,360,240,440,120,431
2020,511900291,138550,88050,88050,88050,0,50500,49000,49000,0,0,1500,1500,0,0,21200,21200,21200,0,9500,500,1000,1000,500,6361
2020,511900301,17784,2184,2184,2184,0,15600,15000,15000,0,0,600,300,300,0,1620,1620,1600,0,2831,158,40,292,343,152
2020,511900331,159900,71000,1000,1000,70000,88900,87500,0,87500,0,1400,1400,0,0,56500,14000,14000,0,8450,500,300,1000,300,11431
2020,511900341,3800,3800,800,800,3000,0,0,0,0,0,0,0,0,0,0,0,0,0,2710,1720,50,100,50,87
2020,511900351,252904,97104,13104,13104,84000,155800,150000,0,150000,0,5800,2800,3000,0,87848,7848,7848,0,4860,600,120,360,180,1015
2020,511900361,148730,27530,27530,27530,0,121200,121000,106000,15000,0,200,200,0,0,15000,0,0,0,7420,360,240,600,120,1237
2020,511900371,215300,105300,52300,52300,53000,110000,110000,0,110000,0,0,0,0,0,35500,500,0,500,6480,840,120,240,480,326
2020,511900381,56900,5400,5400,5400,0,51500,50000,40000,10000,0,1500,1500,0,0,2500,1000,0,1000,3550,150,70,150,150,394
2020,511900391,63820,27520,4520,4520,23000,36300,36000,0,0,36000,300,300,0,0,12000,12000,12000,0,1700,240,300,190,60,53
2020,512000132,5450,5450,2950,2950,2500,0,0,0,0,0,0,0,0,0,0,0,0,0,1447,384,100,24,129,5
2020,512000142,1320,1320,20,20,1300,0,0,0,0,0,0,0,0,0,0,0,0,0,715,148,10,13,16,2
2020,512000162,32400,2200,2200,2200,0,30200,30000,30000,0,0,200,200,0,0,0,0,0,0,2480,590,10,120,120,34
2020,512000182,31584,1584,1584,1584,0,30000,30000,30000,0,0,0,0,0,0,0,0,0,0,978,200,300,7,15,52
2020,512000202,3525,3275,3275,3275,0,250,0,0,0,0,250,250,0,0,22540,22540,900,1600,1380,540,20,90,50,9
2020,512000212,53773,36640,36640,36640,0,17133,17000,15000,2000,0,133,0,133,0,0,0,0,0,2358,120,600,120,78,103
2020,512000232,15502,250,250,250,0,15252,15000,15000,0,0,252,230,22,0,5500,5500,5500,0,1092,120,120,180,72,52
2020,512000242,2440,2440,1940,1940,500,0,0,0,0,0,0,0,0,0,300,300,0,0,2252,570,250,220,162,2
2020,512000272,20680,1380,1380,1380,0,19300,16000,16000,0,0,3300,3300,0,0,5000,5000,5000,0,2620,300,360,240,120,351
2020,512000282,27010,2010,2010,2010,0,25000,25000,25000,0,0,0,0,0,0,0,0,0,0,1108,460,120,60,24,29
2020,512000322,29404,28904,2904,2904,26000,500,0,0,0,0,500,0,500,0,6000,6000,0,6000,3194,246,50,240,168,348
2020,512000342,70900,30450,3450,3450,27000,40450,40000,0,40000,0,450,450,0,0,42000,18000,17000,1000,3801,500,551,100,100,200
2020,512000372,22570,200,200,200,0,22370,22000,22000,0,0,370,370,0,0,940,940,0,940,1740,240,360,240,120,51
2020,512000392,14300,4500,4500,4500,0,9800,9800,9800,0,0,0,0,0,0,300,300,0,300,1920,180,60,60,120,104
2020,512600131,67207,39007,39007,38357,0,28200,28000,28000,0,0,200,0,200,0,0,0,0,0,4484,554,50,300,240,324
2020,512600151,98706,11366,11366,11366,0,87340,85000,85000,0,0,2340,2000,340,0,15000,15000,15000,0,3876,400,36,200,180,226
2020,512600161,30813,5373,5373,5373,0,25440,24000,24000,0,0,1440,1440,0,0,9560,9560,9460,0,4567,204,200,500,480,46
2020,512600171,23087,7087,7087,7087,0,16000,16000,16000,0,0,0,0,0,0,3650,3650,1600,50,2110,240,300,360,100,69
2020,512600181,15523,1223,1223,1223,0,14300,14300,14300,0,0,0,0,0,0,7625,7625,6825,200,2430,440,50,120,300,77
2020,512600191,55646,4246,4246,4246,0,51400,50000,50000,0,0,1400,1400,0,0,2000,2000,0,2000,6620,240,1000,500,180,562
2020,512600201,121900,200,200,200,0,121700,121000,31000,90000,0,700,500,200,0,8000,6000,6000,0,1851,260,10,84,120,181
2020,512600221,27830,1730,1730,1730,0,26100,26000,10000,16000,0,100,0,100,0,8000,0,0,0,1260,96,60,24,96,20
2020,512600231,50090,90,90,90,0,50000,50000,45000,5000,0,0,0,0,0,2000,0,0,0,1285,180,360,15,120,74
2020,512600241,13150,650,650,650,0,12500,12500,12500,0,0,0,0,0,0,0,0,0,0,1118,108,490,12,38,6
2020,512600251,250,250,210,210,40,0,0,0,0,0,0,0,0,0,0,0,0,0,568,108,0,12,18,0
2020,512600261,310,310,10,10,300,0,0,0,0,0,0,0,0,0,0,0,0,0,892,340,10,35,12,1
2020,512600271,3528,3528,2028,2028,1500,0,0,0,0,0,0,0,0,0,0,0,0,0,912,176,240,12,24,1
2020,512600281,37980,6980,6980,6980,0,31000,28000,28000,0,0,3000,3000,0,0,14600,14600,14000,600,5150,500,500,300,200,849
2020,512600301,107210,5710,5710,5710,0,101500,100000,100000,0,0,1500,1200,300,0,0,0,0,0,2560,480,300,300,120,328
2020,512600361,48600,7600,7600,7600,0,41000,40000,25000,15000,0,1000,1000,0,0,60,60,0,0,2111,400,20,300,96,200
2020,512600371,44357,3557,3557,3557,0,40800,39000,23000,16000,0,1800,1800,0,0,3380,1380,0,0,1698,240,96,180,132,97
2020,512600381,23020,20,20,20,0,23000,23000,23000,0,0,0,0,0,0,3000,3000,3000,0,1363,120,1000,23,30,9
2020,512600391,21684,16184,6184,6184,10000,5500,0,0,0,0,5500,5200,300,0,12090,12090,8400,0,3509,142,20,480,380,997
2020,512700101,31165,30865,14865,14865,16000,300,0,0,0,0,300,0,300,0,0,0,0,0,2850,360,400,120,240,1
2020,512700111,5,5,5,5,0,0,0,0,0,0,0,0,0,0,100,100,0,0,910,360,250,40,30,1
2020,512700121,81520,5520,5520,5520,0,76000,76000,76000,0,0,0,0,0,0,14660,14460,14460,0,2076,206,120,30,34,81
2020,512700141,38462,862,862,862,0,37600,30000,30000,0,0,7600,600,0,7000,7000,7000,6500,500,4480,1940,100,180,100,31
2020,512700171,151080,36080,36080,36080,0,115000,114000,85000,29000,0,1000,1000,0,0,1000,0,0,0,3330,480,500,200,100,522
2020,512700181,19330,1170,1170,170,0,18160,15000,15000,0,0,3160,40,2120,1000,0,0,0,0,1352,120,200,28,24,32
2020,512700191,28600,900,900,900,0,27700,27000,27000,0,0,700,700,0,0,14450,14450,14450,0,1080,130,10,120,180,30
2020,512700201,89600,25300,25300,25300,0,64300,64000,32000,32000,0,300,0,300,0,0,0,0,0,1695,150,5,15,45,86
2020,512700221,840,840,840,840,0,0,0,0,0,0,0,0,0,0,0,0,0,0,942,100,40,80,72,1
2020,512700241,25648,5948,5948,5948,0,19700,19000,19000,0,0,700,700,0,0,3496,3496,3416,0,2636,240,180,320,360,478
2020,512700271,15607,4057,4057,4057,0,11550,11000,10000,0,1000,550,500,50,0,3000,3000,3000,0,5090,180,50,600,240,402
2020,512700281,23790,760,760,460,0,23030,18000,16000,2000,0,5030,30,2000,3000,9500,9500,8900,600,1890,180,360,240,120,42
2020,512700301,9363,9363,4850,4850,4513,0,0,0,0,0,0,0,0,0,0,0,0,0,955,153,100,60,72,1
2020,512700311,33120,1620,1620,1620,0,31500,30000,30000,0,0,1500,1500,0,0,600,600,0,0,1712,98,20,100,240,91
2020,512700331,36892,11792,11792,11792,0,25100,25000,25000,0,0,100,100,0,0,0,0,0,0,1470,228,120,240,156,215
2020,512700341,70090,90,90,90,0,70000,70000,20000,50000,0,0,0,0,0,24500,4500,4500,0,892,228,240,20,24,25
2020,512700351,6692,6592,92,92,6500,100,0,0,0,0,100,100,0,0,6627,6627,6150,0,1000,120,50,120,100,1
2020,512700361,38600,100,100,100,0,38500,26000,26000,0,0,12500,3000,0,9500,22830,22830,17930,2000,2460,240,120,120,180,20
2020,512700371,165850,30050,30050,30050,0,135800,135000,45000,90000,0,800,800,0,0,2000,0,0,0,2420,300,1200,100,70,191
2020,512700381,1044,1044,44,44,1000,0,0,0,0,0,0,0,0,0,0,0,0,0,471,55,110,10,16,2
2020,512800101,67902,6482,6482,6482,0,61420,60000,60000,0,0,1420,1300,120,0,41300,30300,22900,2500,5280,180,120,360,180,141
2020,512800111,39855,1855,1855,1855,0,38000,38000,38000,0,0,0,0,0,0,1000,1000,1000,0,1826,180,100,60,36,74
2020,512800121,45528,7428,7428,7428,0,38100,38000,38000,0,0,100,100,0,0,0,0,0,0,2812,224,300,360,108,436
2020,512800151,87210,6960,6960,6960,0,80250,80000,70000,10000,0,250,250,0,0,500,0,0,0,1760,168,260,120,60,218
2020,512800161,84686,22186,22186,22186,0,62500,60000,60000,0,0,2500,2500,0,0,0,0,0,0,3054,300,40,436,238,716
2020,512800171,60620,370,370,370,0,60250,60000,60000,0,0,250,250,0,0,2250,2250,2250,0,2870,300,10,200,120,108
2020,512800201,2560,2530,2030,2030,500,30,0,0,0,0,30,0,30,0,0,0,0,0,645,84,68,10,22,2
2020,512800211,31431,5428,5428,5428,0,26003,25500,15000,0,10500,503,390,113,0,5900,5900,5500,300,3756,300,108,840,144,118
2020,512800221,90120,14120,14120,14120,0,76000,70000,10000,60000,0,6000,2000,4000,0,46520,22520,22520,0,3306,140,60,400,96,318
2020,512800261,3367,3333,3083,3083,250,34,0,0,0,0,34,0,34,0,0,0,0,0,2158,204,10,120,120,0
2020,512800291,5316,2226,2226,2226,0,3090,3000,0,3000,0,90,90,0,0,1600,1600,0,1600,1250,420,25,180,35,36
2020,512800321,87150,6600,6600,6600,0,80550,80000,40000,40000,0,550,300,250,0,0,0,0,0,3171,264,10,65,168,144
2020,512800331,54528,14302,14302,14302,0,40226,38000,38000,0,0,2226,2000,226,0,13270,13270,0,13270,4891,360,30,600,180,1290
2020,512800341,43950,41150,8150,8150,33000,2800,0,0,0,0,2800,2800,0,0,25275,25275,25000,200,4760,240,120,600,240,2785
2020,512800351,24600,100,100,100,0,24500,24500,24500,0,0,0,0,0,0,1000,1000,1000,0,1616,216,120,120,60,35
2020,512800361,27300,2300,2300,2300,0,25000,25000,25000,0,0,0,0,0,0,5480,5480,5480,0,1128,180,12,60,36,26
2020,512800371,7640,7640,1640,1640,6000,0,0,0,0,0,0,0,0,0,0,0,0,0,1110,120,50,80,120,39
2020,512800391,45346,6846,6846,6846,0,38500,38000,14000,24000,0,500,500,0,0,12500,12500,9000,3500,5700,192,100,250,240,541
2020,512900101,77370,3200,3200,3200,0,74170,65000,65000,0,0,9170,1000,170,8000,0,0,0,0,2452,312,134,600,120,191
2020,512900111,37350,14350,7350,7350,7000,23000,23000,0,23000,0,0,0,0,0,13500,0,0,0,940,120,50,50,30,31
2020,512900121,88040,15140,15140,15140,0,72900,68000,68000,0,0,4900,4900,0,0,21260,21260,20760,500,3770,240,50,240,240,165
2020,512900151,67294,1994,1994,1994,0,65300,65000,65000,0,0,300,0,300,0,0,0,0,0,2430,360,240,120,60,61
2020,512900161,441690,25700,25700,25700,0,415990,415000,65000,350000,0,990,990,0,0,100000,0,0,0,3080,360,120,240,120,1855
2020,512900181,11695,10995,2495,2495,8500,700,0,0,0,0,700,700,0,0,0,0,0,0,2009,182,3,300,156,59
2020,512900231,7180,2180,180,180,2000,5000,0,0,0,0,5000,5000,0,0,2450,2450,0,0,3504,282,40,480,181,78
2020,512900241,7267,267,267,267,0,7000,7000,7000,0,0,0,0,0,0,0,0,0,0,1123,102,394,76,84,5
2020,512900251,27420,2620,2620,2620,0,24800,23000,23000,0,0,1800,1800,0,0,16900,16900,15000,1900,2210,300,50,120,180,65
2020,512900261,10998,498,498,498,0,10500,10500,10500,0,0,0,0,0,0,950,950,950,0,665,96,60,48,36,6
2020,512900301,150340,31840,31840,30340,0,118500,117000,50000,67000,0,1500,1500,0,0,48000,0,0,0,4080,240,20,480,240,211
2020,512900311,45001,4521,4521,4521,0,40480,40000,40000,0,0,480,220,260,0,13401,3401,3401,0,3380,350,140,380,190,647
2020,512900321,45992,44072,14072,14072,30000,1920,1750,0,1750,0,170,170,0,0,20000,20000,20000,0,2620,280,20,200,200,122
2020,512900331,64620,7620,7620,7620,0,57000,56000,42000,14000,0,1000,1000,0,0,15550,4550,4000,500,1712,240,80,480,196,291
2020,512900341,18300,17200,1200,1200,16000,1100,0,0,0,0,1100,1100,0,0,0,0,0,0,4000,280,10,420,120,34
2020,512900351,48622,7522,7522,7522,0,41100,38000,38000,0,0,3100,3000,100,0,14200,14200,14200,0,3600,220,20,600,300,87
2020,512900371,6200,6200,200,200,6000,0,0,0,0,0,0,0,0,0,0,0,0,0,890,120,200,30,130,1
2020,512900381,1200,1200,200,200,1000,0,0,0,0,0,0,0,0,0,900,900,0,900,1980,470,10,60,120,26
2020,512900391,87436,25556,25556,25556,0,61880,60000,60000,0,0,1880,1880,0,0,0,0,0,0,5350,300,200,500,150,1305
2020,513000102,41640,11640,11640,11640,0,30000,30000,30000,0,0,0,0,0,0,0,0,0,0,1230,120,120,30,30,39
2020,513000112,52133,9429,9429,8429,0,42704,40000,0,40000,0,2704,1800,904,0,22500,2500,2500,0,3140,240,100,120,120,44
2020,513000122,31402,31402,2402,2402,29000,0,0,0,0,0,0,0,0,0,0,0,0,0,1780,120,60,260,144,13
2020,513000132,41512,8512,8512,8512,0,33000,30000,30000,0,0,3000,3000,0,0,5000,5000,5000,0,5060,240,1400,100,100,91
2020,513000142,34802,402,402,402,0,34400,34000,34000,0,0,400,400,0,0,11000,11000,9000,2000,1820,200,50,50,100,67
2020,513000152,15800,800,800,800,0,15000,15000,15000,0,0,0,0,0,0,5750,5750,5700,0,1980,150,270,120,90,46
2020,513000162,21528,6428,6428,5928,0,15100,15000,15000,0,0,100,0,100,0,4030,4030,3000,0,4950,150,800,550,450,32
2020,513000172,96050,50,50,50,0,96000,96000,70000,26000,0,0,0,0,0,2000,0,0,0,2555,400,600,10,132,265
2020,513000182,60170,70,70,70,0,60100,60000,60000,0,0,100,100,0,0,2500,2500,2500,0,1180,240,70,260,80,85
2020,513000222,61110,10110,10110,9110,0,51000,40000,30000,10000,0,11000,1600,9400,0,20500,20500,14500,6000,3813,360,60,425,288,356
2020,513000242,1360,360,260,260,100,1000,0,0,0,0,1000,1000,0,0,0,0,0,0,2048,516,5,242,144,50
2020,513000262,30914,7414,7414,7414,0,23500,22000,22000,0,0,1500,1500,0,0,2150,2150,2000,0,4014,264,60,50,180,2615
2020,513000302,8860,800,800,800,0,8060,7000,7000,0,0,1060,1060,0,0,0,0,0,0,1506,188,300,252,146,28
2020,513000312,35880,450,450,450,0,35430,35000,20000,15000,0,430,430,0,0,14300,9300,9300,0,952,170,30,120,72,88
2020,513000322,6200,6200,200,200,6000,0,0,0,0,0,0,0,0,0,0,0,0,0,413,78,120,0,18,1
2020,513000332,2006,2006,6,6,2000,0,0,0,0,0,0,0,0,0,0,0,0,0,1570,100,20,36,18,16
2020,513000342,3005,2005,5,5,2000,1000,0,0,0,0,1000,1000,0,0,2815,2815,0,2815,1980,720,300,700,50,67
2020,513000352,99470,17070,17070,17070,0,82400,68000,18000,50000,0,14400,4400,10000,0,1500,1500,0,0,1200,240,10,60,300,183
2020,513000362,21570,370,370,370,0,21200,19000,18000,1000,0,2200,2200,0,0,12700,12700,12000,0,1704,260,36,360,168,189
2020,513000382,23200,200,200,200,0,23000,23000,23000,0,0,0,0,0,0,0,0,0,0,450,240,100,0,20,13
2020,513000392,9070,8820,320,320,8500,250,0,0,0,0,250,250,0,0,5500,5500,5500,0,2310,180,28,50,300,31
2020,513600101,69036,9736,9736,4936,0,59300,52000,45000,7000,0,7300,2300,0,5000,7840,7840,6640,0,3700,240,360,1200,180,65
2020,513600131,418,418,418,418,0,0,0,0,0,0,0,0,0,0,0,0,0,0,505,25,0,0,40,1
2020,513600151,159200,15750,15750,15750,0,143450,142000,67000,75000,0,1450,770,680,0,1800,0,0,0,1482,200,30,120,72,262
2020,513600171,7200,7200,1200,1200,6000,0,0,0,0,0,0,0,0,0,0,0,0,0,797,120,10,18,72,1
2020,513600201,38200,19000,19000,19000,0,19200,19000,19000,0,0,200,200,0,0,1106,1106,1106,0,3496,192,100,600,264,211
2020,513600211,84490,6290,6290,6290,0,78200,70000,50000,20000,0,8200,2000,200,6000,13000,0,0,0,3658,1192,120,150,216,77
2020,513600231,322,276,76,76,200,46,0,0,0,0,46,0,46,0,0,0,0,0,602,118,10,70,28,0
2020,513600251,26635,540,540,540,0,26095,26000,26000,0,0,95,0,95,0,8350,8350,8350,0,2060,270,800,60,60,35
2020,513600261,50740,1590,1590,1590,0,49150,49000,49000,0,0,150,0,150,0,12000,12000,12000,0,1403,107,42,240,84,41
2020,513600321,126838,6538,6538,6538,0,120300,117000,51000,66000,0,3300,3300,0,0,42089,36089,35756,0,7200,560,100,400,140,1654
2020,513600361,20000,950,950,450,0,19050,18000,18000,0,0,1050,850,200,0,2300,2300,0,2000,3550,300,50,450,250,324
2020,513600371,30100,100,100,100,0,30000,30000,30000,0,0,0,0,0,0,0,0,0,0,744,120,72,22,0,14
2020,513600381,53860,6910,6910,6910,0,46950,46000,16000,30000,0,950,950,0,0,0,0,0,0,2410,250,100,500,250,118
2020,513600391,13732,13732,4732,4732,9000,0,0,0,0,0,0,0,0,0,0,0,0,0,2190,480,50,190,180,2
2020,513700111,152780,30480,30480,25480,0,122300,120000,80000,40000,0,2300,2300,0,0,6500,500,0,0,3120,360,120,360,180,241
2020,513700121,123047,12147,12147,12147,0,110900,110000,80000,30000,0,900,900,0,0,17370,16370,13820,0,3954,360,400,600,144,524
2020,513700131,37810,37110,4710,4710,32400,700,0,0,0,0,700,700,0,0,18700,18700,18700,0,5180,300,200,360,170,56
2020,513700181,2108,2108,1608,1608,500,0,0,0,0,0,0,0,0,0,0,0,0,0,1090,440,25,65,60,1
2020,513700191,385634,24834,4834,4834,20000,360800,360000,0,360000,0,800,800,0,0,180500,110500,108000,2500,6510,2000,50,300,180,2297
2020,513700211,25020,20,20,20,0,25000,25000,25000,0,0,0,0,0,0,0,0,0,0,651,120,120,10,11,21
2020,513700221,30830,430,430,430,0,30400,30000,30000,0,0,400,400,0,0,0,0,0,0,2630,240,100,300,120,420
2020,513700231,24290,4290,4290,3790,0,20000,20000,20000,0,0,0,0,0,0,0,0,0,0,1954,1268,96,120,50,58
2020,513700241,23988,3988,3988,3988,0,20000,20000,20000,0,0,0,0,0,0,4300,4300,1300,0,2062,820,100,60,72,19
2020,513700311,28399,9549,9549,9549,0,18850,18500,18500,0,0,350,350,0,0,12728,12728,7878,3900,4026,350,190,580,252,966
2020,513700331,10604,6604,4604,1604,2000,4000,0,0,0,0,4000,2000,1000,1000,1320,1320,0,0,2400,800,0,400,340,59
2020,513700341,8450,1400,1400,1400,0,7050,6500,6500,0,0,550,550,0,0,0,0,0,0,1310,350,250,120,100,30
2020,513700371,54919,12169,12169,7669,0,42750,31300,31300,0,0,11450,3050,8400,0,29348,29348,20664,1,4037,300,289,352,468,102
2020,513700381,2050,2050,1690,1690,360,0,0,0,0,0,0,0,0,0,0,0,0,0,1296,84,240,48,24,0
2020,513800111,4554,4554,4054,4054,500,0,0,0,0,0,0,0,0,0,0,0,0,0,830,432,12,8,18,1
2020,513800121,3220,3220,20,20,3200,0,0,0,0,0,0,0,0,0,0,0,0,0,330,120,12,3,15,1
2020,513800131,7795,7195,4395,4395,2800,600,0,0,0,0,600,600,0,0,0,0,0,0,2336,150,360,480,96,290
2020,513800141,58995,845,845,845,0,58150,58000,58000,0,0,150,150,0,0,19470,19470,17170,2000,2124,350,300,204,240,180
2020,513800161,65120,5120,5120,5120,0,60000,60000,40000,20000,0,0,0,0,0,2030,30,0,0,1810,240,50,60,60,130
2020,513800191,23550,550,550,550,0,23000,23000,23000,0,0,0,0,0,0,0,0,0,0,998,150,80,1,37,24
2020,513800201,12050,50,50,50,0,12000,12000,12000,0,0,0,0,0,0,0,0,0,0,741,52,80,60,26,9
2020,513800241,32644,16344,16344,16344,0,16300,16000,16000,0,0,300,300,0,0,300,300,0,0,5243,360,50,560,244,356
2020,513800251,26128,9828,9828,9828,0,16300,16000,16000,0,0,300,300,0,0,3000,3000,0,3000,2852,250,500,300,204,30
2020,513800321,29932,13594,13594,13594,0,16338,15000,6000,9000,0,1338,1000,338,0,5020,520,0,520,2329,300,27,200,216,199
2020,513800331,13324,3624,2624,2624,1000,9700,0,0,0,0,9700,9700,0,0,0,0,0,0,3180,750,100,500,480,59
2020,513800341,20310,2010,2010,2010,0,18300,16500,16500,0,0,1800,1800,0,0,5000,5000,5000,0,1450,210,250,60,120,78
2020,513800351,45295,10969,10969,10969,0,34326,32600,31500,0,1100,1726,1500,226,0,1600,1600,1300,0,5128,429,60,500,253,829
2020,513800371,94784,30584,30584,30584,0,64200,59000,41000,18000,0,5200,5200,0,0,0,0,0,0,2680,300,60,240,300,1940
2020,513800381,11672,9420,3620,3620,5800,2252,0,0,0,0,2252,1800,452,0,800,800,800,0,3262,252,40,130,120,23
2020,513800391,10003,9422,5722,5722,3700,581,0,0,0,0,581,400,181,0,2030,2030,2000,0,5034,540,30,180,420,294
2020,513900101,23150,50,50,50,0,23100,23000,23000,0,0,100,100,0,0,10660,10660,9360,0,1875,250,60,250,280,59
2020,513900111,28250,3250,3250,3250,0,25000,25000,25000,0,0,0,0,0,0,0,0,0,0,934,180,200,30,24,60
2020,513900121,41960,3960,3960,3960,0,38000,38000,38000,0,0,0,0,0,0,0,0,0,0,1268,200,200,20,48,22
2020,513900131,30300,1300,1300,1300,0,29000,29000,29000,0,0,0,0,0,0,0,0,0,0,1290,200,150,60,70,303
2020,513900161,55700,5700,5700,5700,0,50000,50000,30000,20000,0,0,0,0,0,15000,0,0,0,1610,150,300,72,84,139
2020,513900181,17020,17020,2020,2020,15000,0,0,0,0,0,0,0,0,0,0,0,0,0,1912,180,80,72,180,62
2020,513900201,5170,5170,2070,2070,3100,0,0,0,0,0,0,0,0,0,0,0,0,0,734,240,20,60,48,24
2020,513900211,111576,24300,24300,24300,0,87276,85000,85000,0,0,2276,2050,226,0,0,0,0,0,3148,430,25,276,180,1641
2020,513900231,75590,4110,4110,3810,0,71480,43000,43000,0,0,28480,28000,0,480,12400,12400,11400,0,5264,324,300,780,320,361
2020,513900261,30318,3038,3038,3038,0,27280,27000,27000,0,0,280,280,0,0,11258,11258,11258,0,3045,250,100,340,225,205
2020,513900331,43,43,43,43,0,0,0,0,0,0,0,0,0,0,0,0,0,0,780,168,70,10,36,1
2020,513900361,42100,8325,8325,7825,0,33775,30000,30000,0,0,3775,3775,0,0,5742,5742,5742,0,4770,300,150,480,240,487
2020,513900381,11003,5668,2668,2068,3000,5335,3000,0,3000,0,2335,2300,35,0,5770,5770,4000,0,3983,600,10,240,336,35
2020,514000122,102775,10875,10875,10875,0,91900,90000,90000,0,0,1900,1900,0,0,200,200,0,0,3830,300,250,500,80,366
2020,514000132,29800,29800,4800,4800,25000,0,0,0,0,0,0,0,0,0,24050,24050,24000,0,3100,150,100,200,150,394
2020,514000142,128285,5285,5285,5285,0,123000,120000,120000,0,0,3000,3000,0,0,26800,26800,24800,2000,6000,700,200,200,350,1934
2020,514000152,112740,1740,1740,1740,0,111000,110000,110000,0,0,1000,1000,0,0,22680,22680,22500,0,4380,900,200,150,300,836
2020,514000162,1335,1335,835,835,500,0,0,0,0,0,0,0,0,0,100,100,0,0,1371,600,120,24,72,59
2020,514000192,10500,2000,1000,1000,1000,8500,8500,0,8500,0,0,0,0,0,8500,0,0,0,1930,564,450,12,126,4
2020,514000302,570,570,70,70,500,0,0,0,0,0,0,0,0,0,16300,16300,0,8300,2989,720,200,360,132,52
2020,514000332,19380,18080,8080,8080,10000,1300,0,0,0,0,1300,1300,0,0,2400,2400,0,400,2679,660,40,360,108,31
2020,514000342,7360,7360,7360,7360,0,0,0,0,0,0,0,0,0,0,4000,4000,0,3400,2040,240,240,240,120,1
2020,514000352,43506,22506,4506,4506,18000,21000,21000,0,21000,0,0,0,0,0,3000,3000,3000,0,2328,363,122,84,432,102
2020,514000362,81679,13970,13970,6470,0,67709,66500,28000,38500,0,1209,1209,0,0,9500,7000,7000,0,4710,1770,30,480,480,297
2020,514000372,30560,17260,3260,3260,14000,13300,12000,0,0,12000,1300,1300,0,0,30,30,0,0,7200,1500,120,180,264,348
2020,514000382,82686,9186,9186,8186,0,73500,72000,60000,12000,0,1500,1500,0,0,4500,1500,1500,0,3110,200,30,60,120,79
2020,514000392,75210,7510,7510,7510,0,67700,66500,31500,35000,0,1200,1200,0,0,6358,3858,3858,0,2203,275,72,361,75,124
2020,514600101,182600,15800,15800,15800,0,166800,165000,85000,80000,0,1800,1800,0,0,8000,0,0,0,2450,450,50,60,100,276
2020,514600111,67210,9710,9710,9710,0,57500,57000,57000,0,0,500,500,0,0,20000,20000,20000,0,3220,250,70,380,120,2025
2020,514600121,129900,3800,3800,800,0,126100,125000,77000,48000,0,1100,0,1100,0,13000,0,0,0,3070,260,900,250,150,287
2020,514600141,3200,3200,200,200,3000,0,0,0,0,0,0,0,0,0,0,0,0,0,1518,510,180,60,48,676
2020,514600151,860,580,280,280,300,280,0,0,0,0,280,280,0,0,0,0,0,0,1336,132,120,120,180,304
2020,514600161,75654,4454,4454,4454,0,71200,70000,70000,0,0,1200,1200,0,0,11300,11300,11300,0,3446,246,80,120,120,155
2020,514600171,88980,14480,14480,14480,0,74500,70000,70000,0,0,4500,4500,0,0,23000,23000,23000,0,1994,360,200,70,180,711
2020,514600181,130,130,130,130,0,0,0,0,0,0,0,0,0,0,0,0,0,0,586,100,150,20,16,1
2020,514600331,43786,5286,5286,5286,0,38500,34000,22000,10000,2000,4500,4500,0,0,6900,6500,0,3800,2694,300,84,480,240,137
2020,514600351,5697,5697,5397,5397,300,0,0,0,0,0,0,0,0,0,0,0,0,0,2860,550,70,80,300,56
2020,514600361,148500,1000,1000,1000,0,147500,147000,45000,102000,0,500,200,300,0,75800,72800,72800,0,5725,600,200,400,350,124
2020,514600371,125190,2190,2190,2190,0,123000,123000,42000,81000,0,0,0,0,0,55000,0,0,0,1088,348,36,72,102,212
2020,514600381,43595,1195,1195,1195,0,42400,42000,42000,0,0,400,400,0,0,14176,14176,14176,0,1764,300,480,180,96,61
2020,514700111,278,278,278,278,0,0,0,0,0,0,0,0,0,0,38,38,0,0,1920,530,70,100,70,5
2020,514700151,37850,35850,4850,4850,31000,2000,0,0,0,0,2000,2000,0,0,15000,15000,15000,0,2990,240,60,240,240,320
2020,514700161,9565,8565,4565,3065,4000,1000,0,0,0,0,1000,1000,0,0,10,10,0,0,2222,240,10,180,222,45
2020,514700191,18778,15698,15698,15698,0,3080,2500,0,2500,0,580,580,0,0,0,0,0,0,2698,120,230,192,156,368
2020,514700341,46423,22283,1283,1283,21000,24140,24000,0,24000,0,140,140,0,0,13100,13100,12800,300,3809,276,83,187,185,103
2020,514700351,50304,154,154,154,0,50150,50000,0,50000,0,150,150,0,0,580,580,0,500,1345,348,61,65,60,75
2020,514700361,49990,12600,12600,12600,0,37390,37000,37000,0,0,390,390,0,0,11797,11797,9977,1700,2430,300,120,120,180,357
2020,514700381,29000,700,700,700,0,28300,28000,28000,0,0,300,300,0,0,18400,18400,15400,0,3770,300,50,300,120,281
2020,514700391,11020,720,720,720,0,10300,10000,10000,0,0,300,300,0,0,0,0,0,0,4800,288,10,450,264,109
2020,514800111,274928,4928,4928,4928,0,270000,270000,70000,200000,0,0,0,0,0,97900,14900,14500,0,1546,200,150,60,96,206
2020,514800191,71100,1700,1200,1200,500,69400,68000,0,68000,0,1400,1400,0,0,280,280,0,0,2260,800,10,350,100,503
2020,514800301,42090,6970,6970,6970,0,35120,31540,31000,540,0,3580,2450,1130,0,7886,7886,7116,70,4756,228,100,480,264,818
2020,514800321,212650,550,550,550,0,212100,210000,0,210000,0,2100,2100,0,0,55000,0,0,0,2265,360,300,120,360,138
2020,514800341,65300,4110,4110,4110,0,61190,47000,22000,25000,0,14190,4690,0,9500,19540,40,0,0,3122,264,120,336,132,375
2020,514800351,220426,29426,29426,14426,0,191000,175000,60000,115000,0,16000,0,6000,10000,51000,46000,46000,0,5280,480,120,480,240,305
2020,514800371,26720,586,586,586,0,26134,25938,25000,938,0,196,0,196,0,17829,17829,16779,1000,1723,258,5,296,96,67
2020,514900101,10275,10275,1275,1275,9000,0,0,0,0,0,0,0,0,0,32,32,0,0,1160,240,10,240,120,4
2020,514900111,9560,8760,3760,3760,5000,800,0,0,0,0,800,800,0,0,5032,5032,532,0,2928,300,1400,264,144,13
2020,514900131,110620,13220,13220,13220,0,97400,97000,85000,12000,0,400,400,0,0,10000,10000,10000,0,2270,360,50,300,100,355
2020,514900141,77500,12700,12700,12700,0,64800,62000,62000,0,0,2800,2800,0,0,25000,10000,10000,0,2996,1160,120,120,240,87
2020,514900151,25650,1350,1350,1350,0,24300,23000,23000,0,0,1300,1300,0,0,21200,21200,12700,8500,1998,180,30,180,108,213
2020,514900191,37380,7380,7380,5180,0,30000,30000,24000,5000,1000,0,0,0,0,500,0,0,0,1052,158,200,80,94,135
2020,514900301,75978,6778,6778,5778,0,69200,61000,40000,21000,0,8200,7700,500,0,4000,0,0,0,3453,423,58,361,182,290
2020,514900321,3994,3864,2364,1864,1500,130,0,0,0,0,130,130,0,0,5800,5800,800,3000,7052,1021,128,604,488,198
2020,514900331,82754,12754,9754,9754,3000,70000,70000,0,70000,0,0,0,0,0,62200,51700,41200,3500,6020,1208,118,317,387,145
2020,514900341,5847,5847,347,347,5500,0,0,0,0,0,0,0,0,0,0,0,0,0,890,305,60,24,29,1
2020,514900351,123300,3100,3100,3100,0,120200,120000,40000,80000,0,200,0,200,0,3000,0,0,0,1161,180,200,36,55,642
2020,514900381,87468,35668,16668,16668,19000,51800,50000,0,50000,0,1800,1800,0,0,3550,1550,0,0,1908,360,120,240,168,1615
2020,514900391,26118,24518,5518,5518,19000,1600,0,0,0,0,1600,1600,0,0,6000,6000,0,6000,2290,360,50,300,60,504
2020,515000122,88689,10789,10789,10789,0,77900,77500,40000,37500,0,400,400,0,0,33750,12500,9500,3000,3640,360,300,840,240,1184
2020,515000152,205,205,5,5,200,0,0,0,0,0,0,0,0,0,0,0,0,0,918,138,100,24,36,1
2020,515000192,16502,3202,3202,3202,0,13300,13000,10000,3000,0,300,300,0,0,3880,3880,1400,2300,3426,364,656,420,350,529
2020,515000312,18160,15860,3860,3860,12000,2300,0,0,0,0,2300,2300,0,0,7000,7000,7000,0,1634,204,30,480,180,149
2020,515000322,2144,2144,144,144,2000,0,0,0,0,0,0,0,0,0,7000,7000,0,7000,1724,480,180,240,444,11
2020,515000332,23500,23500,1500,1500,22000,0,0,0,0,0,0,0,0,0,0,0,0,0,1320,276,180,180,72,1
2020,515000342,32696,3996,3996,3996,0,28700,28000,28000,0,0,700,500,200,0,6600,6600,5800,800,3896,276,120,60,120,103
2020,515000352,21437,1337,1337,1337,0,20100,19500,14500,0,5000,600,600,0,0,500,500,500,0,2306,268,60,370,168,165
2020,515000392,2387,2387,687,687,1700,0,0,0,0,0,0,0,0,0,0,0,0,0,387,150,10,12,22,1
2020,515600121,112000,5000,5000,5000,0,107000,107000,62000,45000,0,0,0,0,0,0,0,0,0,1012,192,40,36,24,58
2020,515600181,5108,3008,1008,1008,2000,2100,0,0,0,0,2100,2100,0,0,3542,3542,1800,0,1783,333,36,180,144,39
2020,515600191,22050,21250,1350,1350,19900,800,0,0,0,0,800,800,0,0,16300,16300,14600,1700,2266,120,200,60,180,34
2020,515600321,22268,3226,3226,3226,0,19042,17000,17000,0,0,2042,1929,113,0,8313,8313,6920,700,3339,200,200,170,360,69
2020,515600341,7760,7560,60,60,7500,200,0,0,0,0,200,200,0,0,3983,3983,0,2783,2832,480,72,300,192,46
2020,515600351,590,590,90,90,500,0,0,0,0,0,0,0,0,0,6890,6890,0,6890,5247,564,270,720,336,481
2020,515600361,9548,548,548,548,0,9000,9000,9000,0,0,0,0,0,0,35,35,0,0,768,72,60,60,36,10
2020,515600381,41411,7321,7321,7321,0,34090,34000,34000,0,0,90,0,90,0,4000,4000,4000,0,2834,240,40,324,156,132
2020,515700101,5672,5222,2222,2222,3000,450,0,0,0,0,450,450,0,0,2025,2025,2000,0,2050,120,50,100,200,54
2020,515700111,9100,9100,100,100,9000,0,0,0,0,0,0,0,0,0,9000,9000,9000,0,499,264,12,24,24,1
2020,515700121,37114,35614,7114,6414,28500,1500,0,0,0,0,1500,1500,0,0,14616,14616,8500,6000,4232,240,300,550,192,331
2020,515700141,43789,3489,3489,3489,0,40300,40000,40000,0,0,300,300,0,0,2020,2020,2000,0,3000,360,44,360,240,216
2020,515700151,4970,4070,4070,1070,0,900,0,0,0,0,900,900,0,0,1000,1000,0,0,4554,360,240,600,216,51
2020,515700181,593000,373000,373000,373000,0,220000,220000,220000,0,0,0,0,0,0,0,0,0,0,9730,600,100,100,80,4561
2020,515700191,1131,1131,131,131,1000,0,0,0,0,0,0,0,0,0,0,0,0,0,441,72,100,10,24,1
2020,515700301,85,85,85,85,0,0,0,0,0,0,0,0,0,0,0,0,0,0,527,62,85,8,20,1
2020,515700311,30,30,30,30,0,0,0,0,0,0,0,0,0,0,14516,14516,0,14516,586,60,12,12,12,1
2020,515700331,156690,15990,15990,15990,0,140700,140000,68000,72000,0,700,700,0,0,69180,21180,21180,0,3192,600,30,350,280,355
2020,515700341,113104,8604,8604,8604,0,104500,100000,30000,70000,0,4500,3500,1000,0,42000,0,0,0,1930,240,50,120,200,131
2020,515700361,33252,5000,2000,2000,3000,28252,26000,0,26000,0,2252,252,2000,0,0,0,0,0,1062,100,72,180,120,118
2020,515700381,69377,4677,3677,2177,1000,64700,60000,0,60000,0,4700,3500,0,1200,40375,5375,0,5375,5210,1000,10,500,300,138
2020,515800101,69744,244,244,244,0,69500,68000,68000,0,0,1500,1500,0,0,4260,4260,0,4100,3010,240,260,180,480,131
2020,515800121,14370,13920,8920,6920,5000,450,0,0,0,0,450,250,200,0,2000,2000,0,1000,2860,900,120,180,180,127
2020,515800151,99580,680,680,680,0,98900,98000,98000,0,0,900,900,0,0,2000,0,0,0,1645,240,40,380,180,209
2020,515800161,22220,2920,2920,2920,0,19300,18000,18000,0,0,1300,1200,100,0,10080,10080,10000,0,2161,120,10,120,240,40
2020,515800191,193700,3500,3500,3500,0,190200,190000,150000,40000,0,200,200,0,0,2000,0,0,0,978,360,10,20,48,309
2020,515800301,78050,2250,2250,2250,0,75800,75000,75000,0,0,800,800,0,0,0,0,0,0,7460,480,800,500,360,1607
2020,515800311,251140,2240,2240,2240,0,248900,248000,68000,180000,0,900,900,0,0,0,0,0,0,1988,360,96,132,140,837
2020,515800321,163030,11530,11530,11530,0,151500,148000,68000,80000,0,3500,3000,500,0,60600,55600,55600,0,4600,540,120,720,250,2172
2020,515800331,38224,34772,12772,12772,22000,3452,0,0,0,0,3452,3000,452,0,0,0,0,0,4831,390,10,540,240,662
2020,515800341,26104,18104,4104,4104,14000,8000,6000,0,0,6000,2000,2000,0,0,16300,16300,9000,7300,3940,240,200,400,300,477
2020,515800361,200,200,100,100,100,0,0,0,0,0,0,0,0,0,0,0,0,0,1053,300,70,60,60,1
2020,515800371,2212,2212,712,712,1500,0,0,0,0,0,0,0,0,0,0,0,0,0,442,234,36,15,27,1
2020,515900111,40550,350,350,350,0,40200,40000,40000,0,0,200,200,0,0,0,0,0,0,1829,118,46,260,95,63
2020,515900131,4710,4710,1210,1210,3500,0,0,0,0,0,0,0,0,0,0,0,0,0,700,132,100,18,60,8
2020,515900151,3930,3930,230,230,3700,0,0,0,0,0,0,0,0,0,3000,3000,3000,0,687,288,12,12,0,1
2020,515900161,10610,10310,1110,1110,9200,300,0,0,0,0,300,300,0,0,8000,8000,6000,2000,1116,120,48,360,108,31
2020,515900181,28490,26490,5490,5490,21000,2000,0,0,0,0,2000,2000,0,0,10000,10000,10000,0,2219,237,30,204,120,50
2020,515900191,6030,6030,30,30,6000,0,0,0,0,0,0,0,0,0,0,0,0,0,995,120,620,23,16,1
2020,515900301,14900,2020,2020,2020,0,12880,12000,4500,7500,0,880,880,0,0,900,400,400,0,2270,120,360,180,120,84
2020,515900311,22248,21068,1068,1068,20000,1180,0,0,0,0,1180,1100,80,0,6000,6000,6000,0,2440,330,350,200,360,33
2020,515900341,43462,1526,1526,1526,0,41936,41800,0,41800,0,136,0,136,0,10730,230,0,0,1012,370,200,50,32,78
2020,515900351,42036,3536,3536,3536,0,38500,38000,33000,5000,0,500,100,400,0,500,0,0,0,1471,216,150,220,87,76
2020,515900361,20710,420,420,420,0,20290,20000,20000,0,0,290,280,10,0,425,425,425,0,807,144,20,72,48,25
2020,515900371,23979,6479,6479,6479,0,17500,17000,17000,0,0,500,500,0,0,0,0,0,0,2880,150,270,180,100,47
2020,515900381,10230,10230,230,230,10000,0,0,0,0,0,0,0,0,0,10400,10400,0,10400,2400,180,50,700,200,5
2020,515900391,2650,2650,1650,1650,1000,0,0,0,0,0,0,0,0,0,0,0,0,0,2000,600,150,10,50,1
2020,516000102,250,250,100,100,150,0,0,0,0,0,0,0,0,0,950,950,950,0,2131,348,300,204,120,3
2020,516000112,5001,5001,1,1,5000,0,0,0,0,0,0,0,0,0,4914,4914,4000,734,2448,144,10,60,264,17
2020,516000122,1150,1150,1150,1150,0,0,0,0,0,0,0,0,0,0,0,0,0,0,614,180,130,20,44,10
2020,516000142,32868,4668,4668,4668,0,28200,28000,28000,0,0,200,200,0,0,254,254,100,110,1857,110,2,156,88,281
2020,516000152,68600,200,200,200,0,68400,68400,60000,8400,0,0,0,0,0,500,0,0,0,320,60,50,0,30,158
2020,516000182,2000,100,100,100,0,1900,0,0,0,0,1900,1900,0,0,300,300,0,0,1864,96,670,120,108,56
2020,516000332,21962,19312,2312,2312,17000,2650,0,0,0,0,2650,2500,150,0,3500,3500,3500,0,2698,300,10,120,250,51
2020,516000342,187106,58115,58115,58115,0,128991,127800,56000,71800,0,1191,1191,0,0,9720,20,0,0,3775,240,135,500,250,1879
2020,516000382,724615,154180,154180,154180,0,570435,535000,75000,460000,0,35435,5435,30000,0,110000,0,0,0,13880,540,240,500,300,8766
2020,516000392,37568,28778,28778,25778,0,8790,6940,6940,0,0,1850,1850,0,0,5456,5456,0,5456,7548,580,565,799,432,403
2020,516600131,18453,950,950,950,0,17503,17000,0,17000,0,503,390,113,0,7970,7970,7850,0,2540,360,120,168,240,706
2020,516600171,63940,53890,18890,18890,35000,10050,10000,0,10000,0,50,50,0,0,9000,9000,9000,0,5010,360,50,240,240,515
2020,516600181,52050,250,250,250,0,51800,50000,50000,0,0,1800,1800,0,0,0,0,0,0,2860,240,20,240,120,229
2020,516600301,109999,106009,66009,66009,40000,3990,990,0,990,0,3000,2000,1000,0,0,0,0,0,6465,1200,1000,500,180,5793
2020,516600311,6546,5746,2546,2546,3200,800,0,0,0,0,800,800,0,0,7250,7250,0,7200,1552,420,40,30,192,26
2020,516600351,67675,6575,6575,5075,0,61100,57000,40000,17000,0,4100,2100,0,2000,27600,27600,26200,1000,8512,480,1560,840,372,2079
2020,516600381,21180,21180,8180,8180,13000,0,0,0,0,0,0,0,0,0,0,0,0,0,3494,384,10,120,180,84
2020,516600391,4672,3672,3672,3672,0,1000,0,0,0,0,1000,0,1000,0,1000,1000,0,1000,2400,156,20,240,84,8
2020,516700101,12980,4280,780,780,3500,8700,0,0,0,0,8700,1700,0,7000,0,0,0,0,1171,120,150,300,96,54
2020,516700111,7491,7290,2090,2090,5200,201,0,0,0,0,201,0,201,0,36,36,0,0,1088,120,250,96,72,6
2020,516700121,19089,18789,5789,5789,13000,300,0,0,0,0,300,300,0,0,6610,6610,0,590,5126,156,400,700,240,56
2020,516700131,36740,140,140,140,0,36600,35300,32000,3300,0,1300,1300,0,0,0,0,0,0,946,160,36,120,120,143
2020,516700141,11350,11350,3350,3350,8000,0,0,0,0,0,0,0,0,0,3000,3000,0,3000,2500,480,200,100,180,187
2020,516700151,8000,8000,1000,1000,7000,0,0,0,0,0,0,0,0,0,0,0,0,0,1469,216,180,96,41,33
2020,516700161,5160,4760,4760,4760,0,400,0,0,0,0,400,400,0,0,0,0,0,0,970,130,10,200,150,72
2020,516700171,1050,1050,50,50,1000,0,0,0,0,0,0,0,0,0,0,0,0,0,1115,636,120,24,15,1
2020,516700181,100,100,100,100,0,0,0,0,0,0,0,0,0,0,0,0,0,0,410,50,120,36,18,1
2020,516700301,47150,1450,1450,1450,0,45700,45200,37000,8200,0,500,500,0,0,0,0,0,0,2394,360,30,180,264,167
2020,516700311,117100,5100,5100,5100,0,112000,110000,80000,30000,0,2000,2000,0,0,0,0,0,0,1694,300,10,120,84,1325
2020,516700331,33100,2100,2100,2100,0,31000,31000,31000,0,0,0,0,0,0,100,100,100,0,1020,200,120,130,80,24
2020,516700351,122638,6432,6432,6432,0,116206,115000,50000,65000,0,1206,680,526,0,10000,0,0,0,3288,540,60,60,136,672
2020,516700371,86182,10082,10082,10082,0,76100,70000,50000,20000,0,6100,6000,100,0,30500,28500,21500,0,9850,900,300,1000,650,1048
2020,516700391,410,410,10,10,400,0,0,0,0,0,0,0,0,0,0,0,0,0,428,96,5,24,48,1
2020,516800111,41010,1010,1010,1010,0,40000,40000,40000,0,0,0,0,0,0,5300,0,0,0,1060,80,130,60,60,41
2020,516800121,63660,3600,3600,3600,0,60060,60000,60000,0,0,60,0,60,0,1800,0,0,0,1226,180,70,60,36,38
2020,516800131,181650,91650,91650,91650,0,90000,90000,90000,0,0,0,0,0,0,0,0,0,0,840,200,50,50,60,1611
2020,516800151,230,230,30,30,200,0,0,0,0,0,0,0,0,0,0,0,0,0,712,294,30,24,24,1
2020,516800161,17280,7580,5580,80,2000,9700,0,0,0,0,9700,1200,0,8500,1800,1800,1200,0,3616,856,10,120,120,33
2020,516800171,28510,13110,1110,1110,12000,15400,15000,0,0,15000,400,400,0,0,0,0,0,0,2240,120,300,360,180,124
2020,516800181,42980,2500,2500,2500,0,40480,40000,40000,0,0,480,480,0,0,14615,14615,14615,0,1622,276,24,240,240,124
2020,516800301,18900,16700,1700,1700,15000,2200,0,0,0,0,2200,2200,0,0,0,0,0,0,3120,140,240,380,280,260
2020,516800321,1916,1916,916,916,1000,0,0,0,0,0,0,0,0,0,1696,1696,0,1696,1140,264,0,36,120,3
2020,516800331,75648,7642,7642,7642,0,68006,65800,35000,30800,0,2206,1980,226,0,6000,6000,6000,0,2198,150,48,600,120,154
2020,516800341,1040,40,40,40,0,1000,1000,0,1000,0,0,0,0,0,0,0,0,0,767,232,150,36,60,2
2020,516800351,4664,4664,1764,1764,2900,0,0,0,0,0,0,0,0,0,800,800,800,0,595,362,5,10,24,1
2020,516800371,550,550,50,50,500,0,0,0,0,0,0,0,0,0,0,0,0,0,1027,480,60,38,36,21
2020,516900121,116,116,1,1,115,0,0,0,0,0,0,0,0,0,0,0,0,0,452,120,5,10,15,0
2020,516900151,7585,7585,85,85,7500,0,0,0,0,0,0,0,0,0,0,0,0,0,558,148,12,10,15,1
2020,516900161,191286,47986,47986,47986,0,143300,140000,140000,0,0,3300,3300,0,0,0,0,0,0,9360,500,200,600,360,1602
2020,516900171,1540,1540,540,540,1000,0,0,0,0,0,0,0,0,0,6560,6560,0,1000,1040,80,20,10,15,17
2020,516900181,1260,1260,260,260,1000,0,0,0,0,0,0,0,0,0,1440,1440,1440,0,2185,1440,100,50,55,1
2020,516900301,3275,3275,275,275,3000,0,0,0,0,0,0,0,0,0,3000,3000,3000,0,3382,468,60,30,264,148
2020,516900311,3450,3450,50,50,3400,0,0,0,0,0,0,0,0,0,2700,2700,2700,0,1162,400,80,48,12,1
2020,516900351,370550,32700,32700,2700,0,337850,336500,61000,275500,0,1350,1350,0,0,112050,4050,4000,0,6330,480,400,600,360,2415
2020,516900361,51610,49310,15310,15310,34000,2300,0,0,0,0,2300,2300,0,0,26400,26400,26400,0,2840,240,100,120,180,309
2020,516900371,43613,43313,10313,7213,33000,300,0,0,0,0,300,300,0,0,22000,22000,20000,2000,5613,300,420,500,106,477
2020,517000102,20100,100,100,100,0,20000,20000,20000,0,0,0,0,0,0,0,0,0,0,261,50,36,10,15,13
2020,517000112,27010,410,410,410,0,26600,24000,24000,0,0,2600,2600,0,0,9359,9359,9359,0,4240,300,300,420,520,90
2020,517000122,2709,1209,209,209,1000,1500,0,0,0,0,1500,0,1500,0,2350,2350,0,2350,2614,1200,0,180,360,328
2020,517000132,248800,166300,106300,56300,60000,82500,80000,0,80000,0,2500,2500,0,0,50000,0,0,0,4780,480,800,720,100,1586
2020,517000142,140200,6700,6700,6700,0,133500,130000,130000,0,0,3500,3500,0,0,0,0,0,0,2270,400,300,200,250,4004
2020,517000152,75934,9434,9434,9434,0,66500,63000,63000,0,0,3500,3500,0,0,10000,10000,10000,0,3026,360,120,120,180,323
2020,517000162,44660,42860,18860,3860,24000,1800,0,0,0,0,1800,800,1000,0,10000,10000,10000,0,5745,135,20,90,180,604
2020,517000192,19095,8095,8095,8095,0,11000,11000,11000,0,0,0,0,0,0,100,100,0,0,1138,156,12,10,72,278
2020,517000312,10464,9594,1094,994,8500,870,0,0,0,0,870,870,0,0,20,20,0,0,3569,900,40,480,324,46
2020,517000322,87000,44700,19700,19700,25000,42300,35500,0,32000,3500,6800,6500,300,0,17500,4500,0,4400,4030,480,200,120,130,661
2020,517000332,6732,1662,1662,1662,0,5070,5000,5000,0,0,70,70,0,0,1500,1500,1500,0,1163,108,23,156,33,12
2020,517000342,25822,24972,972,972,24000,850,0,0,0,0,850,750,100,0,0,0,0,0,2780,360,30,300,240,37
2020,517000352,50004,16304,16304,16304,0,33700,30500,30500,0,0,3200,3100,100,0,0,0,0,0,2726,216,300,360,360,1181
2020,517000362,54471,16771,16771,16771,0,37700,34600,31000,0,3600,3100,3100,0,0,20,20,0,0,3910,420,20,600,240,148
2020,517000382,79730,27730,27730,27730,0,52000,50000,43000,0,7000,2000,2000,0,0,4200,4200,0,4200,5200,360,80,130,180,210
2020,517000392,32023,11723,11723,11723,0,20300,20000,20000,0,0,300,300,0,0,0,0,0,0,3420,324,120,204,192,460
2020,517600101,54470,4970,4970,4970,0,49500,48000,48000,0,0,1500,700,800,0,20800,20800,20600,0,4220,360,60,360,240,92
2020,517600111,85681,15231,15231,15231,0,70450,70000,70000,0,0,450,450,0,0,0,0,0,0,8530,600,1000,350,300,151
2020,517600141,49030,4830,4830,4830,0,44200,44000,44000,0,0,200,200,0,0,10200,10200,7200,3000,5300,180,500,240,300,472
2020,517600171,60660,510,510,510,0,60150,60000,60000,0,0,150,150,0,0,0,0,0,0,1340,180,360,150,50,128
2020,517600181,87338,1438,1438,1438,0,85900,80000,80000,0,0,5900,900,0,5000,30,30,0,0,2470,300,200,500,100,117
2020,517600191,18770,18670,8670,8670,10000,100,0,0,0,0,100,100,0,0,4000,4000,4000,0,2720,600,60,480,300,14
2020,517600311,44500,44000,19000,19000,25000,500,0,0,0,0,500,500,0,0,3700,3700,0,3000,7510,1100,500,200,300,248
2020,517600321,367142,61642,21642,21642,40000,305500,301500,0,301500,0,4000,3200,800,0,43050,40050,20000,20000,12370,480,200,450,180,1777
2020,517600331,5924,5924,3824,3824,2100,0,0,0,0,0,0,0,0,0,290,290,290,0,1025,96,50,45,84,2
2020,517600351,32988,7338,7338,7338,0,25650,25000,25000,0,0,650,650,0,0,19750,19750,12750,7000,4570,480,350,360,400,363
2020,517600391,79323,6523,6523,6523,0,72800,69800,54800,0,15000,3000,3000,0,0,32210,32210,12670,19540,2100,300,50,400,200,794
2020,517700101,32580,28780,5780,5780,23000,3800,3000,0,0,3000,800,800,0,0,10000,10000,10000,0,3100,240,700,300,240,215
2020,517700121,60400,400,400,400,0,60000,60000,60000,0,0,0,0,0,0,10000,10000,10000,0,1620,300,120,100,150,1234
2020,517700141,290,290,40,40,250,0,0,0,0,0,0,0,0,0,0,0,0,0,650,63,30,72,36,1
2020,517700181,7220,7220,220,220,7000,0,0,0,0,0,0,0,0,0,6500,6500,5000,1500,1800,120,0,60,120,153
2020,517700191,21050,21050,50,50,21000,0,0,0,0,0,0,0,0,0,0,0,0,0,1120,250,80,150,80,20
2020,517700301,165572,58072,23072,23072,35000,107500,105000,0,105000,0,2500,2500,0,0,42000,0,0,0,1727,360,290,200,67,369
2020,517700341,72450,17630,17630,17630,0,54820,51000,13000,38000,0,3820,3020,800,0,0,0,0,0,2966,578,300,400,138,60
2020,517800111,33397,32018,5636,5636,26382,1379,0,0,0,0,1379,1379,0,0,20603,20603,18603,2000,2741,150,200,396,217,178
2020,517800131,306600,92700,42700,42700,50000,213900,213000,0,213000,0,900,900,0,0,50500,0,0,0,10894,324,120,600,120,459
2020,517800161,4062,3462,2462,2462,1000,600,0,0,0,0,600,600,0,0,400,400,0,400,3808,1200,100,230,288,19
2020,517800171,25821,8482,3482,3482,5000,17339,17000,0,17000,0,339,0,339,0,23600,8600,3700,3000,1906,696,30,60,120,47
2020,517800181,263854,584,584,584,0,263270,262000,146000,116000,0,1270,1270,0,0,7330,5330,4400,800,2537,340,100,400,207,330
2020,517800311,12900,12200,12200,12200,0,700,0,0,0,0,700,700,0,0,0,0,0,0,2400,360,1200,24,42,51
2020,517800321,64220,4920,4920,4920,0,59300,56600,30000,26600,0,2700,2700,0,0,0,0,0,0,2200,336,15,240,120,132
2020,517800331,28140,4640,4640,4640,0,23500,23000,15000,8000,0,500,500,0,0,0,0,0,0,746,100,100,50,56,47
2020,517800361,18534,1534,1534,1534,0,17000,17000,17000,0,0,0,0,0,0,1070,1070,1070,0,1382,270,96,50,84,26
2020,517800371,25000,3000,3000,3000,0,22000,22000,12000,10000,0,0,0,0,0,0,0,0,0,1066,210,300,60,36,8
2020,517800381,1700,1700,1200,200,500,0,0,0,0,0,0,0,0,0,400,400,0,380,1537,98,100,50,84,8
2020,517800391,5482,5482,5107,4497,375,0,0,0,0,0,0,0,0,0,1240,1240,440,130,1912,288,120,50,240,1
2020,517900131,8034,8034,34,34,8000,0,0,0,0,0,0,0,0,0,0,0,0,0,842,96,10,120,96,5
2020,517900151,520,520,200,200,320,0,0,0,0,0,0,0,0,0,0,0,0,0,524,120,1,60,12,0
2020,517900161,640,640,340,340,300,0,0,0,0,0,0,0,0,0,11,11,0,0,495,240,20,36,36,1
2020,517900171,121900,30900,30900,30900,0,91000,90000,90000,0,0,1000,1000,0,0,29000,29000,19000,10000,4220,180,300,360,120,5337
2020,517900181,133040,9440,9440,9440,0,123600,120000,120000,0,0,3600,3600,0,0,4350,4350,0,4350,3550,400,50,200,200,3536
2020,517900301,22300,6700,6700,6700,0,15600,15200,15200,0,0,400,400,0,0,0,0,0,0,2707,213,1240,240,72,58
2020,517900311,8828,7928,428,428,7500,900,0,0,0,0,900,900,0,0,3777,3777,3300,346,1880,120,300,100,90,21
2020,517900331,36192,992,992,992,0,35200,35000,35000,0,0,200,200,0,0,15000,15000,15000,0,2108,360,1000,108,60,64
2020,517900361,25513,1913,1913,1913,0,23600,22000,22000,0,0,1600,1600,0,0,15532,15532,13400,0,1954,324,300,240,120,67
2020,517900381,23302,5116,5116,5116,0,18186,16000,16000,0,0,2186,1734,452,0,0,0,0,0,3196,565,79,710,169,312
2020,517900391,860,860,860,860,0,0,0,0,0,0,0,0,0,0,0,0,0,0,1033,60,200,30,48,1
2020,518000112,33000,3000,2000,2000,1000,30000,30000,0,30000,0,0,0,0,0,1000,1000,0,1000,1536,576,0,60,120,34
2020,518000122,31100,2200,2200,2200,0,28900,28900,28900,0,0,0,0,0,0,245,45,0,0,2208,200,240,120,72,63
2020,518000132,15350,10600,1600,1600,9000,4750,2000,0,0,2000,2750,2750,0,0,0,0,0,0,5020,180,250,1200,230,18
2020,518000162,16860,16860,7860,7560,9000,0,0,0,0,0,0,0,0,0,40,40,0,0,3530,650,120,250,300,33
2020,518000312,41980,1980,1980,1980,0,40000,40000,40000,0,0,0,0,0,0,2000,0,0,0,1494,740,24,24,36,44
2020,518000322,13650,550,550,550,0,13100,10000,10000,0,0,3100,3100,0,0,1900,1900,0,0,2964,240,120,384,360,13
2020,518600131,100040,7840,7840,7840,0,92200,90000,0,90000,0,2200,2100,100,0,0,0,0,0,5880,420,120,360,180,3028
2020,518600151,21400,21100,7100,6600,14000,300,0,0,0,0,300,300,0,0,9084,9084,8500,0,2358,267,978,93,120,109
2020,518600161,329480,66480,66480,66480,0,263000,255000,250000,5000,0,8000,8000,0,0,40400,31900,31000,0,9440,450,650,360,360,387
2020,518600171,637525,35375,35375,35375,0,602150,600000,250000,350000,0,2150,150,2000,0,5600,0,0,0,3050,600,200,550,120,1960
2020,518600301,42750,2650,150,150,2500,40100,40000,0,40000,0,100,100,0,0,12000,0,0,0,1476,156,180,120,60,51
2020,518600311,14516,5116,5116,5116,0,9400,8000,8000,0,0,1400,1400,0,0,500,500,500,0,2116,180,36,360,180,181
2020,518600321,300,300,50,50,250,0,0,0,0,0,0,0,0,0,1980,1980,0,0,1884,200,24,180,180,5
2020,518600331,4400,4400,200,200,4200,0,0,0,0,0,0,0,0,0,0,0,0,0,385,100,18,10,12,1
2020,518700101,6860,6860,1860,1860,5000,0,0,0,0,0,0,0,0,0,1750,1750,1750,0,3685,120,400,240,125,120
2020,518700141,326840,11840,11840,11840,0,315000,313000,253000,60000,0,2000,0,2000,0,30050,30050,30000,0,5040,480,120,180,180,1044
2020,518700181,82749,1549,1549,1549,0,81200,80000,80000,0,0,1200,1200,0,0,2000,2000,0,2000,2740,480,10,600,150,128
2020,518700191,86374,6124,6124,6124,0,80250,80000,80000,0,0,250,250,0,0,0,0,0,0,1120,300,60,300,120,279
2020,518700321,58900,4900,4900,4900,0,54000,38000,26000,12000,0,16000,16000,0,0,18288,18288,18208,0,7460,400,100,1200,240,500
2020,518700331,700,700,200,200,500,0,0,0,0,0,0,0,0,0,0,0,0,0,2280,720,48,95,180,22
2020,518700341,120,120,120,120,0,0,0,0,0,0,0,0,0,0,0,0,0,0,700,60,30,10,48,1
2020,518800101,450800,800,800,800,0,450000,450000,450000,0,0,0,0,0,0,0,0,0,0,2350,600,150,10,40,1178
2020,518800121,180,180,180,180,0,0,0,0,0,0,0,0,0,0,47000,47000,40000,2000,4285,150,1800,240,160,281
2020,518800161,351950,68600,68600,68600,0,283350,283000,143000,140000,0,350,350,0,0,51000,0,0,0,3385,360,90,30,55,1008
2020,518800191,22054,54,54,54,0,22000,22000,22000,0,0,0,0,0,0,0,0,0,0,710,120,120,48,24,7
2020,518800301,159518,35200,35200,35200,0,124318,92000,22000,70000,0,32318,1200,31118,0,20070,20070,20000,0,3030,200,30,350,200,311
2020,518800311,81150,27810,27810,27810,0,53340,47000,20000,27000,0,6340,2800,1540,2000,120,120,0,0,4430,250,20,950,180,509
2020,518800321,60540,320,320,320,0,60220,60000,20000,40000,0,220,0,220,0,0,0,0,0,782,200,50,20,42,28
2020,518900101,211720,11120,11120,11120,0,200600,200000,200000,0,0,600,600,0,0,0,0,0,0,3200,150,100,220,250,510
2020,518900111,43570,43570,8570,8570,35000,0,0,0,0,0,0,0,0,0,20000,20000,20000,0,2534,300,150,100,144,864
2020,518900131,1020,1020,20,20,1000,0,0,0,0,0,0,0,0,0,0,0,0,0,614,288,20,0,18,1
2020,518900151,361000,85000,5000,4500,80000,276000,275000,0,250000,25000,1000,1000,0,0,122500,22500,20000,0,2880,720,240,240,120,189
2020,518900171,14300,13700,700,700,13000,600,0,0,0,0,600,600,0,0,14000,14000,13000,0,2678,360,20,198,140,110
2020,518900301,32812,5712,5712,5712,0,27100,24700,24700,0,0,2400,2400,0,0,0,0,0,0,1772,120,70,350,162,99
2020,518900311,66758,4058,4058,4058,0,62700,40000,10000,30000,0,22700,1900,20800,0,19300,19300,19200,0,3951,420,120,660,216,28
2020,518900321,36100,1200,1200,1200,0,34900,32000,13000,19000,0,2900,0,2900,0,0,0,0,0,884,220,30,30,84,1877
2020,519000122,181100,21100,1100,1100,20000,160000,160000,0,160000,0,0,0,0,0,30000,30000,30000,0,602,120,50,18,18,68
2020,519000172,5750,5750,750,750,5000,0,0,0,0,0,0,0,0,0,3200,3200,3200,0,3837,615,50,240,132,94
2020,519000192,820,820,320,320,500,0,0,0,0,0,0,0,0,0,0,0,0,0,1680,500,76,84,48,17
2020,519600121,60850,59150,8150,8150,51000,1700,0,0,0,0,1700,1700,0,0,2100,2100,0,2100,5190,200,150,300,240,2665
2020,519600131,10012,10012,12,12,10000,0,0,0,0,0,0,0,0,0,20,20,0,0,449,100,30,0,24,1
2020,519600171,90700,16500,16500,16500,0,74200,73000,73000,0,0,1200,1200,0,0,0,0,0,0,7630,1200,250,240,180,936
2020,519600181,105676,2676,2676,2676,0,103000,103000,100000,0,3000,0,0,0,0,1000,1000,0,1000,2614,180,1080,192,72,122
2020,519600191,169960,24260,24260,24260,0,145700,145000,130000,0,15000,700,700,0,0,0,0,0,0,4155,555,380,190,150,852
2020,519700101,3060,3060,60,60,3000,0,0,0,0,0,0,0,0,0,0,0,0,0,571,60,30,1,24,1
2020,519700181,3700,3700,1000,1000,2700,0,0,0,0,0,0,0,0,0,0,0,0,0,638,60,70,80,48,9
2020,519700301,66866,6866,6866,6866,0,60000,60000,20000,40000,0,0,0,0,0,15610,15610,14890,600,1030,180,10,120,120,450
2020,519800131,100150,150,150,150,0,100000,100000,100000,0,0,0,0,0,0,20000,0,0,0,1572,150,150,180,132,115
2020,519800141,31420,20,20,20,0,31400,31000,31000,0,0,400,400,0,0,4500,4500,4500,0,2674,180,50,720,144,471
2020,519800151,40788,688,688,688,0,40100,40000,40000,0,0,100,100,0,0,6000,6000,6000,0,1050,120,200,150,60,61
2020,519800181,25560,25560,560,560,25000,0,0,0,0,0,0,0,0,0,0,0,0,0,1020,240,20,50,50,37
2020,519800191,1020,1020,20,20,1000,0,0,0,0,0,0,0,0,0,200,200,0,0,1423,275,24,144,180,6
2020,519900101,1020,1020,20,20,1000,0,0,0,0,0,0,0,0,0,0,0,0,0,710,120,0,0,20,0
2020,519900131,31430,1430,1430,1430,0,30000,30000,30000,0,0,0,0,0,0,7145,7145,6945,0,2008,276,100,180,72,91
2020,519900151,5700,5700,700,200,5000,0,0,0,0,0,0,0,0,0,0,0,0,0,346,50,50,6,20,1
2020,519900161,5784,4590,590,590,4000,1194,0,0,0,0,1194,1150,44,0,0,0,0,0,5916,180,24,1200,372,189
2020,519900191,6908,5608,3608,3608,2000,1300,0,0,0,0,1300,1300,0,0,1870,1870,0,0,1450,396,7,292,120,92
2020,520000212,12490,340,340,340,0,12150,12000,12000,0,0,150,150,0,0,0,0,0,0,2056,170,20,96,120,351
2020,520000222,15,15,15,15,0,0,0,0,0,0,0,0,0,0,0,0,0,0,514,268,10,15,16,1
2020,520000232,382,382,82,82,300,0,0,0,0,0,0,0,0,0,0,0,0,0,2294,452,30,228,285,20
2020,520000242,36141,32415,32415,22415,0,3726,0,0,0,0,3726,3500,226,0,0,0,0,0,5290,250,150,400,380,629
2020,520000262,36842,33476,31476,31476,2000,3366,0,0,0,0,3366,3300,66,0,0,0,0,0,3544,804,50,250,240,382
2020,520000272,80050,21750,21750,21750,0,58300,53000,30000,23000,0,5300,5300,0,0,600,100,0,0,3810,500,300,400,360,499
2020,520000282,1170,1170,1170,1170,0,0,0,0,0,0,0,0,0,0,0,0,0,0,1502,130,120,72,240,1
2020,520000312,24846,3446,3446,3446,0,21400,18000,18000,0,0,3400,3400,0,0,9412,9412,9360,0,2569,219,36,420,300,127
2020,520000322,37840,6340,6340,6340,0,31500,31000,18000,13000,0,500,500,0,0,48,48,0,0,1283,204,86,143,72,65
2020,520000332,26228,5778,5778,4778,0,20450,17000,17000,0,0,3450,3200,250,0,6030,6030,6000,0,3660,300,300,360,360,76
2020,520000352,2880,280,280,280,0,2600,2500,2500,0,0,100,100,0,0,0,0,0,0,840,60,30,20,40,13
2020,520000362,73076,16776,5776,4776,11000,56300,52500,0,52500,0,3800,1800,2000,0,6900,6900,6900,0,1935,225,50,280,240,103
2020,520000372,62226,2026,2026,2026,0,60200,60000,50000,10000,0,200,200,0,0,13000,10000,10000,0,5614,1300,130,484,620,387
2020,520600231,6480,6280,5980,5980,300,200,0,0,0,0,200,200,0,0,0,0,0,0,3650,500,100,400,300,27
2020,520600241,33942,1672,1672,1672,0,32270,27000,15000,12000,0,5270,180,90,5000,10020,20,0,0,1380,200,20,440,150,34
2020,520600261,38494,5398,5398,5398,0,33096,33000,32000,1000,0,96,0,96,0,0,0,0,0,938,168,50,30,55,41
2020,520600281,16300,3300,3300,3300,0,13000,13000,13000,0,0,0,0,0,0,2000,0,0,0,780,300,50,20,30,19
2020,520600291,110100,1200,1200,1200,0,108900,104000,58000,41000,5000,4900,4100,800,0,34700,14700,14700,0,5040,400,600,360,240,152
2020,520600301,21196,2952,2952,2952,0,18244,16944,16000,944,0,1300,1300,0,0,5000,5000,3800,1200,1805,300,20,540,135,150
2020,520600311,65900,32100,32100,32100,0,33800,25000,25000,0,0,8800,8800,0,0,5550,5550,4800,750,1689,300,50,400,140,461
2020,520600351,33124,4974,4974,4974,0,28150,28000,28000,0,0,150,150,0,0,21000,21000,19000,2000,1855,350,150,100,100,66
2020,520600361,64573,4873,4873,4873,0,59700,55000,35000,20000,0,4700,3700,1000,0,17700,3500,0,0,1515,230,150,200,200,138
2020,520600381,50050,8700,8700,8700,0,41350,38000,20000,18000,0,3350,3350,0,0,880,580,0,0,3040,250,100,600,70,313
2020,520600391,33400,880,880,880,0,32520,30000,17000,13000,0,2520,2000,520,0,1000,0,0,0,2739,356,72,240,72,30
2020,520700211,4321,4236,2516,2516,1720,85,0,0,0,0,85,0,85,0,1700,1700,1700,0,1656,264,100,120,120,16
2020,520700221,1810,1550,100,100,1450,260,0,0,0,0,260,0,260,0,0,0,0,0,655,240,12,10,15,1
2020,520700231,44214,11214,11214,11214,0,33000,31000,24000,7000,0,2000,2000,0,0,0,0,0,0,3494,224,360,400,60,483
2020,520700251,20866,3756,3756,3756,0,17110,17000,17000,0,0,110,0,110,0,50,50,0,0,2350,300,10,100,300,14
2020,520700261,35208,4168,4168,4168,0,31040,30000,30000,0,0,1040,750,290,0,6000,0,0,0,4268,220,240,840,168,101
2020,520700271,6071,5071,4771,4171,300,1000,0,0,0,0,1000,0,0,1000,760,760,0,710,1000,400,30,60,50,2
2020,520700281,47010,13010,11010,9010,2000,34000,9800,0,9800,0,24200,0,24200,0,44500,44500,0,44000,4370,1440,50,300,360,448
2020,520700301,124668,3768,3768,3768,0,120900,118500,8500,110000,0,2400,400,2000,0,2000,2000,0,1000,1318,180,24,180,84,126
2020,520700311,25522,10102,10102,10102,0,15420,15000,5000,10000,0,420,0,420,0,0,0,0,0,951,460,180,36,18,50
2020,520700341,198190,68990,43990,35990,25000,129200,100000,0,80000,20000,29200,7200,22000,0,16000,15000,15000,0,7080,300,120,1200,600,1580
2020,520700361,4600,3900,3900,3900,0,700,0,0,0,0,700,700,0,0,10,10,0,0,1308,64,10,300,156,66
2020,520700371,57528,8728,8728,8728,0,48800,48000,18000,30000,0,800,800,0,0,2000,0,0,0,3940,324,360,240,216,409
2020,520700391,14168,3100,3100,3100,0,11068,11000,11000,0,0,68,0,68,0,0,0,0,0,794,202,100,36,30,23
2020,520800231,4366,3866,3866,2866,0,500,0,0,0,0,500,500,0,0,7000,7000,0,6500,1520,150,250,350,60,35
2020,520800251,79292,9842,9842,9842,0,69450,68000,68000,0,0,1450,550,900,0,2040,40,0,0,4040,200,40,100,300,153
2020,520800271,30390,29620,620,620,29000,770,0,0,0,0,770,550,220,0,60,60,0,0,2668,264,240,180,160,40
2020,520800281,39100,21100,21100,21100,0,18000,18000,18000,0,0,0,0,0,0,0,0,0,0,2880,550,20,255,95,66
2020,520800301,10541,2741,2741,2741,0,7800,6000,6000,0,0,1800,300,0,1500,0,0,0,0,2070,300,84,240,180,11
2020,520800311,992,842,692,692,150,150,0,0,0,0,150,150,0,0,1180,1180,0,700,2090,408,50,500,66,18
2020,520800321,20612,5612,5612,5612,0,15000,14000,12000,2000,0,1000,1000,0,0,2200,2200,2200,0,2760,360,300,100,150,642
2020,520800331,59286,25436,25436,25436,0,33850,33000,33000,0,0,850,800,50,0,0,0,0,0,3244,144,100,100,240,648
2020,520800341,8090,540,540,540,0,7550,7500,7500,0,0,50,50,0,0,0,0,0,0,986,240,120,60,96,21
2020,520800351,60400,1000,1000,1000,0,59400,59000,9000,50000,0,400,400,0,0,7000,5000,0,0,1562,696,120,96,72,161
2020,520800371,90840,1290,1290,1290,0,89550,84000,72000,12000,0,5550,5550,0,0,14000,0,0,0,1510,107,20,480,120,516
2020,520800391,27220,120,120,120,0,27100,25000,25000,0,0,2100,2100,0,0,9000,9000,9000,0,3260,336,20,144,240,68
2020,520900201,10300,200,200,200,0,10100,10000,10000,0,0,100,0,100,0,0,0,0,0,850,240,200,10,35,13
2020,520900211,52600,100,100,100,0,52500,52500,16500,36000,0,0,0,0,0,28000,0,0,0,1016,200,10,70,36,65
2020,520900231,210,210,10,10,200,0,0,0,0,0,0,0,0,0,0,0,0,0,367,120,25,10,16,0
2020,520900241,74773,48620,48620,48620,0,26153,25000,25000,0,0,1153,1000,153,0,0,0,0,0,3540,220,250,180,140,1868
2020,520900251,17160,1460,1460,460,0,15700,15000,15000,0,0,700,600,100,0,5000,5000,5000,0,1592,100,130,270,170,76
2020,520900271,16060,11680,3180,3180,8500,4380,4000,0,0,4000,380,80,300,0,4000,4000,0,4000,2036,300,120,220,120,30
2020,520900281,7350,7050,50,50,7000,300,0,0,0,0,300,200,100,0,20,20,0,0,1940,240,40,250,200,21
2020,520900301,40924,5024,5024,5024,0,35900,32000,32000,0,0,3900,3900,0,0,7200,6700,6700,0,2038,360,120,240,168,164
2020,520900311,15738,568,568,568,0,15170,15000,15000,0,0,170,170,0,0,0,0,0,0,1205,198,60,380,36,51
2020,520900321,40488,10488,10488,10488,0,30000,26000,26000,0,0,4000,3000,1000,0,19700,19700,17000,2700,7610,300,200,600,240,438
2020,520900341,23598,2498,2498,2498,0,21100,19000,19000,0,0,2100,2100,0,0,15240,15240,12280,1700,3092,234,36,400,240,105
2020,520900351,21560,5560,5560,3560,0,16000,16000,16000,0,0,0,0,0,0,11894,11894,9864,2000,1941,285,60,360,300,95
2020,520900361,96572,5372,5372,5372,0,91200,90000,40000,50000,0,1200,1200,0,0,27700,9500,7000,2500,2320,360,100,240,80,173
2020,521000202,86020,1020,1020,1020,0,85000,85000,85000,0,0,0,0,0,0,12000,0,0,0,870,100,150,30,40,98
2020,521000262,700,700,500,500,200,0,0,0,0,0,0,0,0,0,0,0,0,0,763,350,10,72,36,6
2020,521000272,33420,15420,15420,15420,0,18000,18000,18000,0,0,0,0,0,0,0,0,0,0,3880,300,200,100,180,191
2020,521000282,111107,3381,3381,3381,0,107726,107000,40000,67000,0,726,500,226,0,42800,17800,17800,0,2890,250,50,200,100,193
2020,521000302,30280,9280,9280,9280,0,21000,14000,10000,4000,0,7000,7000,0,0,9000,9000,5000,1000,2200,300,100,240,240,108
2020,521000342,27018,5418,5418,4418,0,21600,19000,19000,0,0,2600,1500,500,600,6800,6800,6800,0,4095,225,10,480,180,520
2020,521000352,5,5,5,5,0,0,0,0,0,0,0,0,0,0,0,0,0,0,640,70,10,36,24,1
2020,521000362,24427,3370,3370,3370,0,21057,20400,19900,500,0,657,657,0,0,0,0,0,0,760,50,20,120,60,22
2020,521000372,1500,500,500,500,0,1000,1000,1000,0,0,0,0,0,0,0,0,0,0,969,170,300,20,34,1
2020,521000382,20520,3320,3320,3320,0,17200,15000,15000,0,0,2200,2200,0,0,4560,4560,2400,0,3000,300,150,600,120,132
2020,521600201,21610,110,110,110,0,21500,15000,15000,0,0,6500,1500,0,5000,5300,0,0,0,1040,130,250,15,70,31
2020,521600221,65431,38416,38416,38416,0,27015,25000,20000,5000,0,2015,1900,115,0,15000,15000,15000,0,5140,300,240,600,360,9482
2020,521600241,10280,9080,4080,1080,5000,1200,0,0,0,0,1200,1200,0,0,4434,4434,850,3584,3960,540,120,288,372,170
2020,521600251,47814,8214,8214,8214,0,39600,28000,28000,0,0,11600,7600,0,4000,18370,18370,18300,0,2980,500,40,400,120,121
2020,521600261,61862,5682,5682,4482,0,56180,56000,56000,0,0,180,0,180,0,1400,0,0,0,1496,360,100,126,70,204
2020,521600281,43826,1826,1826,1826,0,42000,42000,42000,0,0,0,0,0,0,550,0,0,0,1215,140,240,15,40,39
2020,521600311,232,232,2,2,230,0,0,0,0,0,0,0,0,0,3500,3500,0,3500,415,132,12,10,66,3
2020,521600321,5080,3880,3880,3880,0,1200,0,0,0,0,1200,1200,0,0,3500,3500,0,3500,1090,264,30,150,50,77
2020,521600331,88471,7471,7471,7471,0,81000,80000,40000,40000,0,1000,1000,0,0,28100,11900,9000,2900,4574,1200,100,500,288,261
2020,521600341,36407,4857,4857,4857,0,31550,12000,10000,2000,0,19550,3500,14050,2000,17097,17097,3000,1000,3263,187,100,520,256,78
2020,521600361,2794,2794,2294,2294,500,0,0,0,0,0,0,0,0,0,2138,2138,0,2138,2911,525,700,240,276,43
2020,521600371,78811,33659,33659,33659,0,45152,42000,32000,10000,0,3152,2700,452,0,1000,0,0,0,5290,500,100,580,240,1146
2020,521600381,23335,3715,3715,3715,0,19620,15000,11000,4000,0,4620,2720,1900,0,2311,2311,484,0,1963,261,210,190,132,177
2020,521600391,11455,6382,6382,6382,0,5073,5000,5000,0,0,73,50,23,0,468,468,468,0,2390,120,30,300,240,32
2020,521700211,7617,2717,2717,2717,0,4900,4900,3400,1500,0,0,0,0,0,900,900,900,0,582,120,30,50,48,4
2020,521700231,20180,150,150,150,0,20030,20000,20000,0,0,30,0,30,0,0,0,0,0,640,128,84,24,28,11
2020,521700251,55027,53927,6927,6927,47000,1100,0,0,0,0,1100,1000,100,0,21100,21100,0,21000,4300,300,200,200,200,1601
2020,521700281,85411,10391,10391,10391,0,75020,74000,33000,41000,0,1020,900,120,0,37978,35978,35858,0,3000,396,90,360,160,555
2020,521700291,105574,39274,39274,39274,0,66300,65000,53000,12000,0,1300,1200,100,0,2350,2350,0,2300,2658,300,500,240,120,674
2020,521700311,12816,10226,7226,7226,3000,2590,2590,0,0,2590,0,0,0,0,2590,2590,0,2590,719,180,3,72,60,31
2020,521700321,28190,600,600,600,0,27590,25200,3000,22200,0,2390,1000,1390,0,100,100,0,100,1218,60,150,168,60,39
2020,521700331,219,219,219,219,0,0,0,0,0,0,0,0,0,0,0,0,0,0,530,87,96,18,24,1
2020,521700341,30,30,30,30,0,0,0,0,0,0,0,0,0,0,0,0,0,0,473,130,100,12,36,1
2020,521700361,800,200,200,200,0,600,600,600,0,0,0,0,0,0,0,0,0,0,576,100,30,20,27,4
2020,521700371,60,60,60,60,0,0,0,0,0,0,0,0,0,0,0,0,0,0,903,160,180,20,30,1
2020,521700381,27554,13854,13854,13854,0,13700,12500,8000,4500,0,1200,1200,0,0,150,150,150,0,4420,850,40,270,300,29
2020,521700391,77828,19228,3228,3228,16000,58600,56000,0,56000,0,2600,2600,0,0,41000,24000,22000,2000,5150,250,350,900,150,799
2020,521800201,40,10,10,10,0,30,0,0,0,0,30,0,30,0,0,0,0,0,555,200,45,10,20,0
2020,521800231,26960,1700,1700,1700,0,25260,24900,24000,900,0,360,0,360,0,6110,6110,5200,910,711,200,160,12,24,41
2020,521800241,3077,3062,2862,2862,200,15,0,0,0,0,15,0,15,0,0,0,0,0,833,414,60,23,22,1
2020,521800261,28106,4038,4038,4038,0,24068,22000,22000,0,0,2068,2000,68,0,7567,7567,7552,0,3110,220,20,250,240,129
2020,521800271,75688,688,688,688,0,75000,75000,60000,15000,0,0,0,0,0,5000,0,0,0,1126,300,180,20,36,65
2020,521800281,9117,117,117,117,0,9000,9000,9000,0,0,0,0,0,0,0,0,0,0,2335,250,700,35,100,35
2020,521800311,91612,57352,57352,42352,0,34260,27000,27000,0,0,7260,5000,2260,0,10750,10750,9000,0,3830,300,20,200,360,397
2020,521800331,920,920,920,920,0,0,0,0,0,0,0,0,0,0,0,0,0,0,559,60,5,60,24,3
2020,521800341,136,6,6,6,0,130,0,0,0,0,130,130,0,0,0,0,0,0,674,136,140,70,18,13
2020,521800361,20200,11200,11200,11200,0,9000,6500,4500,2000,0,2500,2500,0,0,0,0,0,0,2240,200,110,240,120,211
2020,521800371,32600,14250,14250,14250,0,18350,17000,7000,10000,0,1350,450,900,0,1000,1000,1000,0,3520,400,360,400,300,216
2020,521800391,6508,6208,5708,5708,500,300,0,0,0,0,300,300,0,0,0,0,0,0,2550,190,140,235,95,52
2020,521900201,18658,7121,7121,7121,0,11537,11500,11500,0,0,37,0,37,0,0,0,0,0,637,140,50,30,36,35
2020,521900211,9152,1152,1152,1152,0,8000,8000,8000,0,0,0,0,0,0,4125,4125,4125,0,620,125,170,35,36,8
2020,521900251,155580,38330,38330,37330,0,117250,115000,115000,0,0,2250,2250,0,0,189,189,0,0,5870,400,60,250,180,2134
2020,521900271,38648,3048,3048,3048,0,35600,33000,33000,0,0,2600,1500,1100,0,0,0,0,0,1872,240,300,350,72,76
2020,521900301,21470,18770,2270,2270,16500,2700,0,0,0,0,2700,2700,0,0,6576,6576,0,4500,2899,639,10,240,240,531
2020,521900311,34810,8740,8740,8740,0,26070,23000,23000,0,0,3070,3000,70,0,80,80,0,0,2421,230,90,400,270,141
2020,521900321,11744,10514,2714,2714,7800,1230,0,0,0,0,1230,1230,0,0,6636,6636,6200,0,1210,480,20,84,60,7
2020,521900331,1866,1116,816,816,300,750,0,0,0,0,750,750,0,0,0,0,0,0,1795,458,5,304,168,17
2020,521900341,20385,895,895,95,0,19490,12500,12500,0,0,6990,3680,1010,2300,15222,15222,8000,4880,3976,1248,80,540,288,92
2020,521900361,33362,10562,10562,10562,0,22800,12000,12000,0,0,10800,3800,7000,0,2200,2200,2000,200,3280,300,100,500,180,81
2020,521900371,2700,1050,1050,1050,0,1650,700,700,0,0,950,900,50,0,3000,3000,3000,0,1635,215,380,280,65,11
2020,521900381,3790,3300,3300,3100,0,490,0,0,0,0,490,0,490,0,592,592,440,0,2780,660,20,240,180,247
2020,521900391,101,101,1,1,100,0,0,0,0,0,0,0,0,0,0,0,0,0,387,180,20,18,24,0
2020,522000202,29000,17000,3000,3000,14000,12000,12000,0,12000,0,0,0,0,0,11000,0,0,0,2023,336,800,15,42,17
2020,522000212,28529,1495,1495,1495,0,27034,26000,0,26000,0,1034,1000,34,0,21500,21500,20000,1500,3450,120,30,240,300,102
2020,522000232,40813,8700,8700,8700,0,32113,30000,30000,0,0,2113,2000,113,0,0,0,0,0,4010,350,200,300,180,116
2020,522000262,94420,15120,15120,4120,0,79300,68000,53000,15000,0,11300,1000,300,10000,42850,42850,42800,0,4200,500,100,500,200,179
2020,522000282,20640,490,490,490,0,20150,20000,10000,10000,0,150,150,0,0,5420,5420,5420,0,2250,240,100,180,120,68
2020,522000292,27690,6390,6390,6390,0,21300,15000,13000,2000,0,6300,1000,0,5300,0,0,0,0,1524,180,36,96,112,41
2020,522000302,10396,4396,4396,1396,0,6000,6000,6000,0,0,0,0,0,0,0,0,0,0,5955,5200,50,180,55,6
2020,522000312,17780,17130,17130,17130,0,650,600,600,0,0,50,50,0,0,0,0,0,0,991,173,150,40,15,25
2020,522000322,40840,6280,6280,6280,0,34560,32000,12000,20000,0,2560,300,2260,0,3000,3000,3000,0,1560,220,240,50,60,21
2020,522000342,5010,10,10,10,0,5000,5000,5000,0,0,0,0,0,0,0,0,0,0,464,180,48,0,36,5
2020,522000352,8350,200,200,200,0,8150,8000,8000,0,0,150,150,0,0,0,0,0,0,3278,207,1300,190,204,81
2020,522600201,80180,54180,40180,40180,14000,26000,25000,0,25000,0,1000,400,600,0,8960,1960,0,1880,3660,300,0,300,160,972
2020,522600211,40,40,40,40,0,0,0,0,0,0,0,0,0,0,0,0,0,0,276,0,15,25,36,1
2020,522600231,8910,880,880,880,0,8030,8000,8000,0,0,30,30,0,0,1000,1000,0,0,2010,150,100,500,110,24
2020,522600241,273080,1680,1680,1680,0,271400,270000,70000,200000,0,1400,1000,400,0,56000,40000,40000,0,4600,600,500,400,200,1554
2020,522600261,18110,17300,4300,4300,13000,810,0,0,0,0,810,750,60,0,8700,8700,8700,0,3425,650,35,378,243,38
2020,522600271,136620,13300,13300,13300,0,123320,109000,30000,79000,0,14320,200,14120,0,2000,0,0,0,4630,300,700,700,80,328
2020,522600281,81200,3200,3200,3200,0,78000,73000,43000,30000,0,5000,5000,0,0,1840,840,0,0,5175,240,30,240,120,907
2020,522600291,17018,3747,3747,3747,0,13271,13150,13150,0,0,121,0,121,0,5,5,0,0,1203,220,237,53,57,21
2020,522600301,702,202,202,202,0,500,500,500,0,0,0,0,0,0,0,0,0,0,1252,200,90,105,144,3
2020,522600311,31959,1659,1659,1659,0,30300,30000,30000,0,0,300,0,300,0,720,720,720,0,1538,324,280,172,39,40
2020,522600321,9672,2092,2092,2092,0,7580,7000,7000,0,0,580,580,0,0,0,0,0,0,1693,487,100,280,96,29
2020,522600331,14320,320,320,320,0,14000,14000,1000,13000,0,0,0,0,0,0,0,0,0,757,342,48,10,25,6
2020,522600341,140862,23062,23062,23062,0,117800,44000,19000,25000,0,73800,4800,69000,0,23000,23000,23000,0,4228,950,800,350,228,180
2020,522600351,6070,1050,1050,1050,0,5020,5000,5000,0,0,20,0,20,0,0,0,0,0,562,180,10,20,72,6
2020,522700201,4224,3999,999,999,3000,225,0,0,0,0,225,200,25,0,0,0,0,0,2650,300,100,250,180,47
2020,522700211,71786,21186,21186,21186,0,50600,50000,50000,0,0,600,250,350,0,4920,4920,4900,0,3960,260,50,100,150,482
2020,522700241,34408,6188,6188,6188,0,28220,26500,26500,0,0,1720,1400,320,0,3641,3641,3491,0,5340,400,500,600,240,339
2020,522700251,63285,21785,21785,21785,0,41500,40500,27500,13000,0,1000,1000,0,0,0,0,0,0,2630,240,100,200,150,227
2020,522700281,45450,17400,17400,10400,0,28050,28000,28000,0,0,50,50,0,0,0,0,0,0,3990,300,10,200,120,120
2020,522700291,27620,120,120,120,0,27500,26000,26000,0,0,1500,1500,0,0,5754,5754,5585,0,1708,180,5,30,40,134
2020,522700311,43250,9550,9550,9550,0,33700,32000,20000,12000,0,1700,1700,0,0,6000,6000,6000,0,2754,534,100,360,190,52
2020,522700321,22505,5492,5492,5492,0,17013,6300,6300,0,0,10713,600,10113,0,3980,3980,0,0,1827,196,10,300,226,131
2020,522700341,643,643,643,643,0,0,0,0,0,0,0,0,0,0,0,0,0,0,500,140,80,20,15,1
2020,522700351,9045,2965,2965,2965,0,6080,6000,4000,2000,0,80,80,0,0,2270,2270,1700,570,3082,850,60,420,252,29
2020,522700361,1301,301,301,301,0,1000,1000,1000,0,0,0,0,0,0,0,0,0,0,620,75,186,50,24,1
2020,522800201,120580,17080,17080,17080,0,103500,97000,82000,15000,0,6500,4500,2000,0,2000,2000,2000,0,4450,500,100,200,250,508
2020,522800231,8300,8300,300,300,8000,0,0,0,0,0,0,0,0,0,0,0,0,0,964,200,120,130,54,1
2020,522800241,11280,8780,280,280,8500,2500,0,0,0,0,2500,2500,0,0,1600,1600,0,0,2562,180,10,180,168,84
2020,522800261,69882,15782,15782,15282,0,54100,40500,37500,3000,0,13600,2100,11500,0,7380,7380,7280,0,5910,360,500,1000,150,130
2020,522800271,245,245,3,3,242,0,0,0,0,0,0,0,0,0,0,0,0,0,729,130,30,28,36,0
2020,522800281,50076,9776,9776,9776,0,40300,37000,37000,0,0,3300,2300,1000,0,14100,14100,14000,0,3340,300,100,360,240,157
2020,522800291,26750,250,250,250,0,26500,26500,26500,0,0,0,0,0,0,3556,3556,3496,0,934,168,172,10,24,31
2020,522800301,15073,2160,2160,2160,0,12913,11400,2000,9400,0,1513,1400,113,0,0,0,0,0,1260,200,20,250,60,44
2020,522800311,77165,840,840,840,0,76325,74525,5525,69000,0,1800,1500,300,0,0,0,0,0,2142,172,120,600,240,76
2020,522800321,35125,3312,3312,3312,0,31813,24700,9700,15000,0,7113,500,6613,0,4000,4000,4000,0,1600,240,160,320,120,61
2020,522800351,98000,5500,5500,5500,0,92500,90000,50000,40000,0,2500,2500,0,0,5000,5000,5000,0,3119,1280,230,240,312,107
2020,522900201,7920,7520,1020,1020,6500,400,0,0,0,0,400,400,0,0,100,100,0,0,1540,300,90,200,130,0
2020,522900211,68820,12320,12320,12320,0,56500,55000,55000,0,0,1500,1300,200,0,9676,9676,9334,0,4420,400,500,100,170,553
2020,522900221,76352,20032,20032,20032,0,56320,56000,56000,0,0,320,320,0,0,1200,1200,1200,0,3760,400,60,600,180,568
2020,522900231,2266,766,266,266,500,1500,0,0,0,0,1500,1500,0,0,1740,1740,0,1440,1840,660,10,240,120,82
2020,522900251,8498,7698,1698,1698,6000,800,0,0,0,0,800,800,0,0,2240,2240,0,2000,2347,240,70,360,240,37
2020,522900271,154052,4152,4152,4152,0,149900,148000,28000,120000,0,1900,1700,200,0,3050,50,0,0,2540,360,400,360,80,404
2020,522900281,26764,8093,8093,8093,0,18671,16000,16000,0,0,2671,2400,271,0,12743,12743,10113,1000,4855,220,120,710,295,335
2020,522900291,25050,50,50,50,0,25000,25000,25000,0,0,0,0,0,0,0,0,0,0,1065,230,250,0,15,34
2020,522900301,110580,4780,4780,4780,0,105800,105000,12000,93000,0,800,800,0,0,20000,0,0,0,1733,182,100,180,96,181
2020,522900311,16498,4725,4725,4725,0,11773,11500,5500,6000,0,273,160,113,0,500,500,500,0,3606,246,250,420,240,257
2020,522900331,21200,7200,7200,7200,0,14000,11000,11000,0,0,3000,3000,0,0,0,0,0,0,1390,150,20,200,120,791
2020,522900341,7350,1250,1250,750,0,6100,6000,6000,0,0,100,100,0,0,2000,2000,0,2000,2509,145,150,244,240,34
2020,522900351,9770,1520,1520,1520,0,8250,5000,5000,0,0,3250,2250,1000,0,300,300,0,0,2933,122,100,600,180,160
2020,523000212,62976,7476,7476,7476,0,55500,49000,32000,17000,0,6500,1500,0,5000,9000,0,0,0,1640,264,70,180,76,75
2020,523000222,41720,270,270,270,0,41450,41000,16000,25000,0,450,300,150,0,0,0,0,0,1568,240,120,96,72,35
2020,523000242,30160,660,660,660,0,29500,26000,18000,8000,0,3500,3500,0,0,0,0,0,0,6789,350,420,710,216,1028
2020,523600201,53885,5185,5185,5185,0,48700,47000,27000,20000,0,1700,1700,0,0,16000,16000,16000,0,6364,264,100,400,240,712
2020,523600211,181725,15980,15980,15980,0,165745,162000,40000,122000,0,3745,3545,200,0,43000,36000,36000,0,4150,500,100,250,150,2353
2020,523600231,564664,16964,16964,16964,0,547700,544000,34000,510000,0,3700,3000,700,0,136520,130020,130000,0,7420,360,200,500,240,4314
2020,523600241,13,8,8,8,0,5,0,0,0,0,5,0,5,0,0,0,0,0,842,270,10,12,25,3
2020,523700241,15769,2319,2319,2319,0,13450,13000,12000,1000,0,450,300,150,0,4580,4580,4500,80,2640,180,120,240,180,81
2020,523700251,32500,500,500,500,0,32000,32000,20000,12000,0,0,0,0,0,0,0,0,0,779,82,312,10,18,12
2020,523800201,25030,8650,8650,5650,0,16380,14000,14000,0,0,2380,380,0,2000,1300,1300,0,1300,2550,200,200,400,150,55
2020,523800221,3136,2799,2199,2199,600,337,0,0,0,0,337,270,67,0,0,0,0,0,2756,725,135,187,195,37
2020,523800241,23650,3550,3550,3550,0,20100,20000,20000,0,0,100,100,0,0,0,0,0,0,720,120,20,100,30,36
2020,523900201,47600,12800,5800,5800,7000,34800,34500,0,34500,0,300,300,0,0,14150,14150,14000,0,3101,240,130,250,161,344
2020,523900211,63060,12560,12560,8560,0,50500,35000,35000,0,0,15500,2400,10100,3000,24380,24380,24180,0,3190,350,30,500,230,452
2020,523900221,50,20,20,20,0,30,0,0,0,0,30,0,30,0,3290,3290,0,2540,1144,528,10,96,120,1
2020,523900231,21750,420,420,420,0,21330,21000,21000,0,0,330,330,0,0,500,500,430,70,2186,240,100,100,96,14
2020,523900251,250,250,50,50,200,0,0,0,0,0,0,0,0,0,0,0,0,0,664,300,20,24,20,1
2020,530000202,40630,130,130,130,0,40500,40500,0,40500,0,0,0,0,0,0,0,0,0,1503,180,360,10,6,31
2020,530000212,26810,5010,5010,10,0,21800,21000,12000,9000,0,800,800,0,0,9000,9000,7000,2000,1015,120,300,158,36,70
2020,530000242,96850,16700,16700,16700,0,80150,75000,39000,36000,0,5150,4850,300,0,10467,1467,0,0,2286,360,120,180,96,160
2020,530000252,18650,11900,6900,6900,5000,6750,6750,0,6750,0,0,0,0,0,0,0,0,0,1759,170,480,132,105,50
2020,530000262,10605,10005,5,5,10000,600,0,0,0,0,600,600,0,0,200,200,0,0,2730,780,100,200,180,49
2020,530000272,36200,9480,9480,9480,0,26720,25500,23000,2500,0,1220,1220,0,0,0,0,0,0,1980,232,18,120,60,137
2020,530000282,24860,1060,1060,1060,0,23800,23000,23000,0,0,800,800,0,0,14000,14000,14000,0,4205,800,30,120,40,185
2020,530000292,89280,40740,10740,10740,30000,48540,45000,0,45000,0,3540,2400,1140,0,30000,0,0,0,4910,360,500,250,350,2531
2020,530000312,20819,20043,19043,13043,1000,776,0,0,0,0,776,550,226,0,400,400,0,0,2267,204,40,540,205,65
2020,530000322,42570,220,220,220,0,42350,39600,3000,36600,0,2750,450,2300,0,770,770,500,250,1573,161,40,216,156,49
2020,530000342,7950,3350,3350,3350,0,4600,4500,4500,0,0,100,0,100,0,0,0,0,0,756,192,44,60,14,8
2020,530000352,39908,11118,10818,7818,300,28790,28500,0,28500,0,290,290,0,0,26257,22257,20257,0,3840,450,150,300,350,149
2020,530000362,2960,1980,1480,1480,500,980,0,0,0,0,980,980,0,0,1001,1001,916,0,3790,450,50,150,120,72
2020,530000382,38600,8550,8550,8550,0,30050,29500,15000,14500,0,550,550,0,0,3731,2731,2731,0,4510,350,500,400,520,573
2020,530000392,47140,8440,8440,1940,0,38700,38000,16000,22000,0,700,700,0,0,8590,4590,4590,0,4346,575,50,510,336,203
2020,530600211,23324,1916,1916,1416,0,21408,19000,19000,0,0,2408,1280,1128,0,16500,16500,13300,3200,1387,120,0,240,120,31
2020,530600251,33142,16342,16342,16342,0,16800,16400,12500,3900,0,400,400,0,0,0,0,0,0,1772,185,350,240,108,158
2020,530600261,25150,5450,5450,5450,0,19700,13500,13500,0,0,6200,3200,0,3000,0,0,0,0,2430,170,10,300,360,79
2020,530600271,7200,7200,1200,1200,6000,0,0,0,0,0,0,0,0,0,0,0,0,0,1679,120,5,140,96,14
2020,530600281,10,10,10,10,0,0,0,0,0,0,0,0,0,0,560,560,0,0,1070,420,320,36,60,2
2020,530600291,61345,9160,9160,6660,0,52185,39000,15000,24000,0,13185,3185,10000,0,14707,8207,8207,0,2964,300,120,720,360,94
2020,530600331,5150,150,150,150,0,5000,5000,5000,0,0,0,0,0,0,0,0,0,0,1926,144,360,120,132,9
2020,530600351,49740,1827,1827,1737,0,47913,47000,0,47000,0,913,800,113,0,0,0,0,0,1576,288,240,204,144,79
2020,530600371,43920,21020,21020,20520,0,22900,19700,17500,0,2200,3200,3200,0,0,1900,1900,1900,0,5085,732,50,225,208,113
2020,530700211,18100,100,100,100,0,18000,18000,18000,0,0,0,0,0,0,200,0,0,0,458,180,24,12,18,11
2020,530700221,8085,7915,5715,715,2200,170,0,0,0,0,170,0,170,0,0,0,0,0,1000,174,186,30,12,12
2020,530700251,17149,15350,7350,7350,8000,1799,0,0,0,0,1799,1799,0,0,0,0,0,0,2190,120,30,200,70,165
2020,530700271,43168,8180,8180,8180,0,34988,18000,18000,0,0,16988,16700,288,0,7000,7000,2800,0,3300,120,300,540,480,131
2020,530700281,53076,12976,12976,10976,0,40100,22500,19500,3000,0,17600,2600,10000,5000,2925,2925,2925,0,2326,216,100,360,180,181
2020,530700311,19119,19,19,19,0,19100,19000,10000,9000,0,100,100,0,0,1900,1900,0,0,1300,322,35,360,108,36
2020,530700341,7500,2200,2200,2200,0,5300,4500,4500,0,0,800,800,0,0,3080,3080,0,3080,3200,450,100,250,300,216
2020,530700351,8916,1080,1080,1080,0,7836,7000,7000,0,0,836,750,86,0,0,0,0,0,1790,160,50,450,120,90
2020,530700361,9243,9130,8270,8270,860,113,0,0,0,0,113,0,113,0,80,80,0,0,2530,360,330,220,240,65
2020,530700371,18649,1510,1510,1510,0,17139,13500,13500,0,0,3639,800,2839,0,0,0,0,0,2170,300,280,360,120,40
2020,530700381,49766,32026,27026,27026,5000,17740,13000,0,13000,0,4740,4600,140,0,8600,7600,0,4500,3800,400,300,480,120,703
2020,530700391,5576,5350,3350,3350,2000,226,0,0,0,0,226,0,226,0,0,0,0,0,885,382,5,60,48,1
2020,530800211,2390,790,290,290,500,1600,0,0,0,0,1600,0,100,1500,1600,1600,0,1400,1620,636,24,100,120,1
2020,530800231,2970,2970,470,470,2500,0,0,0,0,0,0,0,0,0,6600,6600,400,700,2595,468,5,130,180,6
2020,530800251,6030,30,30,30,0,6000,6000,6000,0,0,0,0,0,0,0,0,0,0,478,57,25,10,36,8
2020,530800261,59806,1770,1770,1770,0,58036,57000,28000,29000,0,1036,1036,0,0,12500,12000,12000,0,2304,240,100,240,156,145
2020,530800271,80050,12250,12250,12250,0,67800,67000,52000,15000,0,800,800,0,0,3000,3000,3000,0,8010,480,350,500,240,744
2020,530800281,28564,17464,464,464,17000,11100,10000,0,0,10000,1100,1100,0,0,28100,28100,17100,11000,3170,390,120,180,200,36
2020,530800291,66050,4450,4450,2450,0,61600,49000,49000,0,0,12600,4100,500,8000,4700,4700,4700,0,6500,480,1000,600,320,207
2020,530800311,12260,3360,3360,3360,0,8900,7000,7000,0,0,1900,100,300,1500,2000,2000,0,2000,3220,1440,120,240,120,26
2020,530800331,15735,210,210,210,0,15525,15525,15525,0,0,0,0,0,0,2880,2880,2880,0,692,120,12,60,48,27
2020,530800341,14430,4140,4140,4140,0,10290,10000,10000,0,0,290,200,90,0,0,0,0,0,2630,480,20,300,120,74
2020,530800381,36650,6400,6400,6400,0,30250,30000,30000,0,0,250,250,0,0,0,0,0,0,2517,404,635,430,84,73
2020,530900221,30100,5100,4600,4600,500,25000,25000,0,25000,0,0,0,0,0,20000,0,0,0,1944,432,15,5,48,18
2020,530900231,200,200,50,50,150,0,0,0,0,0,0,0,0,0,0,0,0,0,609,96,30,24,36,1
2020,530900241,65920,920,920,920,0,65000,65000,25000,40000,0,0,0,0,0,4800,4800,4800,0,1442,180,230,360,72,82
2020,530900271,222218,21118,21118,11118,0,201100,201000,70000,131000,0,100,0,100,0,102292,99292,99292,0,2890,360,100,100,180,968
2020,530900281,42888,8888,8888,8888,0,34000,33000,33000,0,0,1000,1000,0,0,0,0,0,0,3025,150,6,600,192,164
2020,530900291,100456,14105,14105,14105,0,86351,84430,50000,30000,4430,1921,1051,870,0,33500,20000,20000,0,3760,300,100,100,250,313
2020,530900301,23489,9944,9944,8944,0,13545,9200,5500,3700,0,4345,1800,1545,1000,0,0,0,0,2369,488,510,230,84,61
2020,530900311,45712,36150,36150,36150,0,9562,9200,3800,5400,0,362,0,362,0,0,0,0,0,1911,182,180,120,44,89
2020,530900341,7080,80,80,80,0,7000,7000,7000,0,0,0,0,0,0,0,0,0,0,592,240,60,12,48,10
2020,530900351,22248,4498,4498,4498,0,17750,17000,17000,0,0,750,750,0,0,12416,12416,12400,0,4404,240,24,360,180,382
2020,530900361,147622,3922,922,922,3000,143700,135000,0,135000,0,8700,700,8000,0,125000,125000,120000,5000,3664,1044,240,360,240,174
2020,530900371,8928,1178,1178,1178,0,7750,7500,7500,0,0,250,250,0,0,0,0,0,0,985,180,36,180,78,36
2020,530900381,36010,29469,26969,15969,2500,6541,0,0,0,0,6541,3750,791,2000,500,500,500,0,3613,300,35,780,168,232
2020,531000212,5567,567,67,67,500,5000,5000,0,5000,0,0,0,0,0,0,0,0,0,2165,700,100,10,180,7
2020,531000232,45660,1060,1060,1060,0,44600,40000,40000,0,0,4600,4000,600,0,18100,18100,17000,0,4026,276,30,600,360,119
2020,531000252,215,215,15,15,200,0,0,0,0,0,0,0,0,0,4884,4884,0,4884,808,72,120,30,31,0
2020,531000262,7570,170,170,170,0,7400,6800,6800,0,0,600,600,0,0,0,0,0,0,3824,360,154,299,331,92
2020,531000272,56222,13058,13058,13058,0,43164,42000,42000,0,0,1164,480,684,0,0,0,0,0,4568,300,250,144,144,236
2020,531000292,43885,12650,12650,12650,0,31235,30000,30000,0,0,1235,670,565,0,18064,18064,18064,0,3197,240,69,482,180,197
2020,531000302,27530,11930,11930,10930,0,15600,15000,15000,0,0,600,600,0,0,0,0,0,0,5042,832,800,400,180,1017
2020,531000312,24003,4003,4003,4003,0,20000,18000,16000,2000,0,2000,2000,0,0,8000,8000,6800,1200,5558,744,144,240,264,453
2020,531000322,875,875,575,575,300,0,0,0,0,0,0,0,0,0,0,0,0,0,1470,380,10,100,72,3
2020,531000332,84954,20854,4854,4854,16000,64100,62600,0,60000,2600,1500,1500,0,0,18300,300,0,300,2865,300,75,360,240,439
2020,531000352,6970,170,170,170,0,6800,5000,5000,0,0,1800,1800,0,0,0,0,0,0,2930,360,120,180,250,138
2020,531000362,58076,17076,2076,2076,15000,41000,38000,0,38000,0,3000,3000,0,0,30000,15000,15000,0,3626,168,48,360,120,43
2020,531000372,6536,4496,2196,2196,2300,2040,0,0,0,0,2040,2000,40,0,2700,2700,1300,100,2752,360,5,120,180,51
2020,531000382,1137,1137,37,37,1100,0,0,0,0,0,0,0,0,0,0,0,0,0,1052,228,144,84,36,44
2020,531000392,4454,3528,2328,2328,1200,926,0,0,0,0,926,700,226,0,40,40,0,0,2142,288,120,360,84,28
2020,531600201,12610,2960,2960,2960,0,9650,9000,9000,0,0,650,650,0,0,2446,2446,1296,1000,1844,120,150,240,144,100
2020,531600231,45926,3626,3626,3626,0,42300,42000,42000,0,0,300,300,0,0,52,52,0,0,3077,250,87,310,210,116
2020,531600261,10,10,10,10,0,0,0,0,0,0,0,0,0,0,9450,9450,0,0,1092,360,72,120,72,13
2020,531600291,3600,3600,100,100,3500,0,0,0,0,0,0,0,0,0,0,0,0,0,632,156,36,50,24,1
2020,531600311,76240,5400,5400,5400,0,70840,70000,0,70000,0,840,490,350,0,1400,1000,0,1000,2052,560,180,240,100,56
2020,531600321,61190,8250,8250,8250,0,52940,43000,10000,33000,0,9940,1440,8500,0,17500,17500,0,15500,3444,312,180,480,300,30
2020,531600331,13000,3400,3400,3400,0,9600,9600,9600,0,0,0,0,0,0,0,0,0,0,648,130,84,24,20,15
2020,531600361,15712,2634,2634,2634,0,13078,9000,9000,0,0,4078,3400,678,0,6300,6300,6300,0,1900,360,120,240,280,84
2020,531600371,26894,11219,11219,11219,0,15675,14000,6000,8000,0,1675,1500,175,0,1500,1500,600,800,2692,300,10,550,242,226
2020,531600381,3200,200,200,200,0,3000,3000,3000,0,0,0,0,0,0,0,0,0,0,674,140,82,10,15,2
2020,531600391,106780,11390,11390,8790,0,95390,53000,39000,14000,0,42390,7390,25000,10000,60800,60800,60800,0,6470,680,150,750,630,664
2020,531700211,44237,6487,6487,6487,0,37750,33000,33000,0,0,4750,4750,0,0,17430,17430,15700,0,4275,325,250,200,300,920
2020,531700221,29130,11795,11795,11795,0,17335,17000,17000,0,0,335,135,200,0,0,0,0,0,2604,200,70,100,144,125
2020,531700231,10001,2301,2301,2301,0,7700,7000,7000,0,0,700,700,0,0,3000,3000,3000,0,1619,120,470,276,88,14
2020,531700241,1215,1215,715,715,500,0,0,0,0,0,0,0,0,0,2200,2200,0,1400,2889,545,380,36,266,57
2020,531700251,18822,5952,5952,4952,0,12870,12000,12000,0,0,870,570,300,0,5534,5534,5534,0,1096,99,10,252,150,61
2020,531700261,53530,7990,7990,7990,0,45540,40000,40000,0,0,5540,5540,0,0,0,0,0,0,6429,384,350,720,100,1284
2020,531700291,82133,1443,1443,1443,0,80690,79000,55000,24000,0,1690,1690,0,0,25820,25820,24400,0,1575,264,16,412,264,113
2020,531700321,11956,1806,1806,1806,0,10150,7500,7500,0,0,2650,2600,50,0,1200,1200,0,0,2320,480,70,360,300,843
2020,531700331,4897,4757,3757,3257,1000,140,0,0,0,0,140,140,0,0,1500,1500,0,1500,4073,880,150,400,360,64
2020,531700341,7010,10,10,10,0,7000,7000,7000,0,0,0,0,0,0,0,0,0,0,552,156,120,60,36,17
2020,531700371,12920,3630,3630,3630,0,9290,9000,9000,0,0,290,290,0,0,1800,1800,0,1800,2059,340,30,250,240,1186
2020,531700381,15637,6287,6287,6287,0,9350,9000,9000,0,0,350,0,350,0,6000,6000,6000,0,5040,240,40,400,360,798
2020,531700391,16442,3052,3052,3052,0,13390,13000,13000,0,0,390,390,0,0,8300,8300,8000,300,1280,120,100,300,80,94
2020,531800231,21716,1890,1890,1890,0,19826,19000,19000,0,0,826,700,126,0,2070,2070,2000,0,2630,650,30,340,240,70
2020,531800261,720,720,420,420,300,0,0,0,0,0,0,0,0,0,2880,2880,0,2600,1779,682,30,180,144,10
2020,531800271,75410,16660,16660,12660,0,58750,53100,30000,20000,3100,5650,1450,2500,1700,15327,15327,14800,0,2880,240,10,420,240,73
2020,531800281,26173,5323,5323,5323,0,20850,18000,18000,0,0,2850,2620,230,0,9806,9806,7650,0,3478,228,160,360,300,142
2020,531800291,16332,4111,4111,4111,0,12221,12000,5500,6500,0,221,0,221,0,400,0,0,0,926,163,10,10,58,15
2020,531800321,81605,5705,5705,3705,0,75900,75500,5000,70500,0,400,400,0,0,6000,0,0,0,2122,150,290,150,72,54
2020,531800331,2074,1724,1224,1224,500,350,0,0,0,0,350,350,0,0,390,390,390,0,2872,720,62,350,100,28
2020,531800341,10451,5851,3851,3851,2000,4600,0,0,0,0,4600,4600,0,0,16630,16630,0,8730,7244,864,100,600,420,305
2020,531800351,39832,10332,10332,10332,0,29500,26000,16000,10000,0,3500,3500,0,0,0,0,0,0,3494,300,10,360,144,1322
2020,531800361,77201,42401,42401,26901,0,34800,32000,32000,0,0,2800,2800,0,0,13160,13160,10160,3000,4520,320,50,600,350,1020
2020,531800381,85,85,85,85,0,0,0,0,0,0,0,0,0,0,0,0,0,0,447,144,108,20,22,1
2020,531800391,44401,50,50,50,0,44351,44000,14000,30000,0,351,350,1,0,2000,2000,0,600,666,150,100,130,36,23
2020,531900201,54955,9780,9780,9780,0,45175,45000,45000,0,0,175,0,175,0,17708,17708,17708,0,4240,300,400,70,150,63
2020,531900261,5900,5900,2400,2400,3500,0,0,0,0,0,0,0,0,0,0,0,0,0,536,94,20,1,51,11
2020,531900281,26176,1266,1266,1266,0,24910,21500,21500,0,0,3410,3410,0,0,19558,19558,15730,0,2760,360,150,500,300,94
2020,531900291,87320,320,320,320,0,87000,87000,27000,60000,0,0,0,0,0,10000,0,0,0,1322,144,88,54,36,284
2020,531900301,1313,1313,1013,1013,300,0,0,0,0,0,0,0,0,0,1720,1720,0,1720,1100,404,120,30,90,0
2020,531900311,31357,22170,14170,14170,8000,9187,6000,0,6000,0,3187,3100,87,0,0,0,0,0,3268,366,50,580,372,370
2020,531900321,10030,30,30,30,0,10000,10000,10000,0,0,0,0,0,0,0,0,0,0,620,144,230,20,36,9
2020,531900331,10,10,10,10,0,0,0,0,0,0,0,0,0,0,0,0,0,0,613,68,18,120,42,1
2020,531900351,31002,3202,3202,3202,0,27800,23400,23400,0,0,4400,3800,600,0,18260,18260,17580,0,7290,240,200,450,300,70
2020,531900381,15600,3150,3150,3150,0,12450,12200,7600,4600,0,250,250,0,0,900,0,0,0,3050,450,240,360,80,52
2020,531900391,33370,5360,5360,5360,0,28010,28000,4000,24000,0,10,0,10,0,0,0,0,0,1065,90,400,50,35,10
2020,532000212,3552,3552,3552,1552,0,0,0,0,0,0,0,0,0,0,5000,5000,0,5000,520,144,72,0,0,25
2020,532000242,64159,33959,2959,2959,31000,30200,29600,0,5000,24600,600,600,0,0,33620,33620,10000,23400,4214,420,100,180,204,29
2020,532000262,3856,3856,1556,1556,2300,0,0,0,0,0,0,0,0,0,600,600,0,0,2576,880,80,120,96,1
2020,532000282,3120,2920,2620,2620,300,200,0,0,0,0,200,200,0,0,0,0,0,0,1084,300,10,240,84,41
2020,532000302,25900,3400,3400,3400,0,22500,21600,7600,14000,0,900,900,0,0,0,0,0,0,1382,80,200,100,50,85
2020,532000312,59669,12259,12259,12259,0,47410,46210,12210,34000,0,1200,1200,0,0,0,0,0,0,1839,114,50,286,169,58
2020,532000322,27053,13593,13593,13593,0,13460,10580,5880,4700,0,2880,2880,0,0,0,0,0,0,3809,561,300,180,283,222
2020,532000332,2,2,2,2,0,0,0,0,0,0,0,0,0,0,300,300,0,0,1047,397,15,40,18,0
2020,532600201,9492,8542,4042,4042,4500,950,0,0,0,0,950,900,50,0,1800,1800,1800,0,2995,600,30,255,240,7
2020,532600211,33951,6218,6218,6218,0,27733,26000,26000,0,0,1733,1733,0,0,0,0,0,0,2210,300,60,150,300,221
2020,532600241,2330,2130,200,200,1930,200,0,0,0,0,200,200,0,0,2440,2440,0,1640,1164,240,24,180,60,40
2020,532600251,87676,26190,26190,26190,0,61486,60000,60000,0,0,1486,1258,228,0,0,0,0,0,2924,300,100,60,84,256
2020,532600261,29453,22925,8925,8825,14000,6528,6000,0,0,6000,528,300,228,0,5110,5110,0,5000,3029,432,116,580,181,57
2020,532600301,385872,38342,18342,18342,20000,347530,344000,0,340000,4000,3530,3530,0,0,186400,116400,109100,7000,6790,710,400,790,790,7844
2020,532600321,12564,2814,2814,2814,0,9750,9000,5000,4000,0,750,750,0,0,1104,1104,370,0,2206,168,300,410,288,36
2020,532600341,280,280,280,280,0,0,0,0,0,0,0,0,0,0,0,0,0,0,1122,360,56,24,52,1
2020,532700211,8896,8306,806,806,7500,590,0,0,0,0,590,590,0,0,3900,3900,3900,0,3030,420,10,350,240,44
2020,532700221,45710,3110,3110,3110,0,42600,42000,42000,0,0,600,600,0,0,21520,21520,21520,0,2020,240,60,120,120,159
2020,532700241,3500,3500,3000,1000,500,0,0,0,0,0,0,0,0,0,0,0,0,0,2545,672,660,216,300,22
2020,532700251,15030,3325,3325,3325,0,11705,11000,11000,0,0,705,650,55,0,0,0,0,0,2438,288,850,240,60,27
2020,532700261,35265,13925,8925,7925,5000,21340,15000,0,15000,0,6340,3000,3340,0,7900,7900,7000,0,2973,212,150,216,234,105
2020,532700271,2501,2171,1671,1671,500,330,0,0,0,0,330,100,230,0,1383,1383,0,1290,3448,618,40,600,288,114
2020,532700291,4815,4815,4515,4515,300,0,0,0,0,0,0,0,0,0,60,60,60,0,2212,516,150,300,120,1
2020,532700301,20010,2000,2000,2000,0,18010,18000,3000,15000,0,10,0,10,0,13730,4730,4730,0,1579,200,800,100,64,19
2020,532700311,30350,6550,6550,6550,0,23800,22000,2000,20000,0,1800,1800,0,0,1000,0,0,0,1805,244,240,270,65,46
2020,532700321,5350,1350,1350,1350,0,4000,4000,4000,0,0,0,0,0,0,0,0,0,0,857,130,170,70,20,15
2020,532700331,5058,4808,2858,2858,1950,250,0,0,0,0,250,250,0,0,40,40,0,0,2161,174,140,125,96,139
2020,532800221,59731,7680,7680,7380,0,52051,49000,49000,0,0,3051,1001,2050,0,3250,550,0,0,6032,860,720,830,582,71
2020,532800261,32784,1184,1184,1184,0,31600,30000,30000,0,0,1600,600,1000,0,12425,12425,11550,0,2656,270,338,144,60,90
2020,532800321,53050,16100,16100,16100,0,36950,36500,2500,34000,0,450,300,150,0,0,0,0,0,2299,402,866,120,115,263
2020,532800331,2830,30,30,30,0,2800,0,0,0,0,2800,2500,300,0,2300,2300,0,0,811,70,1,200,120,5
2020,532900201,71241,23306,23306,23306,0,47935,44000,29000,15000,0,3935,2935,1000,0,0,0,0,0,5902,420,120,480,192,720
2020,532900221,2354,2354,554,554,1800,0,0,0,0,0,0,0,0,0,0,0,0,0,1986,600,60,144,240,1
2020,532900231,13300,3300,3300,3300,0,10000,10000,10000,0,0,0,0,0,0,0,0,0,0,1010,160,20,130,130,11
2020,532900241,12011,1211,1211,1211,0,10800,9000,9000,0,0,1800,1800,0,0,6400,6400,3500,2000,2320,240,400,250,120,74
2020,532900251,39420,8220,8220,8220,0,31200,30000,30000,0,0,1200,1200,0,0,1500,1500,1500,0,4570,3300,486,100,72,441
2020,532900281,2410,2410,910,910,1500,0,0,0,0,0,0,0,0,0,0,0,0,0,3764,648,20,540,216,400
2020,532900291,13060,60,60,60,0,13000,13000,13000,0,0,0,0,0,0,0,0,0,0,277,80,20,5,12,3
2020,532900301,510,10,10,10,0,500,500,500,0,0,0,0,0,0,0,0,0,0,550,50,10,60,0,1
2020,532900311,2110,1200,1200,1200,0,910,900,900,0,0,10,0,10,0,0,0,0,0,593,90,120,25,36,3
2020,532900321,10025,1005,1005,1005,0,9020,8900,900,8000,0,120,40,80,0,0,0,0,0,1136,83,120,240,48,9
2020,532900331,41540,40,40,40,0,41500,41500,4000,37500,0,0,0,0,0,0,0,0,0,473,176,100,10,19,10
2020,533000202,30210,19910,3910,910,16000,10300,0,0,0,0,10300,2300,3000,5000,19044,19044,11700,5900,4184,240,100,240,240,41
2020,533000212,1520,1520,20,20,1500,0,0,0,0,0,0,0,0,0,0,0,0,0,932,150,150,20,12,1
2020,533000222,60200,1200,1200,1200,0,59000,59000,15000,44000,0,0,0,0,0,0,0,0,0,1110,150,300,50,50,11
2020,533600201,144498,42036,16036,16036,26000,102462,98402,0,98402,0,4060,3880,180,0,64495,14495,14495,0,3480,300,200,300,180,2833
2020,533600221,129039,19239,19239,19239,0,109800,105000,40000,65000,0,4800,4800,0,0,3000,0,0,0,1740,170,180,150,70,238
2020,533700211,255812,15230,230,230,15000,240582,238000,0,238000,0,2582,2582,0,0,35212,212,0,0,2096,276,70,400,150,416
2020,533900201,12550,4500,4500,4500,0,8050,8000,8000,0,0,50,0,50,0,0,0,0,0,420,80,10,24,36,27
2020,540000202,17840,2448,2448,2448,0,15392,15000,15000,0,0,392,320,72,0,0,0,0,0,1860,228,192,215,36,32
2020,540000212,281676,70876,70876,60876,0,210800,205000,75000,130000,0,5800,4900,900,0,62000,50000,50000,0,9846,720,120,920,480,3590
2020,540000222,27810,4909,4909,4909,0,22901,21000,21000,0,0,1901,1811,90,0,11740,11740,10000,1500,3912,241,442,114,181,260
2020,540000232,40844,17994,994,994,17000,22850,21000,0,21000,0,1850,1850,0,0,17100,100,0,0,2121,542,51,421,168,50
2020,540000242,23721,503,503,503,0,23218,21800,16800,5000,0,1418,1300,118,0,9100,9100,8000,1100,2780,243,352,255,36,94
2020,540000262,1097,1015,815,815,200,82,0,0,0,0,82,0,82,0,500,500,0,500,2702,132,24,180,204,20
2020,540000272,17452,2420,2420,2420,0,15032,13000,13000,0,0,2032,1450,582,0,3000,3000,0,3000,2528,156,55,600,96,57
2020,540000292,11624,1374,1374,1374,0,10250,10000,10000,0,0,250,250,0,0,5200,5200,5000,0,2983,144,72,481,132,567
2020,540000312,30869,2069,2069,2069,0,28800,26500,20000,6500,0,2300,2300,0,0,20310,20310,11770,8510,5904,300,177,600,316,1488
2020,540000322,28800,6500,1500,1500,5000,22300,22000,0,22000,0,300,300,0,0,15600,14600,14500,0,1260,120,120,180,120,70
2020,540000332,2660,2360,160,160,2200,300,0,0,0,0,300,300,0,0,0,0,0,0,2000,50,50,300,100,74
2020,540000342,17178,6278,6278,6278,0,10900,10500,10500,0,0,400,400,0,0,2650,2650,2650,0,2110,360,100,420,240,103
2020,540000362,11650,11650,3150,3150,8500,0,0,0,0,0,0,0,0,0,0,0,0,0,1430,180,50,240,120,494
2020,540000372,89952,17350,17350,15350,0,72602,72000,27000,45000,0,602,150,452,0,23300,21300,19000,2300,3926,336,100,240,300,903
2020,540000382,1150,750,750,750,0,400,0,0,0,0,400,400,0,0,0,0,0,0,1764,0,600,90,84,17
2020,540600201,218181,159866,159866,159866,0,58315,54000,54000,0,0,4315,3527,788,0,0,0,0,0,3695,362,183,348,96,8894
2020,540600231,51993,10770,10770,10770,0,41223,39623,20000,19623,0,1600,1600,0,0,13456,12456,9980,2176,2240,240,30,480,240,81
2020,540600251,56070,1731,1731,1731,0,54339,54000,36000,18000,0,339,0,339,0,18000,18000,18000,0,985,216,122,59,30,37
2020,540600261,41341,9586,9586,6886,0,31755,31300,31300,0,0,455,250,205,0,6250,6250,0,5180,3636,250,80,200,84,59
2020,540600271,16764,1264,1264,1264,0,15500,15500,15500,0,0,0,0,0,0,56,56,56,0,1562,354,721,57,92,13
2020,540600281,30798,6038,6038,6038,0,24760,22000,22000,0,0,2760,2650,110,0,11000,11000,11000,0,4884,300,400,450,144,431
2020,540600301,93094,9344,9344,9344,0,83750,57000,20000,37000,0,26750,1750,25000,0,3000,3000,3000,0,2790,790,250,380,50,163
2020,540600361,2500,2100,2100,2100,0,400,0,0,0,0,400,400,0,0,0,0,0,0,1659,144,5,340,240,197
2020,540600381,28450,15300,15300,15300,0,13150,13000,0,13000,0,150,150,0,0,750,0,0,0,1866,216,180,300,120,114
2020,540600391,174008,33832,33832,33832,0,140176,135000,25000,110000,0,5176,4950,226,0,23500,0,0,0,8402,420,310,360,264,2775
2020,540700221,9380,7180,7080,7080,100,2200,0,0,0,0,2200,2200,0,0,704,704,0,0,2151,420,24,180,132,554
2020,540700251,34393,4061,4061,4061,0,30332,29000,15000,14000,0,1332,230,1102,0,100,0,0,0,3564,192,120,276,144,29
2020,540700261,46625,7310,7310,7310,0,39315,36400,29000,0,7400,2915,2690,225,0,9364,9364,9334,0,3170,272,146,520,84,117
2020,540700281,28904,5476,5476,5476,0,23428,22400,22400,0,0,1028,950,78,0,2698,2698,0,2500,2284,210,40,400,250,195
2020,540700321,1040,1040,40,40,1000,0,0,0,0,0,0,0,0,0,0,0,0,0,434,71,120,18,8,1
2020,540700331,760,230,130,130,100,530,0,0,0,0,530,530,0,0,952,952,372,0,1426,396,40,120,240,48
2020,540700341,19174,3884,3884,3884,0,15290,15000,15000,0,0,290,290,0,0,0,0,0,0,4350,250,250,550,500,350
2020,540700371,145701,18521,18521,14521,0,127180,118000,90000,28000,0,9180,7000,2180,0,47086,32086,23310,8400,5302,480,110,341,240,1088
2020,540700391,26792,8702,8702,8702,0,18090,12200,10000,2200,0,5890,5890,0,0,6500,6500,0,2500,5616,156,50,380,300,95
2020,540800221,67465,13350,13350,13350,0,54115,52000,47000,5000,0,2115,1750,365,0,6000,0,0,0,6280,532,340,425,476,717
2020,540800251,16711,4311,4311,4311,0,12400,12000,12000,0,0,400,280,120,0,5529,3529,0,1489,1720,130,50,360,110,171
2020,540800261,112725,24215,24215,14215,0,88510,88000,18000,70000,0,510,90,420,0,60000,0,0,0,2566,540,60,290,96,99
2020,540800281,57625,12236,12236,12236,0,45389,31500,29500,2000,0,13889,2550,339,11000,0,0,0,0,3233,384,125,156,180,117
2020,540800301,41310,6080,6080,6080,0,35230,35000,20000,15000,0,230,200,30,0,200,200,0,200,721,116,45,37,60,7
2020,540800311,13740,13740,3740,3740,10000,0,0,0,0,0,0,0,0,0,6015,6015,6015,0,2354,150,84,240,120,1
2020,540800321,17250,600,600,600,0,16650,16500,10500,0,6000,150,150,0,0,0,0,0,0,1530,190,80,150,150,45
2020,540800331,27050,5050,5050,5050,0,22000,22000,22000,0,0,0,0,0,0,500,0,0,0,2669,1035,1000,60,30,79
2020,540800341,52605,6805,6805,6805,0,45800,44000,20000,24000,0,1800,1800,0,0,50,0,0,0,2650,250,200,300,400,1416
2020,540800381,21462,4962,4962,4962,0,16500,15000,15000,0,0,1500,1400,100,0,11064,11064,11064,0,3670,210,70,150,240,46
2020,540900201,1492,1221,221,221,1000,271,0,0,0,0,271,0,271,0,0,0,0,0,1167,528,126,62,59,5
2020,540900211,24976,4431,4431,4431,0,20545,20000,20000,0,0,545,370,175,0,1532,32,0,0,2050,164,53,480,216,111
2020,540900221,6846,6146,3646,3646,2500,700,0,0,0,0,700,700,0,0,60,60,0,0,2736,108,410,601,204,35
2020,540900231,25937,5199,5199,5199,0,20738,20000,20000,0,0,738,670,68,0,0,0,0,0,1408,119,47,152,111,29
2020,540900241,20700,4325,4325,4325,0,16375,16200,16200,0,0,175,0,175,0,0,0,0,0,1975,95,1020,18,62,105
2020,540900261,46308,8858,8858,8858,0,37450,36850,0,36850,0,600,600,0,0,23000,23000,23000,0,669,180,8,120,55,162
2020,540900271,23045,6175,6175,2175,0,16870,16000,16000,0,0,870,750,120,0,6954,6954,6954,0,1834,264,200,420,270,32
2020,540900281,31714,5846,5846,5846,0,25868,25100,17000,8100,0,768,670,98,0,5290,5290,5240,0,4677,990,259,550,360,418
2020,540900311,61000,1900,1900,1900,0,59100,57000,9000,48000,0,2100,2100,0,0,5000,0,0,0,1758,60,120,200,48,186
2020,540900321,12350,350,350,350,0,12000,12000,12000,0,0,0,0,0,0,0,0,0,0,960,160,150,50,40,27
2020,540900331,60357,18257,18257,15257,0,42100,37000,22000,15000,0,5100,5100,0,0,5000,5000,5000,0,4070,300,50,400,200,331
2020,540900341,9510,3460,3460,460,0,6050,4000,4000,0,0,2050,1800,250,0,1291,1291,1291,0,1384,120,110,50,140,337
2020,540900381,40175,2675,2675,2675,0,37500,28500,28500,0,0,9000,9000,0,0,3500,3500,3500,0,4354,505,1020,660,300,101
2020,540900391,65890,5890,5890,5890,0,60000,60000,60000,0,0,0,0,0,0,300,0,0,0,904,120,40,60,54,148
2020,541000202,131,131,81,81,50,0,0,0,0,0,0,0,0,0,500,500,0,500,1513,312,12,48,144,10
2020,541000222,12834,1252,1252,1252,0,11582,11500,11500,0,0,82,0,82,0,2500,0,0,0,4241,642,110,600,505,19
2020,541000242,41780,3240,3240,3240,0,38540,35000,10000,25000,0,3540,3440,100,0,5000,5000,5000,0,2570,240,96,600,168,578
2020,541000252,14563,563,563,563,0,14000,14000,10000,4000,0,0,0,0,0,0,0,0,0,852,125,121,62,36,154
2020,541000262,49997,10697,10697,10697,0,39300,38000,38000,0,0,1300,1300,0,0,1700,1700,1700,0,4237,321,602,252,243,421
2020,541000272,146887,8054,8054,8054,0,138833,137000,37000,100000,0,1833,1050,783,0,18000,10000,10000,0,2494,385,52,287,68,405
2020,541000302,16350,2350,2350,2350,0,14000,14000,6000,8000,0,0,0,0,0,0,0,0,0,1340,200,400,50,80,8
2020,541000312,150,150,150,150,0,0,0,0,0,0,0,0,0,0,0,0,0,0,621,69,120,36,18,1
2020,541000322,9890,590,590,590,0,9300,8500,8500,0,0,800,800,0,0,6920,6920,6500,180,2248,280,371,500,200,78
2020,541000332,5,5,5,5,0,0,0,0,0,0,0,0,0,0,0,0,0,0,525,120,100,40,25,1
2020,541000352,10,10,10,10,0,0,0,0,0,0,0,0,0,0,2200,2200,0,0,534,84,40,0,24,21
2020,541000362,1900,1900,400,400,1500,0,0,0,0,0,0,0,0,0,19,19,0,0,666,120,40,120,96,1
2020,541000372,7650,150,150,150,0,7500,7500,1500,6000,0,0,0,0,0,0,0,0,0,1822,150,650,180,96,108
2020,541600201,50201,11275,11275,11275,0,38926,36500,16500,20000,0,2426,2200,226,0,1000,0,0,0,3080,132,129,258,96,166
2020,541600221,24236,1586,1586,1586,0,22650,11400,11400,0,0,11250,1250,0,10000,0,0,0,0,1169,184,148,368,41,18
2020,541600241,157140,24564,24564,24564,0,132576,127000,35000,92000,0,5576,2350,3226,0,91400,91400,76400,0,4106,360,365,480,186,1210
2020,541600251,34897,11547,11547,11547,0,23350,22000,22000,0,0,1350,900,450,0,0,0,0,0,2957,264,121,307,186,448
2020,541600261,65135,14605,14605,14605,0,50530,48000,48000,0,0,2530,2400,130,0,20714,20714,19714,700,8763,444,405,720,240,920
2020,541600271,19016,2926,2926,2926,0,16090,16000,16000,0,0,90,70,20,0,0,0,0,0,1815,151,156,107,72,54
2020,541600281,30060,4030,4030,4030,0,26030,25000,25000,0,0,1030,900,130,0,6,6,0,0,2034,456,50,240,84,66
2020,541600291,1715,1365,65,65,1300,350,0,0,0,0,350,350,0,0,0,0,0,0,991,264,304,36,24,9
2020,541600301,51112,2801,2801,2801,0,48311,47711,47711,0,0,600,600,0,0,1494,294,0,0,1875,258,440,317,173,209
2020,541600331,8620,8620,1620,120,7000,0,0,0,0,0,0,0,0,0,0,0,0,0,1980,200,300,150,120,1
2020,541600381,104366,81360,81360,81360,0,23006,22000,14000,8000,0,1006,600,406,0,0,0,0,0,6755,360,210,350,75,7372
2020,541700201,13411,343,343,343,0,13068,13000,13000,0,0,68,0,68,0,0,0,0,0,946,125,351,55,22,13
2020,541700211,969,969,726,726,243,0,0,0,0,0,0,0,0,0,0,0,0,0,535,98,40,36,34,0
2020,541700221,13195,1071,1071,1071,0,12124,12000,12000,0,0,124,0,124,0,0,0,0,0,599,156,70,10,36,27
2020,541700241,27107,26087,12087,12087,14000,1020,0,0,0,0,1020,670,350,0,3500,3500,3500,0,3060,240,60,540,180,56
2020,541700281,33404,12069,12069,12069,0,21335,20000,20000,0,0,1335,1290,45,0,2700,2700,2700,0,3802,256,325,250,315,553
2020,541700291,50462,12120,12120,12120,0,38342,36000,36000,0,0,2342,1800,542,0,0,0,0,0,3320,300,120,240,240,383
2020,541700321,210840,55840,55840,55840,0,155000,153000,48000,105000,0,2000,2000,0,0,30000,0,0,0,5320,600,200,250,150,7190
2020,541700331,225,225,225,225,0,0,0,0,0,0,0,0,0,0,0,0,0,0,336,60,10,30,36,1
2020,541700351,20,20,20,20,0,0,0,0,0,0,0,0,0,0,0,0,0,0,1200,500,5,10,120,1
2020,541700371,14805,665,665,665,0,14140,14140,5000,9140,0,0,0,0,0,0,0,0,0,1524,180,400,60,24,14
2020,541800201,42495,10332,10332,10332,0,32163,28000,28000,0,0,4163,4000,163,0,11200,11200,11200,0,4634,324,50,720,240,503
2020,541800211,71458,25158,6658,6658,18500,46300,45000,0,45000,0,1300,1300,0,0,3300,1800,0,1800,1890,198,150,186,60,102
2020,541800221,275860,42960,42960,41960,0,232900,215000,66000,149000,0,17900,9200,8000,700,5000,0,0,0,6970,650,150,850,95,3331
2020,541800241,33757,8494,8494,8494,0,25263,24900,24900,0,0,363,0,363,0,0,0,0,0,2457,161,241,191,53,29
2020,541800271,4222,4161,2661,2661,1500,61,0,0,0,0,61,0,61,0,0,0,0,0,1682,216,123,102,96,47
2020,541800291,49313,2638,2638,1638,0,46675,46000,28000,18000,0,675,650,25,0,15000,0,0,0,4345,744,132,466,300,110
2020,541800311,20340,4790,4790,4790,0,15550,14000,14000,0,0,1550,1550,0,0,800,800,0,0,2660,280,300,440,180,165
2020,541800321,76042,17322,17322,17322,0,58720,57000,5000,52000,0,1720,0,1720,0,6000,6000,0,6000,1710,200,210,80,150,49
2020,541800331,38310,11460,11460,11460,0,26850,25000,20000,5000,0,1850,1700,150,0,0,0,0,0,4984,384,900,600,300,785
2020,541900201,4623,2092,2092,2092,0,2531,0,0,0,0,2531,1850,681,0,900,900,0,900,1673,75,87,215,102,49
2020,541900221,3957,2455,2455,2455,0,1502,0,0,0,0,1502,1400,102,0,0,0,0,0,2014,240,12,60,120,143
2020,541900231,9392,5992,5842,5842,150,3400,3000,0,0,3000,400,400,0,0,6200,6200,0,6200,1895,396,64,36,180,29
2020,541900261,19994,7159,7159,7159,0,12835,12600,12600,0,0,235,0,235,0,0,0,0,0,1925,200,1156,30,44,17
2020,541900271,32467,4467,4467,4467,0,28000,28000,28000,0,0,0,0,0,0,0,0,0,0,2981,361,605,187,123,49
2020,541900281,44038,14698,14698,14698,0,29340,28000,28000,0,0,1340,1000,340,0,1300,1300,0,1300,6333,362,121,625,314,1197
2020,541900291,20880,20130,7630,7630,12500,750,0,0,0,0,750,750,0,0,10200,10200,10000,200,1882,220,23,175,139,27
2020,541900301,12536,2536,2536,2536,0,10000,10000,5000,5000,0,0,0,0,0,0,0,0,0,792,150,50,12,30,11
2020,541900311,35850,9850,9850,9850,0,26000,25000,0,25000,0,1000,1000,0,0,3500,2500,2000,500,5690,360,180,850,400,89
2020,541900331,35819,1549,1549,1549,0,34270,33670,3000,30670,0,600,300,300,0,500,500,500,0,1411,142,108,364,77,42
2020,541900351,35329,4129,4129,4129,0,31200,28000,28000,0,0,3200,3200,0,0,15050,15050,15000,0,3800,420,550,360,100,801
2020,541900361,81492,35106,12106,12106,23000,46386,45260,0,0,45260,1126,900,226,0,5200,5200,0,5200,3163,336,69,308,120,1401
2020,541900371,35070,10000,10000,10000,0,25070,25000,25000,0,0,70,0,70,0,0,0,0,0,1250,100,200,100,50,21
2020,541900381,26820,10900,10900,5900,0,15920,15300,9000,6300,0,620,0,620,0,4000,4000,0,4000,3110,270,40,1500,300,168
2020,541900391,4258,4038,2088,2088,1950,220,0,0,0,0,220,220,0,0,0,0,0,0,1301,240,400,168,48,37
2020,542000202,33266,3282,3282,3282,0,29984,29000,29000,0,0,984,950,34,0,19000,19000,19000,0,1431,192,12,240,240,90
2020,542000212,14953,298,298,298,0,14655,14500,14500,0,0,155,0,155,0,0,0,0,0,861,168,60,10,35,36
2020,542000222,13678,1956,1956,1956,0,11722,11700,11700,0,0,22,0,22,0,1000,1000,1000,0,2949,331,21,241,204,70
2020,542000242,12440,12320,7820,4820,4500,120,0,0,0,0,120,120,0,0,3400,3400,0,3400,1950,240,60,300,240,110
2020,542000312,450,150,50,50,100,300,0,0,0,0,300,300,0,0,0,0,0,0,788,384,2,20,60,1
2020,542000322,16680,10080,10080,10080,0,6600,5500,5500,0,0,1100,800,300,0,0,0,0,0,1869,180,20,440,90,13
2020,542000332,13220,6316,6316,6316,0,6904,5000,5000,0,0,1904,0,1904,0,0,0,0,0,1846,235,300,100,84,6
2020,542000362,3938,438,438,438,0,3500,3500,3500,0,0,0,0,0,0,0,0,0,0,1472,186,310,72,84,2
2020,542600211,33376,4796,4796,4796,0,28580,27000,27000,0,0,1580,1530,50,0,11327,11327,8299,600,3383,237,10,407,369,252
2020,542600221,37127,6213,6213,6213,0,30914,30000,28000,2000,0,914,800,114,0,5362,5362,5362,0,3938,208,225,319,324,57
2020,542600301,12,12,12,12,0,0,0,0,0,0,0,0,0,0,0,0,0,0,573,90,80,115,18,1
2020,542600311,24520,9020,9020,7520,0,15500,11000,3500,7500,0,4500,1200,3300,0,7540,7540,240,5300,1872,142,30,260,255,37
2020,542600331,22700,1670,1670,1290,0,21030,20500,7800,12700,0,530,180,350,0,3000,3000,3000,0,1700,330,180,120,29,28
2020,542600341,16600,250,250,250,0,16350,16000,13000,3000,0,350,250,100,0,8000,8000,8000,0,1596,195,464,144,43,128
2020,542700211,60157,15194,15194,15194,0,44963,43300,43300,0,0,1663,1500,163,0,11333,11333,11333,0,5156,258,800,368,106,166
2020,542700221,52738,12063,12063,12063,0,40675,40000,40000,0,0,675,430,245,0,0,0,0,0,3391,312,120,168,132,106
2020,542700301,3990,560,560,560,0,3430,3430,3430,0,0,0,0,0,0,0,0,0,0,515,121,60,40,14,3
2020,542700311,1155,1155,1155,1155,0,0,0,0,0,0,0,0,0,0,0,0,0,0,1376,50,30,50,96,2
2020,542700331,29950,4350,4350,4350,0,25600,25600,4000,21600,0,0,0,0,0,0,0,0,0,847,118,12,10,77,29
2020,542700351,57193,343,343,343,0,56850,56000,10000,46000,0,850,0,850,0,0,0,0,0,412,128,84,0,30,43
2020,542700361,5312,4312,4312,4312,0,1000,0,0,0,0,1000,1000,0,0,6500,6500,0,6500,803,120,0,200,108,739
2020,542800201,36557,8247,8247,8247,0,28310,27000,27000,0,0,1310,1200,110,0,15584,15584,15584,0,3398,248,200,230,160,273
2020,542800221,3296,3208,608,608,2600,88,0,0,0,0,88,0,88,0,0,0,0,0,1127,288,191,122,61,1
2020,542800301,6000,1000,1000,1000,0,5000,5000,5000,0,0,0,0,0,0,0,0,0,0,496,180,60,18,54,4
2020,542800311,15320,320,320,320,0,15000,15000,0,15000,0,0,0,0,0,0,0,0,0,889,115,340,60,36,14
2020,542800331,32348,6298,6298,6298,0,26050,26000,5000,21000,0,50,0,50,0,0,0,0,0,1769,360,600,120,29,10
2020,542800341,17551,2321,2321,2321,0,15230,9420,1720,7700,0,5810,800,5010,0,1000,1000,0,0,828,72,6,120,60,16
2020,542800351,56032,21632,21632,21632,0,34400,34400,5000,29400,0,0,0,0,0,0,0,0,0,592,150,60,60,29,17
2020,542800381,12303,4090,4090,4090,0,8213,5500,5500,0,0,2713,2600,113,0,0,0,0,0,1424,240,24,240,120,336
2020,542800391,9142,3942,3942,2942,0,5200,0,0,0,0,5200,5200,0,0,13200,13200,0,10500,3270,240,60,840,360,508
2020,542900201,3555,3555,3095,3095,460,0,0,0,0,0,0,0,0,0,181,181,0,0,935,192,15,36,48,19
2020,542900231,30775,25559,14559,9559,11000,5216,0,0,0,0,5216,2200,3016,0,1220,1220,0,0,3373,324,479,544,144,95
2020,542900241,37957,5457,5457,3457,0,32500,30000,30000,0,0,2500,2500,0,0,4250,4250,0,4250,2306,156,120,480,180,335
2020,542900301,2728,2728,838,838,1890,0,0,0,0,0,0,0,0,0,1000,1000,0,0,1137,204,10,72,240,0
2020,542900311,16230,4230,4230,4230,0,12000,12000,12000,0,0,0,0,0,0,0,0,0,0,890,150,20,30,30,40
2020,542900331,14755,1455,1455,1455,0,13300,9000,0,9000,0,4300,3000,1300,0,7450,7450,5650,0,4513,360,70,700,400,624
2020,542900361,55201,22975,22975,22975,0,32226,29500,10300,19200,0,2726,2500,226,0,0,0,0,0,8765,1200,4540,600,65,114
2020,542900371,37974,28517,28517,28517,0,9457,8000,8000,0,0,1457,1118,339,0,0,0,0,0,1563,60,160,290,139,134
2020,542900381,983,983,683,683,300,0,0,0,0,0,0,0,0,0,530,530,0,0,1974,415,60,80,266,0
2020,543000302,33276,30076,30076,30076,0,3200,0,0,0,0,3200,3000,200,0,0,0,0,0,1814,100,120,384,60,229
2020,543000312,17524,7464,7464,7464,0,10060,8400,4000,4400,0,1660,1500,160,0,0,0,0,0,1238,104,60,120,60,30
2020,543000322,44390,1020,1020,1020,0,43370,40000,0,40000,0,3370,3300,70,0,20000,0,0,0,1070,84,120,240,60,133
2020,550000202,3119,2919,219,219,2700,200,200,0,200,0,0,0,0,0,50,50,0,0,936,63,20,24,15,3
2020,550000212,139024,14024,14024,14024,0,125000,125000,55000,70000,0,0,0,0,0,55000,40000,40000,0,4049,280,240,240,214,1154
2020,550000222,7550,5950,2950,2950,3000,1600,0,0,0,0,1600,1600,0,0,1000,1000,0,0,1770,396,24,240,120,58
2020,550000232,2170,1970,1970,1970,0,200,0,0,0,0,200,200,0,0,1000,1000,0,0,1155,175,120,180,90,8
2020,550000252,4160,3760,260,260,3500,400,0,0,0,0,400,400,0,0,11000,11000,0,11000,1240,70,150,200,120,76
2020,550000262,6200,4700,200,200,4500,1500,0,0,0,0,1500,1500,0,0,1886,1886,0,1886,2974,360,30,120,240,10
2020,550000272,13375,3375,3375,3375,0,10000,9000,9000,0,0,1000,1000,0,0,2000,2000,2000,0,936,120,150,120,36,36
2020,550000282,69957,5857,5857,5857,0,64100,52000,22000,30000,0,12100,2000,10100,0,20,20,0,0,2338,176,50,480,132,60
2020,550000292,23340,340,340,340,0,23000,23000,23000,0,0,0,0,0,0,0,0,0,0,981,300,32,72,76,20
2020,550000302,29710,19960,19960,19960,0,9750,9500,9500,0,0,250,250,0,0,0,0,0,0,1232,120,100,300,132,20
2020,550000312,29027,13147,13147,13147,0,15880,14000,14000,0,0,1880,1880,0,0,1000,1000,0,1000,4771,300,320,220,300,178
2020,550000322,2696,2485,485,485,2000,211,0,0,0,0,211,211,0,0,3550,3550,0,1550,2314,720,50,160,180,17
2020,550000342,11020,10020,520,520,9500,1000,0,0,0,0,1000,1000,0,0,6700,6700,6700,0,785,150,100,20,24,49
2020,550000352,57305,3305,3305,3305,0,54000,54000,44000,10000,0,0,0,0,0,3000,0,0,0,3105,250,240,360,360,307
2020,550000362,11348,5448,5148,3148,300,5900,0,0,0,0,5900,900,0,5000,1400,1400,0,0,2770,590,10,30,90,28
2020,550000372,27852,5952,5952,5952,0,21900,17000,17000,0,0,4900,4900,0,0,9500,9500,7000,1000,3766,240,20,720,276,162
2020,550000392,51740,7440,7440,7440,0,44300,40000,40000,0,0,4300,3300,0,1000,22000,22000,20000,2000,3750,250,30,600,240,956
2020,550600201,20070,270,270,270,0,19800,19800,19800,0,0,0,0,0,0,0,0,0,0,1190,100,200,60,70,25
2020,550600211,2280,1560,1060,1060,500,720,0,0,0,0,720,500,220,0,1598,1598,0,1520,878,94,10,144,60,17
2020,550600221,233,233,13,13,220,0,0,0,0,0,0,0,0,0,12000,12000,0,12000,1196,144,2,180,72,64
2020,550600241,40600,4100,4100,3600,0,36500,35000,35000,0,0,1500,1000,500,0,3800,3800,3800,0,4480,400,240,300,540,390
2020,550600291,24616,116,116,116,0,24500,24500,14500,10000,0,0,0,0,0,5000,4000,0,0,504,93,240,9,32,17
2020,550600301,28940,2140,2140,2140,0,26800,26500,18000,8500,0,300,300,0,0,3000,3000,0,3000,4552,230,60,360,312,45
2020,550600321,38347,20147,20147,19147,0,18200,16000,16000,0,0,2200,2200,0,0,650,650,0,0,1770,160,144,120,96,130
2020,550600331,13572,5742,5742,5742,0,7830,7500,7500,0,0,330,330,0,0,2550,2550,2550,0,2900,230,20,300,240,273
2020,550600361,12129,5071,5071,5071,0,7058,6000,6000,0,0,1058,900,158,0,0,0,0,0,1904,190,192,480,132,164
2020,550600371,15564,1484,1484,1484,0,14080,14000,14000,0,0,80,80,0,0,80,0,0,0,1550,216,36,135,60,63
2020,550600381,40456,13756,13756,13756,0,26700,25000,25000,0,0,1700,1350,350,0,0,0,0,0,5757,480,24,480,288,1042
2020,550600391,26170,9720,9720,7720,0,16450,14000,14000,0,0,2450,150,300,2000,0,0,0,0,2314,360,240,240,120,37
2020,550700201,6390,6310,6310,6310,0,80,0,0,0,0,80,0,80,0,0,0,0,0,457,204,15,8,18,1
2020,550700231,21279,9779,4479,4479,5300,11500,0,0,0,0,11500,1500,0,10000,7000,7000,3900,0,1620,280,30,60,120,29
2020,550700241,15580,4480,4480,4480,0,11100,10000,10000,0,0,1100,1100,0,0,4050,4050,4050,0,2630,204,200,720,216,41
2020,550700251,7560,60,60,60,0,7500,7500,7500,0,0,0,0,0,0,0,0,0,0,470,120,36,24,60,13
2020,550700261,4520,3020,520,520,2500,1500,0,0,0,0,1500,1500,0,0,4044,4044,0,2145,2000,180,36,50,240,440
2020,550700311,33035,6035,6035,6035,0,27000,27000,12000,15000,0,0,0,0,0,2745,2745,2745,0,1527,272,456,120,86,16
2020,550700321,6040,5640,1640,1640,4000,400,0,0,0,0,400,400,0,0,0,0,0,0,1353,300,24,60,144,7
2020,550700341,13787,3337,3337,3337,0,10450,10000,10000,0,0,450,450,0,0,1828,1828,0,1628,2746,640,1120,135,120,44
2020,550700351,31940,22140,22140,22140,0,9800,9800,9800,0,0,0,0,0,0,500,0,0,0,2585,110,2100,20,15,35
2020,550700361,33345,19945,19945,19945,0,13400,10000,10000,0,0,3400,3400,0,0,0,0,0,0,3976,300,20,270,150,285
2020,550700391,269668,17438,17438,4938,0,252230,192000,42000,150000,0,60230,2230,58000,0,129700,124700,120700,4000,6940,460,20,1200,460,2662
2020,550800201,6250,4250,4250,4250,0,2000,0,0,0,0,2000,2000,0,0,0,0,0,0,1920,700,10,300,120,147
2020,550800211,7170,170,170,170,0,7000,7000,7000,0,0,0,0,0,0,0,0,0,0,824,150,20,20,24,19
2020,550800221,10690,920,920,920,0,9770,9000,9000,0,0,770,770,0,0,0,0,0,0,1820,300,10,300,120,103
2020,550800231,1350,1350,1100,1100,250,0,0,0,0,0,0,0,0,0,0,0,0,0,646,160,12,60,36,0
2020,550800241,32175,8675,8675,8175,0,23500,21500,18000,3500,0,2000,0,1000,1000,900,100,0,0,2093,220,360,120,180,82
2020,550800251,8055,7655,4655,4655,3000,400,0,0,0,0,400,400,0,0,0,0,0,0,2020,400,300,300,220,27
2020,550800261,30,30,30,30,0,0,0,0,0,0,0,0,0,0,0,0,0,0,621,125,120,20,26,1
2020,550800271,47030,230,230,230,0,46800,45000,45000,0,0,1800,1800,0,0,2200,2200,2200,0,1139,276,100,120,33,86
2020,550800311,21739,6639,6639,6639,0,15100,14000,14000,0,0,1100,1100,0,0,4718,4718,3200,340,2170,310,20,400,180,39
2020,550800321,69062,41262,41262,41262,0,27800,27600,11000,3000,13600,200,200,0,0,13300,13300,0,13300,3489,204,50,315,160,110
2020,550800331,11150,150,150,150,0,11000,11000,11000,0,0,0,0,0,0,0,0,0,0,1350,210,50,50,110,8
2020,550800341,79830,400,400,400,0,79430,79000,18000,61000,0,430,430,0,0,38900,36900,26900,10000,6400,600,120,360,420,1112
2020,550800361,88748,27148,27148,27148,0,61600,57000,27000,30000,0,4600,4300,300,0,9320,9320,8000,0,3883,540,240,600,180,515
2020,550800391,63104,21790,21790,21790,0,41314,39800,25800,14000,0,1514,900,614,0,16000,16000,16000,0,2870,300,100,100,240,76
2020,550900211,7161,7011,6011,6011,1000,150,0,0,0,0,150,150,0,0,3000,3000,0,3000,2920,480,60,240,120,519
2020,550900221,7926,1426,1426,1426,0,6500,6500,6500,0,0,0,0,0,0,0,0,0,0,690,120,180,48,37,5
2020,550900241,430,340,20,20,320,90,0,0,0,0,90,90,0,0,7050,7050,0,7000,629,234,10,25,30,13
2020,550900251,81760,1660,1660,1160,0,80100,70000,70000,0,0,10100,7500,2100,500,40500,40000,40000,0,2646,300,10,360,216,118
2020,550900281,15267,3867,3867,2667,0,11400,9400,9400,0,0,2000,1500,500,0,0,0,0,0,2548,180,300,180,168,118
2020,550900291,39380,1580,1580,1580,0,37800,36000,30000,6000,0,1800,1800,0,0,16000,0,0,0,1142,240,200,120,72,122
2020,550900311,29900,25600,15600,15600,10000,4300,0,0,0,0,4300,4300,0,0,20000,20000,0,20000,3037,300,200,480,240,912
2020,550900321,38594,6044,6044,6044,0,32550,28000,11500,16500,0,4550,550,4000,0,1300,1300,0,1300,2552,192,30,250,200,71
2020,550900331,19124,7124,7124,7124,0,12000,10000,10000,0,0,2000,2000,0,0,0,0,0,0,2095,250,280,260,35,56
2020,550900351,9516,4516,4516,4516,0,5000,5000,5000,0,0,0,0,0,0,1200,1200,1200,0,2650,240,300,180,180,183
2020,550900381,96620,18820,18820,18820,0,77800,76000,21000,55000,0,1800,1800,0,0,0,0,0,0,6300,600,300,300,600,901
2020,550900391,13000,11800,9800,9800,2000,1200,0,0,0,0,1200,1200,0,0,540,540,0,0,5840,300,70,500,300,38
2020,551000202,11000,2700,2700,2700,0,8300,8000,8000,0,0,300,300,0,0,800,800,800,0,1149,84,30,100,65,128
2020,551000212,9068,7868,868,868,7000,1200,0,0,0,0,1200,700,500,0,1500,1500,0,0,3020,240,120,500,360,97
2020,551000222,31022,5772,5772,5772,0,25250,25000,25000,0,0,250,250,0,0,2000,0,0,0,2129,360,106,360,240,84
2020,551000232,14605,2605,2605,2605,0,12000,10000,10000,0,0,2000,2000,0,0,3776,3776,3776,0,1300,250,10,240,120,178
2020,551000242,112805,30305,30305,30305,0,82500,37000,37000,0,0,45500,5500,40000,0,12000,12000,12000,0,6605,457,240,936,420,117
2020,551000262,27078,13428,13428,13428,0,13650,12000,12000,0,0,1650,1650,0,0,0,0,0,0,2842,270,20,732,240,49
2020,551000272,40238,5308,5308,5308,0,34930,34000,34000,0,0,930,930,0,0,17330,17330,15000,2300,5056,126,120,180,60,978
2020,551000282,48580,6862,6862,6862,0,41718,41000,16000,25000,0,718,650,68,0,1778,1778,1778,0,7282,264,400,400,318,92
2020,551000292,15042,15042,6042,6042,9000,0,0,0,0,0,0,0,0,0,60,60,0,0,1707,240,7,200,80,43
2020,551000302,5020,20,20,20,0,5000,5000,5000,0,0,0,0,0,0,0,0,0,0,354,84,20,30,50,8
2020,551000312,6002,1002,1002,1002,0,5000,5000,5000,0,0,0,0,0,0,0,0,0,0,2070,200,20,150,250,14
2020,551000322,5672,2672,1672,1672,1000,3000,0,0,0,0,3000,3000,0,0,0,0,0,0,4130,720,200,600,360,1215
2020,551000352,11650,3350,3350,3350,0,8300,8000,5000,3000,0,300,300,0,0,0,0,0,0,742,100,30,180,72,36
2020,551000362,5398,348,348,348,0,5050,3000,3000,0,0,2050,1900,150,0,0,0,0,0,1494,80,20,60,84,3
2020,551000372,2964,664,164,164,500,2300,0,0,0,0,2300,2300,0,0,1500,1500,1500,0,2931,600,25,540,310,111
2020,551000392,28795,8195,8195,7695,0,20600,20000,8000,0,12000,600,600,0,0,10000,10000,5000,5000,4120,1052,500,360,240,197
2020,551600201,30850,5350,5350,5350,0,25500,20000,0,20000,0,5500,5500,0,0,500,0,0,0,2240,300,1000,120,100,573
2020,551600211,11810,110,110,110,0,11700,10000,10000,0,0,1700,1700,0,0,550,550,0,0,2420,300,60,480,180,62
2020,551600261,2790,1180,680,680,500,1610,0,0,0,0,1610,1610,0,0,3200,3200,0,3200,3640,720,60,750,280,38
2020,551600271,29140,5340,5340,5340,0,23800,23500,21000,2500,0,300,300,0,0,40,40,0,0,2409,240,500,100,84,38
2020,551600291,270,270,20,20,250,0,0,0,0,0,0,0,0,0,0,0,0,0,340,12,3,7,8,1
2020,551600311,39378,14168,14168,14168,0,25210,23000,20000,3000,0,2210,1470,740,0,0,0,0,0,1822,450,50,180,112,103
2020,551600321,63529,60229,42229,42229,18000,3300,2800,0,2800,0,500,500,0,0,0,0,0,0,7318,261,325,424,250,1127
2020,551600331,180,180,180,180,0,0,0,0,0,0,0,0,0,0,80,80,0,80,282,50,10,12,60,1
2020,551600361,18350,150,150,150,0,18200,17000,10000,7000,0,1200,1200,0,0,500,0,0,0,823,200,100,120,48,51
2020,551600371,22246,246,246,246,0,22000,19500,19500,0,0,2500,2500,0,0,11106,11106,7010,2700,3320,360,20,420,200,254
2020,551600381,33260,1400,1400,1400,0,31860,28000,9000,19000,0,3860,60,3800,0,5500,5500,5500,0,2336,150,400,250,116,67
2020,551700201,53090,13090,13090,13090,0,40000,40000,40000,0,0,0,0,0,0,0,0,0,0,1684,550,230,64,50,32
2020,551700211,1100,1100,100,100,1000,0,0,0,0,0,0,0,0,0,0,0,0,0,1294,100,1000,10,24,1
2020,551700241,17470,1270,1270,1270,0,16200,14000,14000,0,0,2200,2200,0,0,7950,7950,6700,0,2070,274,40,300,120,64
2020,551700251,10827,2560,2560,2560,0,8267,8000,8000,0,0,267,200,67,0,0,0,0,0,1950,240,184,320,102,31
2020,551700291,25678,2978,2978,2978,0,22700,20000,20000,0,0,2700,2700,0,0,2000,2000,2000,0,1973,420,70,600,120,2323
2020,551700301,86819,36250,36250,36250,0,50569,50000,10000,40000,0,569,230,339,0,0,0,0,0,1784,150,60,260,84,160
2020,551700331,6550,6550,6550,6550,0,0,0,0,0,0,0,0,0,0,0,0,0,0,2312,360,12,320,60,172
2020,551700351,7910,10,10,10,0,7900,7900,7900,0,0,0,0,0,0,0,0,0,0,449,154,36,15,20,2
2020,551700371,60010,8240,8240,8240,0,51770,50000,10000,40000,0,1770,1600,170,0,22100,19600,19600,0,3350,480,720,600,240,312
2020,551700391,15354,12174,12174,12124,0,3180,0,0,0,0,3180,3180,0,0,8400,8400,0,8400,4506,246,30,600,540,209
2020,551800201,68900,34500,34500,29500,0,34400,30000,17000,13000,0,4400,400,4000,0,4000,0,0,0,4060,480,800,350,230,2080
2020,551800211,29646,14046,14046,14046,0,15600,15000,15000,0,0,600,150,450,0,9000,9000,9000,0,4490,300,50,240,180,508
2020,551800221,5,5,5,5,0,0,0,0,0,0,0,0,0,0,0,0,0,0,645,120,156,48,36,1
2020,551800241,65220,11920,11920,11920,0,53300,49750,25000,24750,0,3550,3550,0,0,12000,12000,12000,0,4181,420,240,600,181,107
2020,551800271,10250,10250,9750,9750,500,0,0,0,0,0,0,0,0,0,0,0,0,0,1321,432,10,84,15,289
2020,551800281,36370,10770,10770,10770,0,25600,24950,20000,4950,0,650,450,200,0,0,0,0,0,2890,240,180,480,250,1486
2020,551800301,76028,2798,2798,2798,0,73230,73000,5000,68000,0,230,80,150,0,12000,12000,12000,0,1020,160,40,135,70,45
2020,551800311,21055,1615,1615,1615,0,19440,19200,7200,12000,0,240,0,240,0,0,0,0,0,888,160,48,35,60,11
2020,551800321,765,765,265,265,500,0,0,0,0,0,0,0,0,0,0,0,0,0,1110,300,50,10,60,0
2020,551800331,91532,19932,19932,19932,0,71600,65000,50000,15000,0,6600,3600,3000,0,0,0,0,0,4490,840,480,600,120,2722
2020,551800341,26535,10,10,10,0,26525,26500,3000,23500,0,25,0,25,0,8000,8000,2000,0,576,180,20,30,48,21
2020,551800351,1500,1500,300,300,1200,0,0,0,0,0,0,0,0,0,0,0,0,0,1578,300,42,120,36,1
2020,551800381,30,30,30,30,0,0,0,0,0,0,0,0,0,0,0,0,0,0,680,85,120,30,25,1
2020,551900201,4020,20,20,20,0,4000,4000,4000,0,0,0,0,0,0,2704,2704,1904,800,492,84,36,72,36,5
2020,551900211,19642,342,342,342,0,19300,16000,16000,0,0,3300,3300,0,0,8500,8500,6000,2500,1370,280,120,100,210,35
2020,551900221,35600,17100,1100,1100,16000,18500,18000,0,18000,0,500,500,0,0,80,80,0,0,1580,360,96,156,72,88
2020,551900231,49973,10015,10015,10015,0,39958,36000,22000,14000,0,3958,2900,1058,0,182,182,0,0,3056,456,180,240,180,127
2020,551900241,20740,2040,2040,2040,0,18700,18000,18000,0,0,700,700,0,0,0,0,0,0,1820,180,580,160,180,140
2020,551900251,15732,5332,5332,5332,0,10400,10000,10000,0,0,400,400,0,0,2220,2220,2220,0,2600,360,120,120,240,19
2020,551900271,8355,175,175,175,0,8180,8000,0,8000,0,180,180,0,0,0,0,0,0,1591,180,15,250,72,14
2020,551900281,48450,1650,1650,1650,0,46800,44000,15000,29000,0,2800,2800,0,0,0,0,0,0,2065,120,30,70,80,1012
2020,551900291,26315,5752,5752,5752,0,20563,20000,19000,1000,0,563,450,113,0,1300,1300,1300,0,1964,300,200,100,250,42
2020,551900311,650,50,50,50,0,600,500,500,0,0,100,0,100,0,0,0,0,0,483,50,50,20,18,2
2020,551900321,70800,500,500,500,0,70300,70000,0,70000,0,300,300,0,0,30000,30000,30000,0,1950,250,70,500,100,211
2020,551900331,45720,11320,11320,11320,0,34400,32000,10000,22000,0,2400,2400,0,0,1635,335,335,0,3450,200,150,150,50,154
2020,551900341,540,470,370,170,100,70,0,0,0,0,70,70,0,0,0,0,0,0,2027,473,44,420,360,9
2020,551900351,91370,41220,40000,40000,1220,50150,50000,0,50000,0,150,150,0,0,0,0,0,0,1508,120,50,150,168,74
2020,551900361,53858,17954,17954,17954,0,35904,30000,12000,18000,0,5904,3000,2904,0,12000,12000,12000,0,3968,288,300,420,360,960
2020,551900371,32250,9500,9500,9500,0,22750,22000,12000,10000,0,750,600,150,0,0,0,0,0,2300,276,50,360,204,245
2020,551900391,27018,2018,2018,2018,0,25000,25000,5000,20000,0,0,0,0,0,0,0,0,0,1804,235,360,240,101,26
2020,552000242,40170,14720,14720,14720,0,25450,23000,23000,0,0,2450,2450,0,0,4000,4000,4000,0,2136,360,100,240,156,1378
2020,552000272,36500,500,500,500,0,36000,36000,36000,0,0,0,0,0,0,3600,3600,3600,0,984,192,10,12,60,31
2020,552000282,290280,4780,4780,4780,0,285500,282000,42000,240000,0,3500,3000,500,0,8000,8000,0,8000,4408,300,80,360,48,5053
2020,552000292,45940,4240,4240,4240,0,41700,40000,40000,0,0,1700,1700,0,0,4800,4800,0,4800,3460,300,150,250,180,203
2020,552000302,6070,6000,1700,1700,4300,70,0,0,0,0,70,70,0,0,0,0,0,0,1266,290,36,180,60,21
2020,552000322,20500,3000,3000,3000,0,17500,15000,15000,0,0,2500,2500,0,0,0,0,0,0,1250,240,20,360,100,111
2020,552000342,17390,270,270,270,0,17120,17000,2000,15000,0,120,0,120,0,0,0,0,0,698,123,72,39,24,10
2020,552000352,24918,12168,12168,12168,0,12750,12000,12000,0,0,750,520,230,0,6920,6920,6920,0,3895,265,40,260,280,28
2020,552000362,3010,10,10,10,0,3000,3000,3000,0,0,0,0,0,0,0,0,0,0,1411,1000,50,10,48,5
2020,552000372,47855,10405,10405,10405,0,37450,34000,8000,26000,0,3450,3450,0,0,9833,9833,9833,0,4000,240,120,720,180,1774
2020,552000382,5030,30,30,30,0,5000,5000,5000,0,0,0,0,0,0,0,0,0,0,480,120,36,12,36,9
2020,552000392,9555,1455,1455,1455,0,8100,8000,5000,3000,0,100,100,0,0,0,0,0,0,920,136,36,120,108,25
2020,552600221,66528,12728,12728,12728,0,53800,50000,50000,0,0,3800,1700,2100,0,0,0,0,0,8000,300,1000,200,100,1519
2020,552600251,50251,5751,5751,5751,0,44500,43000,43000,0,0,1500,1500,0,0,20350,20350,19550,800,2370,240,80,220,160,201
2020,552600281,5190,5190,1190,1190,4000,0,0,0,0,0,0,0,0,0,0,0,0,0,972,180,24,60,72,7
2020,552600291,12090,1590,1590,1590,0,10500,10500,3500,7000,0,0,0,0,0,150,150,0,0,2344,150,120,72,204,58
2020,552600301,80650,9650,9150,5150,500,71000,64000,0,64000,0,7000,7000,0,0,24000,0,0,0,4386,350,120,540,186,138
2020,552600311,45885,14435,14435,14435,0,31450,27000,11000,16000,0,4450,4200,250,0,0,0,0,0,3330,240,10,360,240,167
2020,552600321,26950,2850,2850,2850,0,24100,11400,3000,8400,0,12700,200,12500,0,17000,17000,7000,5000,2300,240,240,240,120,21
2020,552600331,7680,180,180,180,0,7500,7500,2500,5000,0,0,0,0,0,0,0,0,0,780,60,150,80,30,6
2020,552600341,1300,1300,1300,1300,0,0,0,0,0,0,0,0,0,0,9136,9136,0,9136,850,70,100,180,70,1
2020,552600351,8740,570,570,570,0,8170,8000,8000,0,0,170,170,0,0,0,0,0,0,1030,180,140,60,40,14
2020,552600371,5100,600,600,600,0,4500,4500,4500,0,0,0,0,0,0,0,0,0,0,324,90,50,10,24,4
2020,552700201,67125,62779,14779,14779,48000,4346,3800,0,3800,0,546,546,0,0,21570,21570,0,0,8439,448,641,365,152,992
2020,552700211,26495,595,595,595,0,25900,24500,24500,0,0,1400,1400,0,0,28455,28455,17727,9400,7080,420,200,330,700,268
2020,552700241,57200,29500,29500,29500,0,27700,22000,22000,0,0,5700,700,0,5000,3000,3000,3000,0,1756,240,250,240,60,196
2020,552700271,66550,16150,16150,16150,0,50400,50000,50000,0,0,400,100,300,0,15000,15000,15000,0,1870,200,10,400,160,76
2020,552700291,7380,380,380,380,0,7000,7000,7000,0,0,0,0,0,0,0,0,0,0,524,290,60,10,24,11
2020,552700301,3740,3240,3240,3240,0,500,0,0,0,0,500,500,0,0,0,0,0,0,2278,108,170,360,120,32
2020,552700311,161057,15057,15057,15057,0,146000,121000,2000,119000,0,25000,1500,23500,0,9000,9000,5000,4000,4100,250,100,370,320,162
2020,552700331,30132,16602,11602,11602,5000,13530,13000,0,0,13000,530,200,330,0,13000,13000,0,13000,2508,192,500,650,156,310
2020,552700341,23900,3800,3800,3800,0,20100,19000,8500,10500,0,1100,0,1100,0,0,0,0,0,770,240,60,100,60,24
2020,552700351,19500,2500,2500,2500,0,17000,17000,8500,8500,0,0,0,0,0,0,0,0,0,379,130,50,30,24,6
2020,552800251,260,260,90,90,170,0,0,0,0,0,0,0,0,0,0,0,0,0,799,73,10,13,38,1
2020,552800291,15195,195,195,195,0,15000,15000,15000,0,0,0,0,0,0,0,0,0,0,3074,240,2160,168,46,43
2020,552800301,24373,6368,6368,6368,0,18005,15000,15000,0,0,3005,2890,115,0,3580,3580,3580,0,3190,240,30,280,230,252
2020,552800331,34517,9267,9267,9267,0,25250,21000,6000,15000,0,4250,4250,0,0,8,0,0,0,1877,160,85,300,192,155
2020,552800341,16360,11620,920,920,10700,4740,0,0,0,0,4740,4190,550,0,5977,5977,5977,0,1958,320,100,500,240,3
2020,552800351,68620,14060,14060,14060,0,54560,51000,3000,48000,0,3560,3060,500,0,0,0,0,0,1508,200,60,240,68,80
2020,552800361,13230,230,230,230,0,13000,13000,13000,0,0,0,0,0,0,0,0,0,0,908,158,350,12,48,11
2020,552900211,28200,28200,28200,200,0,0,0,0,0,0,0,0,0,0,37000,37000,22000,15000,5270,450,400,680,240,216
2020,552900221,23679,19179,2679,2679,16500,4500,0,0,0,0,4500,4500,0,0,16050,16050,10000,4000,3597,80,30,720,150,200
2020,552900241,58880,8080,8080,8080,0,50800,50000,50000,0,0,800,800,0,0,0,0,0,0,2670,240,50,150,140,535
2020,552900251,1470,1050,50,50,1000,420,0,0,0,0,420,420,0,0,0,0,0,0,1745,650,305,150,100,31
2020,552900271,25520,10420,10420,10420,0,15100,15000,15000,0,0,100,100,0,0,2300,2300,0,2300,2190,240,120,240,180,63
2020,552900301,5215,15,15,15,0,5200,5000,5000,0,0,200,200,0,0,1100,1100,1100,0,1190,136,360,20,24,15
2020,552900311,6070,70,70,70,0,6000,6000,6000,0,0,0,0,0,0,0,0,0,0,576,96,200,20,30,4
2020,552900321,10068,2188,2188,2188,0,7880,6000,6000,0,0,1880,1880,0,0,1200,1200,0,1200,1070,130,50,120,80,83
2020,552900331,19240,2210,2210,2210,0,17030,12000,12000,0,0,5030,4800,230,0,13707,13707,7757,0,2876,300,48,480,192,115
2020,552900341,1200,1200,1200,1200,0,0,0,0,0,0,0,0,0,0,0,0,0,0,438,72,36,15,15,11
2020,552900351,16700,3250,3250,3250,0,13450,12000,4000,8000,0,1450,950,500,0,0,0,0,0,1020,100,200,190,120,53
2020,553000202,45108,6808,6808,6808,0,38300,37000,37000,0,0,1300,1300,0,0,13200,13200,13200,0,3986,396,80,120,240,266
2020,553000222,38030,3580,3580,3580,0,34450,30000,15000,15000,0,4450,1450,0,3000,22000,22000,22000,0,2464,300,120,260,245,190
2020,553000232,94360,12960,12960,12960,0,81400,61500,11500,50000,0,19900,11400,8500,0,20600,15100,15000,0,4976,480,120,960,396,1246
2020,553800201,72422,35522,35522,35522,0,36900,34000,24000,10000,0,2900,2900,0,0,15,0,0,0,3650,300,500,180,80,611
2020,553900211,83900,4000,4000,3000,0,79900,45000,25000,20000,0,34900,2900,12000,20000,16200,16200,12000,4000,2437,132,12,173,294,202
2020,560000202,20948,9748,6748,6748,3000,11200,9500,0,9500,0,1700,1700,0,0,10800,1300,0,1300,4208,564,200,720,430,98
2020,560000212,16920,1920,1920,1920,0,15000,15000,15000,0,0,0,0,0,0,720,720,720,0,1313,360,80,120,48,63
2020,560000222,20700,1000,1000,1000,0,19700,16000,16000,0,0,3700,3700,0,0,0,0,0,0,2060,216,30,206,218,469
2020,560000232,49064,10564,10564,10564,0,38500,36000,36000,0,0,2500,2500,0,0,15000,15000,15000,0,3020,228,60,540,180,246
2020,560000242,5310,5010,1510,1510,3500,300,0,0,0,0,300,250,50,0,1100,1100,1100,0,2220,180,30,148,192,51
2020,560000252,3362,3162,2762,2762,400,200,0,0,0,0,200,200,0,0,2000,2000,0,0,610,60,66,60,60,31
2020,560000262,2430,2430,2430,2430,0,0,0,0,0,0,0,0,0,0,1400,1400,1200,200,2196,180,96,240,180,1
2020,560000272,58110,1910,1910,1910,0,56200,55000,55000,0,0,1200,1200,0,0,8900,8900,8700,0,4040,330,120,220,240,317
2020,560000292,44640,2940,2940,2940,0,41700,40000,0,40000,0,1700,1700,0,0,33030,6030,1230,4000,4180,300,200,260,240,386
2020,560000312,33500,10900,10900,10900,0,22600,22000,8000,14000,0,600,600,0,0,0,0,0,0,4812,900,240,480,252,47
2020,560000322,23400,700,700,700,0,22700,22000,6000,16000,0,700,700,0,0,0,0,0,0,1257,240,250,200,107,74
2020,560000352,119345,28145,28145,28145,0,91200,54000,31000,23000,0,37200,6500,30700,0,15800,5000,0,5000,8887,260,220,560,300,215
2020,560000362,16160,8060,8060,5060,0,8100,6000,0,0,6000,2100,2100,0,0,5112,5112,0,3632,3532,192,50,650,300,124
2020,560000372,35050,6860,6860,6860,0,28190,27000,27000,0,0,1190,1100,90,0,10050,10050,9960,0,2878,234,12,360,240,392
2020,560000382,34906,4730,4730,3430,0,30176,28500,26500,2000,0,1676,1450,226,0,0,0,0,0,2789,329,100,240,240,372
2020,560000392,74021,22371,22371,22371,0,51650,51000,20000,31000,0,650,650,0,0,9600,9600,0,9600,3370,240,60,180,240,1259
2020,560600201,2554,2554,1744,1744,810,0,0,0,0,0,0,0,0,0,0,0,0,0,2033,348,1000,70,100,1
2020,560600211,1606,1536,536,536,1000,70,0,0,0,0,70,70,0,0,800,800,0,0,1850,450,90,300,126,10
2020,560600231,30880,5180,5180,5180,0,25700,25000,25000,0,0,700,500,200,0,4100,3600,3600,0,3870,240,50,360,240,72
2020,560600261,107430,22530,22530,22530,0,84900,80000,80000,0,0,4900,3800,1100,0,29000,29000,29000,0,2434,360,24,120,300,1327
2020,560600281,1120,1120,120,120,1000,0,0,0,0,0,0,0,0,0,0,0,0,0,865,170,80,50,40,1
2020,560600321,18300,1000,1000,1000,0,17300,14000,14000,0,0,3300,2800,500,0,0,0,0,0,2960,360,320,500,240,75
2020,560600341,20650,6450,1200,1200,5250,14200,0,0,0,0,14200,14200,0,0,13500,13500,0,13500,2534,96,10,300,120,25
2020,560600351,10345,3158,3158,3158,0,7187,5000,5000,0,0,2187,2000,187,0,2800,2800,0,0,1590,550,50,250,120,162
2020,560600371,32550,2740,2740,740,0,29810,28300,9500,18800,0,1510,700,510,300,4082,4082,3700,0,4279,1098,300,178,360,70
2020,560600381,76975,11625,11625,11625,0,65350,50500,50500,0,0,14850,6500,5350,3000,8900,8900,0,7000,5185,756,60,500,360,301
2020,560600391,10239,9189,3730,3730,5459,1050,0,0,0,0,1050,1050,0,0,0,0,0,0,2296,222,240,360,72,258
2020,560700201,1370,1370,520,520,850,0,0,0,0,0,0,0,0,0,3280,3280,0,3280,1687,252,60,15,180,3
2020,560700211,41202,11902,11902,8902,0,29300,12000,12000,0,0,17300,3800,5500,8000,0,0,0,0,4650,340,800,340,320,374
2020,560700251,11920,6070,4070,4070,2000,5850,0,0,0,0,5850,5700,150,0,3025,3025,0,0,2365,360,10,380,200,126
2020,560700261,109100,18500,18500,18500,0,90600,83000,65000,18000,0,7600,7600,0,0,75440,43440,40000,0,3720,580,150,360,180,437
2020,560700271,40870,670,670,670,0,40200,40000,24000,16000,0,200,200,0,0,7500,7500,5000,2300,1910,200,200,500,100,106
2020,560700291,121558,25108,25108,14108,0,96450,87000,43000,44000,0,9450,100,350,9000,33380,5380,5380,0,3564,420,80,280,264,724
2020,560700321,4095,3895,195,195,3700,200,0,0,0,0,200,200,0,0,3430,3430,2400,0,1281,240,10,200,216,174
2020,560700331,20805,1785,1785,1285,0,19020,15620,12800,2820,0,3400,3400,0,0,0,0,0,0,4194,840,360,1000,144,695
2020,560700341,2262,262,262,262,0,2000,2000,2000,0,0,0,0,0,0,0,0,0,0,1412,200,80,156,116,2
2020,560700351,24800,15300,15300,11800,0,9500,9500,8000,1500,0,0,0,0,0,0,0,0,0,2992,140,200,150,240,289
2020,560700361,20310,10510,10510,10510,0,9800,9500,9500,0,0,300,300,0,0,2609,2609,2609,0,2614,200,40,360,156,53
2020,560700391,22700,12200,5200,5200,7000,10500,10000,0,10000,0,500,500,0,0,500,0,0,0,4216,228,200,726,282,19
2020,560800201,13342,442,442,442,0,12900,12900,12900,0,0,0,0,0,0,0,0,0,0,650,72,100,60,48,13
2020,560800211,11070,3270,1270,1270,2000,7800,6000,0,6000,0,1800,1800,0,0,300,0,0,0,1690,300,70,120,80,6
2020,560800221,37770,21270,21270,21270,0,16500,16500,8000,8500,0,0,0,0,0,0,0,0,0,1880,130,340,130,140,178
2020,560800231,158330,90500,90500,90500,0,67830,67000,67000,0,0,830,0,830,0,0,0,0,0,1650,276,180,60,84,414
2020,560800261,50900,300,300,300,0,50600,50000,50000,0,0,600,600,0,0,16500,11000,11000,0,1250,200,50,200,100,159
2020,560800271,41738,5238,5238,5238,0,36500,33000,28000,5000,0,3500,3400,100,0,8950,8950,8950,0,2850,300,200,200,250,234
2020,560800281,35530,8230,8230,8230,0,27300,27000,27000,0,0,300,300,0,0,2700,2700,1500,1200,3710,200,300,400,200,417
2020,560800291,37722,5652,5652,5652,0,32070,31000,31000,0,0,1070,1020,50,0,0,0,0,0,1686,300,120,240,96,63
2020,560800301,21600,500,500,500,0,21100,20000,20000,0,0,1100,1100,0,0,13000,13000,13000,0,2330,400,60,400,200,97
2020,560800311,14790,2790,2790,490,0,12000,12000,12000,0,0,0,0,0,0,8556,8556,7176,1340,3780,180,30,360,300,8
2020,560800341,79374,9840,9840,840,0,69534,58000,50000,8000,0,11534,1500,34,10000,9000,0,0,0,1606,126,50,100,60,158
2020,560800351,5420,220,220,220,0,5200,5200,4500,700,0,0,0,0,0,0,0,0,0,710,80,10,50,100,4
2020,560800361,12185,105,105,105,0,12080,12000,3000,9000,0,80,0,80,0,0,0,0,0,850,88,112,60,60,6
2020,560800381,31195,15925,15925,15925,0,15270,15000,15000,0,0,270,50,220,0,0,0,0,0,1858,312,96,280,120,109
2020,560800391,8150,7900,1900,1900,6000,250,0,0,0,0,250,250,0,0,4000,4000,4000,0,1634,50,350,360,84,73
2020,560900201,6544,6044,3044,3044,3000,500,0,0,0,0,500,500,0,0,3500,3500,1500,2000,1278,84,286,120,58,32
2020,560900221,26900,19050,15050,14050,4000,7850,0,0,0,0,7850,2700,150,5000,0,0,0,0,4950,2640,20,380,180,63
2020,560900241,32314,3214,3214,3214,0,29100,28000,18000,10000,0,1100,1000,100,0,3600,3600,3600,0,1180,240,10,240,80,54
2020,560900271,30254,4054,4054,4054,0,26200,25000,25000,0,0,1200,1200,0,0,9000,9000,9000,0,2360,450,80,100,60,79
2020,560900281,35632,8532,8532,8532,0,27100,27000,27000,0,0,100,100,0,0,0,0,0,0,1880,300,300,200,100,192
2020,560900331,36248,19048,19048,19048,0,17200,16900,16500,400,0,300,300,0,0,0,0,0,0,4170,246,1200,240,156,75
2020,560900341,79680,49960,49960,49760,0,29720,25000,25000,0,0,4720,3020,1100,600,6420,6420,6220,0,7022,300,300,260,216,349
2020,560900351,36244,8844,8844,8544,0,27400,25000,25000,0,0,2400,500,1900,0,1000,1000,1000,0,1259,192,48,300,86,64
2020,560900371,70794,16694,16694,16694,0,54100,51000,31000,20000,0,3100,2950,150,0,0,0,0,0,5608,360,700,600,240,1322
2020,560900381,19108,3308,3308,2308,0,15800,14000,14000,0,0,1800,1800,0,0,100,100,0,0,1856,232,200,250,84,67
2020,560900391,501,200,200,200,0,301,0,0,0,0,301,0,301,0,0,0,0,0,561,110,300,0,12,1
2020,561000212,21301,19571,2571,2571,17000,1730,0,0,0,0,1730,1600,130,0,0,0,0,0,3155,180,5,240,240,55
2020,561000232,18610,8460,8460,8460,0,10150,10000,10000,0,0,150,150,0,0,50,50,0,0,990,80,30,160,120,111
2020,561000242,31092,1640,1640,1640,0,29452,29000,29000,0,0,452,350,102,0,20820,20820,19800,0,3338,132,550,200,186,53
2020,561000282,30390,590,590,590,0,29800,25000,15000,10000,0,4800,4800,0,0,3000,3000,0,2000,2572,180,300,360,360,138
2020,561000302,161840,15130,15130,15130,0,146710,140500,45000,95500,0,6210,1200,5010,0,0,0,0,0,1831,278,46,460,74,410
2020,561000312,12078,2578,2578,2578,0,9500,7000,7000,0,0,2500,2500,0,0,2300,2300,0,0,1720,166,3,360,132,105
2020,561000322,34485,8046,8046,8046,0,26439,15000,15000,0,0,11439,4500,6939,0,7200,7200,2200,5000,3969,654,360,420,280,174
2020,561000332,42952,9098,9098,9098,0,33854,29000,22000,7000,0,4854,4430,424,0,1810,1810,0,1540,4274,330,224,540,372,136
2020,561000352,18500,17065,2115,2065,14950,1435,0,0,0,0,1435,1300,135,0,100,100,0,100,6312,600,270,720,480,1174
2020,561000362,7422,422,422,422,0,7000,7000,7000,0,0,0,0,0,0,0,0,0,0,780,138,195,36,62,7
2020,561000372,23915,7115,7115,7115,0,16800,15000,6000,9000,0,1800,600,1200,0,2800,2800,800,2000,1956,132,50,300,84,33
2020,561000382,232,166,166,166,0,66,0,0,0,0,66,0,66,0,0,0,0,0,516,130,60,20,36,1
2020,561000392,19326,926,926,926,0,18400,18400,18400,0,0,0,0,0,0,8000,8000,8000,0,2136,130,20,960,156,35
2020,561600211,822,472,472,472,0,350,0,0,0,0,350,250,100,0,0,0,0,0,1181,50,320,160,71,6
2020,561600251,94920,25220,25220,25220,0,69700,53000,48000,5000,0,16700,14500,2200,0,20000,20000,15000,5000,5050,480,150,480,200,1488
2020,561600301,70117,25249,25249,24749,0,44868,30500,30000,500,0,14368,5800,8068,500,15480,15480,12000,0,4135,288,165,485,276,280
2020,561600311,86473,16683,16683,16583,0,69790,67000,30000,37000,0,2790,290,2500,0,25600,25600,5000,0,3560,351,33,190,236,205
2020,561600321,25935,24620,4620,4620,20000,1315,0,0,0,0,1315,1150,165,0,6900,6900,6900,0,3920,252,50,300,334,96
2020,561600331,34040,2140,2140,2140,0,31900,29000,29000,0,0,2900,2250,650,0,18960,18960,14960,4000,3316,225,11,745,180,415
2020,561600361,8637,237,237,237,0,8400,8400,0,8400,0,0,0,0,0,0,0,0,0,852,60,348,72,24,13
2020,561600371,117606,46443,46443,46443,0,71163,43000,8000,35000,0,28163,4100,24063,0,25300,25300,25000,0,3491,737,305,370,228,230
2020,561600381,560,560,10,10,550,0,0,0,0,0,0,0,0,0,0,0,0,0,629,408,0,5,12,1
2020,561600391,36460,160,160,160,0,36300,36000,0,36000,0,300,0,300,0,1200,1200,0,500,1196,116,492,48,30,41
2020,561700211,42324,6824,6824,6824,0,35500,29000,20000,9000,0,6500,6500,0,0,0,0,0,0,2020,240,120,360,120,83
2020,561700261,4813,4720,3780,3780,940,93,0,0,0,0,93,0,93,0,4000,4000,4000,0,745,72,5,60,48,1
2020,561700291,3340,3340,3140,3140,200,0,0,0,0,0,0,0,0,0,0,0,0,0,1501,600,35,20,36,1
2020,561700301,25776,7446,7446,7446,0,18330,17000,9000,8000,0,1330,830,500,0,1100,1100,0,1040,2230,240,50,460,360,78
2020,561700311,213498,171318,171318,171318,0,42180,28000,28000,0,0,14180,4680,9500,0,2527,2527,0,2527,2975,380,5,540,120,2366
2020,561700371,330,330,330,330,0,0,0,0,0,0,0,0,0,0,0,0,0,0,470,90,60,18,28,4
2020,561700381,8750,170,170,170,0,8580,8580,700,7880,0,0,0,0,0,0,0,0,0,465,90,30,30,5,5
2020,561700391,305,305,305,305,0,0,0,0,0,0,0,0,0,0,0,0,0,0,381,84,31,24,25,1
2020,561800201,75131,9531,9531,9531,0,65600,65000,65000,0,0,600,600,0,0,12200,11000,11000,0,4042,400,70,400,172,623
2020,561800221,14262,2012,2012,2012,0,12250,11000,11000,0,0,1250,1200,50,0,4000,4000,4000,0,2540,300,150,100,150,128
2020,561800231,12780,3760,3760,3760,0,9020,8500,8500,0,0,520,470,50,0,3822,3822,3762,0,2198,264,60,120,204,44
2020,561800241,22730,18330,1330,830,17000,4400,0,0,0,0,4400,3400,1000,0,15220,15220,14500,0,3274,204,10,960,144,101
2020,561800251,16032,7332,7332,7332,0,8700,8400,8400,0,0,300,300,0,0,9700,9700,3400,6300,10036,216,1900,84,540,46
2020,561800261,27532,3152,3152,3152,0,24380,21560,20000,1560,0,2820,2720,100,0,3000,3000,3000,0,2740,350,100,600,320,405
2020,561800271,25240,2240,2240,2240,0,23000,21500,21500,0,0,1500,1300,200,0,6000,6000,6000,0,3485,320,60,500,135,737
2020,561800281,18200,900,900,900,0,17300,16000,16000,0,0,1300,1300,0,0,3100,3100,0,3100,2046,276,300,120,160,96
2020,561800311,43501,29375,23375,23375,6000,14126,11000,0,11000,0,3126,2900,226,0,1800,1800,0,1800,4767,240,12,300,480,329
2020,561800341,17085,1040,1040,1040,0,16045,16000,9000,7000,0,45,45,0,0,80,80,0,0,2742,186,240,290,206,30
2020,561800351,19210,7300,7300,7300,0,11910,9100,3500,5600,0,2810,2300,510,0,0,0,0,0,1296,180,84,360,120,72
2020,561800361,23932,612,612,612,0,23320,23000,23000,0,0,320,320,0,0,1080,1080,0,800,3198,300,96,240,216,234
2020,561800371,72232,36766,36766,36766,0,35466,32000,28000,4000,0,3466,3025,441,0,0,0,0,0,8203,302,122,901,396,942
2020,561900221,4060,4060,60,60,4000,0,0,0,0,0,0,0,0,0,0,0,0,0,675,50,120,40,15,1
2020,561900241,71200,4300,4300,4300,0,66900,65500,13500,52000,0,1400,900,500,0,0,0,0,0,756,120,50,150,72,56
2020,561900251,4005,4005,5,5,4000,0,0,0,0,0,0,0,0,0,0,0,0,0,560,120,60,36,84,1
2020,561900261,26320,12070,70,70,12000,14250,10000,0,10000,0,4250,4250,0,0,14360,7360,7360,0,1700,280,40,600,60,387
2020,561900281,35260,6580,6580,5580,0,28680,26000,26000,0,0,2680,2450,230,0,10000,10000,10000,0,4036,276,120,360,240,124
2020,561900301,5090,490,490,490,0,4600,4600,4600,0,0,0,0,0,0,20,20,0,0,955,168,180,96,84,12
2020,561900311,9076,5031,5031,5031,0,4045,4000,4000,0,0,45,45,0,0,0,0,0,0,1537,220,9,236,72,22
2020,561900321,18882,902,902,902,0,17980,14480,2000,12480,0,3500,0,3500,0,0,0,0,0,2004,212,830,67,76,46
2020,561900331,11790,4264,4264,4264,0,7526,6100,5100,1000,0,1426,1200,226,0,0,0,0,0,2680,98,700,480,206,57
2020,561900341,20203,2103,2103,2103,0,18100,18000,18000,0,0,100,0,100,0,10712,10712,10712,0,2214,240,10,536,240,25
2020,561900361,64250,15150,14150,12650,1000,49100,48000,0,48000,0,1100,100,1000,0,1000,0,0,0,3243,1730,40,318,260,81
2020,561900381,19470,8570,8570,8570,0,10900,10500,1500,9000,0,400,0,400,0,500,500,0,500,982,150,146,60,90,5
2020,561900391,25190,3550,3550,3550,0,21640,18400,10000,8400,0,3240,2340,900,0,140,140,0,0,1980,70,100,300,100,75
2020,562000302,52220,7984,7984,7984,0,44236,41420,6420,35000,0,2816,1100,1716,0,0,0,0,0,1138,240,336,96,50,15
2020,562000312,15201,2534,2534,2534,0,12667,10000,10000,0,0,2667,0,2667,0,0,0,0,0,1319,180,22,10,146,3
2020,562000322,27761,10501,10501,10156,0,17260,16900,14000,2900,0,360,300,60,0,1800,1800,1000,800,4690,240,500,200,360,432
2020,562000342,96350,21968,21968,21968,0,74382,71000,2000,69000,0,3382,910,2472,0,0,0,0,0,1533,201,55,50,61,23
2020,562000352,24984,9084,9084,9084,0,15900,14500,8500,6000,0,1400,1200,200,0,400,400,0,400,2634,120,150,480,144,329
2020,562000362,1000,300,300,300,0,700,700,700,0,0,0,0,0,0,0,0,0,0,210,54,60,2,4,2
2020,562000372,8236,5536,5536,5536,0,2700,2700,700,2000,0,0,0,0,0,0,0,0,0,529,80,120,47,24,11
2020,562600301,16946,1946,1946,1946,0,15000,15000,0,15000,0,0,0,0,0,0,0,0,0,1279,115,156,24,29,16
2020,562600341,2233,1559,1559,1559,0,674,650,500,150,0,24,0,24,0,0,0,0,0,389,120,10,17,22,2
2020,562600351,27100,16960,16960,16960,0,10140,5500,5500,0,0,4640,640,0,4000,6900,6900,3900,3000,2215,180,60,365,115,79
2020,562600361,7620,4100,4100,4100,0,3520,2700,0,2700,0,820,700,120,0,9500,9500,6500,0,4696,858,20,600,360,60
2020,562600371,45550,11850,11850,11850,0,33700,31200,17000,0,14200,2500,2500,0,0,10600,10600,0,10600,2326,216,10,240,150,626
2020,562700301,29254,3334,3334,3334,0,25920,15420,3000,12420,0,10500,300,10200,0,10200,10200,0,1700,2370,300,180,250,200,40
2020,562700311,1528,528,528,528,0,1000,1000,1000,0,0,0,0,0,0,0,0,0,0,381,60,20,20,6,1
2020,562700321,23401,12926,12926,12926,0,10475,9225,1500,7725,0,1250,300,950,0,0,0,0,0,979,155,170,250,50,12
2020,562700331,5053,29,29,29,0,5024,5000,5000,0,0,24,0,24,0,0,0,0,0,691,104,13,10,50,17
2020,562700351,24950,9700,9700,9700,0,15250,15100,10300,4800,0,150,0,150,0,0,0,0,0,912,120,120,240,60,5
2020,562700361,51901,3201,3201,3201,0,48700,44700,3900,40800,0,4000,500,3500,0,1260,1260,0,1260,2340,240,60,240,60,92
2020,562700371,268,178,178,178,0,90,0,0,0,0,90,0,90,0,0,0,0,0,476,72,30,20,24,1
2020,562800301,20760,630,630,630,0,20130,19630,0,19630,0,500,500,0,0,0,0,0,0,2180,170,270,230,120,87
2020,562800321,21608,5008,5008,5008,0,16600,15100,5000,10100,0,1500,700,800,0,7500,7500,4000,3500,867,30,20,120,72,11
2020,562800341,55267,8914,8914,8914,0,46353,43500,35000,8500,0,2853,2401,452,0,18085,18085,12000,6000,5940,276,156,420,384,1135
2020,562800351,9452,5362,5362,5362,0,4090,3900,2800,1100,0,190,140,50,0,0,0,0,0,1964,160,24,240,120,27
2020,562800361,53018,7518,7518,7518,0,45500,43100,0,43100,0,2400,1700,700,0,0,0,0,0,1907,125,120,350,106,144
2020,562900301,3510,150,150,150,0,3360,1500,1500,0,0,1860,1800,60,0,0,0,0,0,811,100,40,180,38,5
2020,562900311,2420,420,420,420,0,2000,2000,2000,0,0,0,0,0,0,0,0,0,0,698,85,120,24,24,6
2020,562900321,22788,5308,5308,5308,0,17480,16200,16200,0,0,1280,1280,0,0,0,0,0,0,1487,208,56,190,105,103
2020,562900331,116725,13887,13887,13887,0,102838,76550,17800,58750,0,26288,2150,24138,0,5000,0,0,0,2762,219,63,251,193,97
2020,562900341,28141,12051,12051,12051,0,16090,14000,14000,0,0,2090,2000,90,0,6413,6413,6413,0,2130,240,120,600,120,33
2020,562900351,10435,8440,6440,4440,2000,1995,1000,0,1000,0,995,950,45,0,1000,1000,0,1000,1998,152,50,100,96,38
2020,562900361,13830,4230,4230,4230,0,9600,7500,7500,0,0,2100,900,1200,0,14500,14500,10000,3500,3180,520,510,400,216,17
2020,570000302,18050,11750,11750,11750,0,6300,3000,3000,0,0,3300,3200,100,0,0,0,0,0,5770,240,50,1000,480,369
2020,570000312,20240,3440,3440,3440,0,16800,16600,13600,3000,0,200,200,0,0,0,0,0,0,2014,232,120,180,180,229
2020,570000322,25795,4795,4795,4795,0,21000,19000,13000,6000,0,2000,2000,0,0,0,0,0,0,1402,142,84,180,120,108
2020,570000332,7591,521,521,521,0,7070,6600,6600,0,0,470,400,70,0,200,200,200,0,528,55,96,84,60,11
2020,570000342,80868,36508,36508,36008,0,44360,44000,25000,19000,0,360,250,110,0,0,0,0,0,5016,435,240,320,240,487
2020,570000352,16791,211,211,211,0,16580,16500,16500,0,0,80,0,80,0,3500,3500,3500,0,3495,1680,500,150,144,31
2020,570000372,7410,910,410,410,500,6500,4500,0,4500,0,2000,2000,0,0,2250,2250,2250,0,4491,480,120,480,240,53
2020,570000382,32860,8460,8460,8460,0,24400,22800,15000,7800,0,1600,1600,0,0,0,0,0,0,3166,360,600,720,96,519
2020,570000392,44950,13500,13500,13500,0,31450,31450,12000,19450,0,0,0,0,0,0,0,0,0,848,160,100,60,128,21
2020,570600311,87279,53459,53459,47459,0,33820,28000,28000,0,0,5820,4900,920,0,300,300,0,0,9160,360,1200,1000,400,1296
2020,570600331,62922,10696,10696,9832,0,52226,50000,50000,0,0,2226,2000,226,0,25070,17070,15000,2070,2484,360,50,240,274,97
2020,570600341,310,310,10,10,300,0,0,0,0,0,0,0,0,0,1340,1340,440,0,834,78,120,50,24,11
2020,570600351,14604,4604,4604,4604,0,10000,8000,4000,4000,0,2000,2000,0,0,1156,1156,1156,0,3600,360,360,240,360,21
2020,570600361,1066,966,966,966,0,100,0,0,0,0,100,100,0,0,0,0,0,0,1095,0,50,240,60,39
2020,570600371,4015,515,515,515,0,3500,3500,3500,0,0,0,0,0,0,0,0,0,0,854,240,180,30,24,14
2020,570700301,11002,2,2,2,0,11000,11000,6000,5000,0,0,0,0,0,0,0,0,0,208,33,3,3,11,6
2020,570700311,25160,5920,5920,5920,0,19240,19000,19000,0,0,240,240,0,0,7000,7000,7000,0,4090,1000,10,120,300,214
2020,570700331,18052,7252,7252,7252,0,10800,10000,10000,0,0,800,800,0,0,550,550,0,0,3052,288,250,400,144,55
2020,570700351,71844,19824,19824,19824,0,52020,49000,19000,30000,0,3020,2900,120,0,0,0,0,0,2780,360,150,500,240,252
2020,570700371,17410,3060,3060,3060,0,14350,12000,12000,0,0,2350,2350,0,0,8200,8200,7500,0,7550,420,250,450,550,664
2020,570700391,25470,2670,2670,2670,0,22800,22000,14000,8000,0,800,800,0,0,0,0,0,0,860,60,300,60,48,46
2020,570800301,26432,17632,3732,3732,13900,8800,5500,0,5500,0,3300,1700,1600,0,9500,9000,9000,0,2470,240,20,480,180,89
2020,570800331,30,30,30,30,0,0,0,0,0,0,0,0,0,0,0,0,0,0,318,46,60,20,12,1
2020,570800341,34948,9848,9848,6848,0,25100,23000,23000,0,0,2100,2100,0,0,9000,9000,9000,0,2110,180,10,500,300,251
2020,570800361,53200,19500,19500,19500,0,33700,32000,9000,23000,0,1700,300,1400,0,0,0,0,0,3740,480,300,240,140,126
2020,570800381,8746,5346,4846,4846,500,3400,0,0,0,0,3400,1200,0,2200,0,0,0,0,2814,384,170,800,150,32
2020,570900301,4925,4675,4475,4475,200,250,0,0,0,0,250,0,250,0,0,0,0,0,2430,480,20,30,300,1
2020,570900311,7410,850,850,850,0,6560,6500,4000,2500,0,60,0,60,0,900,900,900,0,1492,250,50,120,90,7
2020,570900321,11727,3001,3001,3001,0,8726,8500,8500,0,0,226,0,226,0,0,0,0,0,955,110,500,50,50,31
2020,570900331,62002,14172,14172,14172,0,47830,46000,20000,26000,0,1830,1600,230,0,1300,1300,1000,300,2963,540,500,290,96,39
2020,570900341,2560,2560,1360,1360,1200,0,0,0,0,0,0,0,0,0,0,0,0,0,900,240,10,160,60,1
2020,570900361,3200,800,800,800,0,2400,1800,1800,0,0,600,600,0,0,0,0,0,0,968,96,10,120,72,82
2020,570900371,3040,3040,3040,3040,0,0,0,0,0,0,0,0,0,0,0,0,0,0,684,100,280,15,18,1
2020,570900381,60392,9642,8642,5642,1000,50750,50000,0,50000,0,750,750,0,0,13200,13200,11700,1500,6450,500,300,1200,500,1487
2020,570900391,13720,11820,5320,5320,6500,1900,0,0,0,0,1900,1900,0,0,0,0,0,0,2280,250,30,400,120,113
2020,571000302,20359,16649,14649,14479,2000,3710,3000,0,3000,0,710,620,90,0,0,0,0,0,1385,265,100,400,40,32
2020,571000352,44000,1600,1600,1600,0,42400,42000,8000,34000,0,400,400,0,0,2700,2700,0,2700,3250,310,1320,70,160,17
2020,571000382,7670,7670,7470,7470,200,0,0,0,0,0,0,0,0,0,0,0,0,0,1459,476,5,120,48,119
2020,571000392,2500,500,500,500,0,2000,2000,2000,0,0,0,0,0,0,0,0,0,0,440,100,240,20,0,4
2020,571600301,24108,12108,2208,2208,9900,12000,9000,0,9000,0,3000,3000,0,0,14920,7920,7920,0,3090,450,30,600,250,74
2020,571600321,17402,5202,5202,5202,0,12200,10000,10000,0,0,2200,1900,300,0,6500,5000,5000,0,2280,160,50,500,240,132
2020,571600351,36244,1544,1544,1544,0,34700,33500,23500,10000,0,1200,1200,0,0,16500,16500,15500,500,3120,500,100,100,100,46
2020,571600361,12404,104,4,4,100,12300,12000,0,12000,0,300,300,0,0,7405,7405,0,7105,1920,240,80,240,200,85
2020,571600371,1028,998,798,798,200,30,0,0,0,0,30,30,0,0,1154,1154,570,584,2042,328,255,198,124,8
2020,571600381,56090,1090,1090,1090,0,55000,44000,3000,41000,0,11000,2000,9000,0,8500,8500,3800,4700,2305,210,500,450,100,35
2020,571600391,78150,2200,2200,2200,0,75950,59000,13000,46000,0,16950,8950,8000,0,15000,15000,15000,0,3660,400,240,500,120,149
2020,571700301,11540,3360,3360,3360,0,8180,8000,8000,0,0,180,0,180,0,330,330,300,0,754,144,200,12,48,5
2020,571700321,33256,11256,11256,11256,0,22000,18000,18000,0,0,4000,4000,0,0,6500,6500,6000,500,4240,360,400,700,270,132
2020,571700331,8800,3700,3600,3600,100,5100,5000,0,5000,0,100,100,0,0,0,0,0,0,566,77,10,20,84,62
2020,571700371,45678,3728,3728,3728,0,41950,35300,10000,22000,3300,6650,5200,1450,0,47610,47610,22610,25000,5477,264,150,1530,426,203
2020,571700381,4100,1100,1100,1100,0,3000,3000,3000,0,0,0,0,0,0,0,0,0,0,526,80,120,5,36,6
2020,571700391,6047,47,47,47,0,6000,6000,6000,0,0,0,0,0,0,0,0,0,0,579,100,50,5,24,2
2020,571800301,13848,148,148,148,0,13700,13600,4600,9000,0,100,0,100,0,5500,5500,5500,0,2302,1030,88,25,28,15
2020,571800331,4518,2018,1018,1018,1000,2500,0,0,0,0,2500,0,500,2000,200,200,0,200,1180,200,120,100,60,5
2020,571800341,12946,2316,2316,2316,0,10630,4600,1000,3600,0,6030,0,6030,0,2617,2617,2600,0,662,183,10,36,48,6
2020,571800361,7100,100,100,100,0,7000,7000,7000,0,0,0,0,0,0,0,0,0,0,346,60,40,25,36,7
2020,571800381,22208,21508,8008,8008,13500,700,0,0,0,0,700,700,0,0,0,0,0,0,1446,260,350,50,36,83
2020,571800391,3084,3084,1784,1784,1300,0,0,0,0,0,0,0,0,0,0,0,0,0,1040,206,120,12,42,14
2020,571900311,94008,31508,31508,25508,0,62500,59000,35000,24000,0,3500,3300,200,0,500,0,0,0,9740,1800,200,1000,240,2134
2020,571900331,41874,4874,4874,4874,0,37000,35000,5000,30000,0,2000,2000,0,0,5000,5000,5000,0,1640,170,150,230,180,128
2020,571900341,2346,2346,1346,1346,1000,0,0,0,0,0,0,0,0,0,0,0,0,0,1258,588,10,60,60,1
2020,571900351,174717,17142,17142,17142,0,157575,124950,100000,24950,0,32625,2500,30125,0,6600,6600,6000,0,5782,84,100,180,180,944
2020,571900361,10374,574,574,574,0,9800,9800,4000,5800,0,0,0,0,0,0,0,0,0,948,120,80,88,80,15
2020,571900371,48128,18978,18978,18978,0,29150,26500,15000,11500,0,2650,2650,0,0,10800,10800,5300,5500,5140,280,100,1300,360,187
2020,571900381,7526,2300,2300,2300,0,5226,5000,5000,0,0,226,0,226,0,0,0,0,0,654,100,30,10,24,4
2020,572000312,35670,1170,1170,1170,0,34500,33000,27000,6000,0,1500,1500,0,0,21200,21200,20000,0,3900,300,400,200,200,92
2020,572000322,66764,13288,13288,13288,0,53476,51000,28000,23000,0,2476,2250,226,0,15700,14700,14700,0,3344,302,30,400,156,538
2020,572000342,25144,4444,4444,4444,0,20700,20000,5000,15000,0,700,0,700,0,0,0,0,0,1340,300,50,200,20,14
2020,572000352,21010,6180,6180,6180,0,14830,13720,7120,6600,0,1110,900,210,0,0,0,0,0,806,130,25,123,108,40
2020,572000362,2920,2320,1320,1320,1000,600,0,0,0,0,600,200,400,0,3700,3700,0,0,3032,636,30,480,240,48
2020,572000382,23034,4834,4834,4834,0,18200,15000,15000,0,0,3200,3200,0,0,40,40,0,0,2070,270,240,600,240,131
2020,572600301,21963,4935,4935,4935,0,17028,9040,5500,3540,0,7988,1450,6538,0,19992,19992,17792,2200,3456,146,120,720,360,70
2020,572600331,3200,3200,1200,1200,2000,0,0,0,0,0,0,0,0,0,0,0,0,0,1741,325,660,60,60,1
2020,572600341,104808,33628,33628,33628,0,71180,65200,1200,64000,0,5980,2380,3600,0,22000,0,0,0,4380,250,150,1000,250,352
2020,572600351,46060,8730,8730,8730,0,37330,31000,11000,20000,0,6330,530,5800,0,0,0,0,0,2380,250,550,650,80,80
2020,572600361,5,5,5,5,0,0,0,0,0,0,0,0,0,0,0,0,0,0,356,25,12,5,24,0
2020,572600371,9302,3502,3502,3502,0,5800,5000,5000,0,0,800,800,0,0,1000,1000,1000,0,725,93,120,120,28,6
2020,572700301,1020,570,570,570,0,450,0,0,0,0,450,0,450,0,0,0,0,0,762,158,24,36,39,1
2020,572700311,72999,24277,24277,24277,0,48722,42280,6000,36280,0,6442,3900,2542,0,50,0,0,0,2770,162,260,240,108,218
2020,572700321,9590,590,590,590,0,9000,9000,9000,0,0,0,0,0,0,5552,5552,4852,0,1000,160,0,60,180,8
2020,572700331,172920,29520,29520,29520,0,143400,140000,20000,120000,0,3400,3200,200,0,0,0,0,0,3360,480,200,700,100,199
2020,572700341,500,500,500,500,0,0,0,0,0,0,0,0,0,0,0,0,0,0,396,60,24,12,0,2
2020,572700351,6500,1400,1400,1400,0,5100,5000,5000,0,0,100,50,50,0,0,0,0,0,656,66,200,60,10,31
2020,572700361,25900,10200,10200,10200,0,15700,15000,15000,0,0,700,0,700,0,0,0,0,0,1311,115,200,30,16,23
2020,572700371,28079,12029,12029,12029,0,16050,12000,12000,0,0,4050,2700,350,1000,7500,4000,4000,0,1988,870,30,70,58,56
2020,572800301,232,232,232,232,0,0,0,0,0,0,0,0,0,0,6120,6120,0,0,661,140,220,25,36,0
2020,572800321,2600,2600,2600,2600,0,0,0,0,0,0,0,0,0,0,0,0,0,0,820,116,150,50,24,1
2020,572800331,60,60,60,60,0,0,0,0,0,0,0,0,0,0,0,0,0,0,757,116,240,24,36,1
2020,572800341,13647,1422,1422,1422,0,12225,7500,7500,0,0,4725,1700,3025,0,2430,2430,0,2430,1196,160,240,120,60,25
2020,572800351,10848,2848,2848,2848,0,8000,6000,6000,0,0,2000,1800,200,0,3900,3900,3400,0,3249,219,150,320,220,70
2020,572900301,32534,10434,10434,10434,0,22100,22000,17000,5000,0,100,100,0,0,0,0,0,0,1950,280,80,170,150,63
2020,572900311,68898,15898,15898,10898,0,53000,48000,38000,10000,0,5000,4000,1000,0,17740,17740,9240,8500,6640,300,200,240,200,719
2020,572900321,7530,30,30,30,0,7500,7500,7500,0,0,0,0,0,0,1400,1400,1400,0,256,48,10,25,48,18
2020,572900341,200,200,200,200,0,0,0,0,0,0,0,0,0,0,0,0,0,0,308,60,24,20,42,1
2020,572900351,20200,250,250,250,0,19950,18700,6700,12000,0,1250,350,900,0,1400,1400,0,1400,1280,105,85,210,120,59
2020,572900361,20594,9594,9594,9244,0,11000,8500,6000,2500,0,2500,2500,0,0,0,0,0,0,2540,120,60,600,120,164
2020,580000302,33198,7198,7198,7198,0,26000,24000,12000,12000,0,2000,2000,0,0,0,0,0,0,1692,240,138,39,118,64
2020,580000312,27170,870,870,870,0,26300,26300,12000,14300,0,0,0,0,0,0,0,0,0,1075,210,100,50,72,32
2020,580000322,358,358,158,158,200,0,0,0,0,0,0,0,0,0,600,600,0,0,2053,372,50,96,132,8
2020,580000332,3037,3037,3037,3037,0,0,0,0,0,0,0,0,0,0,0,0,0,0,637,60,36,41,60,1
2020,580000352,34243,11813,11813,8813,0,22430,19300,19300,0,0,3130,130,1000,2000,120,120,0,0,2238,228,60,240,240,119
2020,580000382,110618,9918,9918,9900,0,100700,89000,19000,70000,0,11700,1700,10000,0,3180,3180,3000,0,2500,216,400,180,180,568
2020,580000392,26010,22610,2610,2610,20000,3400,3400,0,0,3400,0,0,0,0,700,700,700,0,4192,360,200,120,180,3
2020,580600321,17710,710,710,710,0,17000,16800,12000,0,4800,200,200,0,0,5352,5352,4452,900,2334,204,24,192,360,65
2020,580600361,318,318,18,18,300,0,0,0,0,0,0,0,0,0,0,0,0,0,678,138,0,24,19,1
2020,580600371,5600,700,700,700,0,4900,4300,4300,0,0,600,600,0,0,0,0,0,0,1711,131,30,300,180,155
2020,580700311,34065,2065,2065,2065,0,32000,32000,32000,0,0,0,0,0,0,1500,0,0,0,1738,300,240,100,168,44
2020,580700331,4819,4519,2219,2219,2300,300,0,0,0,0,300,0,300,0,950,950,0,0,2524,414,75,130,208,10
2020,580700341,18341,14580,2580,2580,12000,3761,3225,0,3225,0,536,450,86,0,5500,5500,4500,1000,3778,398,112,530,330,199
2020,580700351,13760,2760,2760,2760,0,11000,10000,10000,0,0,1000,1000,0,0,14650,14650,10900,0,1760,240,180,180,240,337
2020,580700361,920,120,120,120,0,800,0,0,0,0,800,800,0,0,944,944,0,944,1320,240,10,200,120,34
2020,580700371,20530,420,420,420,0,20110,20000,20000,0,0,110,0,110,0,8800,8800,8800,0,2480,420,510,230,120,87
2020,580700391,16715,14815,7315,7315,7500,1900,0,0,0,0,1900,1500,400,0,1000,1000,0,1000,3118,240,100,240,168,238
2020,580800301,34942,6688,6688,6688,0,28254,26000,26000,0,0,2254,1350,904,0,9850,9850,9850,0,5463,438,10,660,270,255
2020,580800311,455,55,55,55,0,400,0,0,0,0,400,400,0,0,8100,8100,0,2100,1507,152,120,440,156,1
2020,580800321,8922,622,622,622,0,8300,8300,3800,4500,0,0,0,0,0,0,0,0,0,635,106,140,30,8,8
2020,580800331,13020,20,20,20,0,13000,13000,13000,0,0,0,0,0,0,0,0,0,0,521,96,36,2,24,20
2020,580800341,151,151,1,1,150,0,0,0,0,0,0,0,0,0,0,0,0,0,890,248,165,24,22,0
2020,580800351,34720,11920,11920,9920,0,22800,20000,20000,0,0,2800,1200,600,1000,50,50,0,0,6160,300,360,240,360,580
2020,580800361,52900,18750,18750,17750,0,34150,23000,23000,0,0,11150,10400,750,0,11140,11140,9000,0,2225,150,70,125,300,165
2020,580800371,31799,7409,7409,7409,0,24390,22000,22000,0,0,2390,2200,190,0,490,490,0,0,4118,380,390,620,460,87
2020,580900301,24359,11059,11059,11059,0,13300,10000,10000,0,0,3300,3300,0,0,20,20,0,0,2495,240,240,360,160,195
2020,580900311,5030,5030,30,30,5000,0,0,0,0,0,0,0,0,0,5600,5600,0,0,1565,108,380,130,36,1
2020,580900321,2045,2045,45,45,2000,0,0,0,0,0,0,0,0,0,0,0,0,0,841,85,280,34,27,1
2020,580900341,18617,4017,4017,4017,0,14600,13600,1600,12000,0,1000,100,900,0,300,300,0,300,3132,110,120,520,91,829
2020,580900351,123735,5095,5095,5095,0,118640,33000,9000,24000,0,85640,3640,47000,35000,34300,26300,20800,5000,5740,250,70,600,240,108
2020,580900361,67575,28875,28875,28775,0,38700,38500,21500,17000,0,200,100,100,0,100,100,0,100,5070,774,150,280,336,1458
2020,580900371,41499,24449,24449,24449,0,17050,14000,14000,0,0,3050,3050,0,0,0,0,0,0,3850,300,100,450,220,174
2020,580900391,44538,10838,10838,10838,0,33700,31000,31000,0,0,2700,2380,320,0,1550,1550,700,800,3804,204,150,500,420,513
2020,581000302,12020,6570,6070,2070,500,5450,0,0,0,0,5450,250,1200,4000,0,0,0,0,2859,601,18,240,150,123
2020,581000322,35300,300,300,300,0,35000,35000,35000,0,0,0,0,0,0,0,0,0,0,858,180,60,60,48,50
2020,581000332,85472,26472,26472,26472,0,59000,48000,10000,38000,0,11000,3000,3000,5000,17120,17120,16000,1000,5736,240,20,460,600,386
2020,581000352,7142,342,342,342,0,6800,6700,6700,0,0,100,100,0,0,5410,5410,4800,0,1400,132,36,460,72,33
2020,581000362,6130,6130,1130,1130,5000,0,0,0,0,0,0,0,0,0,0,0,0,0,2067,181,30,402,144,23
2020,581000372,7610,110,110,110,0,7500,7000,7000,0,0,500,500,0,0,1480,1480,0,0,3180,180,150,300,150,53
2020,581000382,2803,2803,303,303,2500,0,0,0,0,0,0,0,0,0,0,0,0,0,690,68,78,27,30,1
2020,581600301,57892,11292,11292,11292,0,46600,45000,16000,29000,0,1600,1500,100,0,4357,3757,3419,308,2040,270,100,320,160,88
2020,581600311,22180,14980,14980,14980,0,7200,7100,7100,0,0,100,100,0,0,55,55,0,0,1853,60,117,360,66,59
2020,581600321,75400,3900,3900,3900,0,71500,71000,26000,45000,0,500,500,0,0,39100,39100,39000,0,4400,360,240,360,300,215
2020,581600331,61600,200,200,200,0,61400,61100,19000,42100,0,300,300,0,0,3500,0,0,0,1758,252,250,70,96,112
2020,581600341,51020,740,740,740,0,50280,50000,50000,0,0,280,100,180,0,13800,13000,13000,0,2386,716,300,290,240,92
2020,581600351,101066,12598,12598,12598,0,88468,83000,18000,65000,0,5468,4790,678,0,35574,17574,14574,3000,4305,205,630,720,240,277
2020,581600371,67248,36198,36198,36198,0,31050,30000,30000,0,0,1050,1050,0,0,0,0,0,0,5170,360,180,420,300,959
2020,581600391,2708,2628,2128,2128,500,80,0,0,0,0,80,80,0,0,0,0,0,0,1562,138,60,260,84,36
2020,581700331,113436,40616,40616,40616,0,72820,15200,7200,8000,0,57620,620,50000,7000,38800,38800,38800,0,2125,95,310,240,198,104
2020,581700341,13042,1272,1272,1272,0,11770,11500,8500,3000,0,270,270,0,0,100,100,100,0,1262,191,12,120,110,37
2020,581700351,22210,3610,3610,3610,0,18600,18000,18000,0,0,600,600,0,0,9000,9000,9000,0,3406,256,500,460,150,37
2020,581700361,22956,6906,6906,6906,0,16050,16000,16000,0,0,50,50,0,0,0,0,0,0,1400,212,10,150,55,57
2020,581700371,25780,2180,2180,2180,0,23600,22250,16250,6000,0,1350,1350,0,0,7250,7250,6900,0,3180,210,300,300,180,475
2020,581700381,300,300,300,300,0,0,0,0,0,0,0,0,0,0,0,0,0,0,1232,130,100,100,12,1
2020,581800301,11000,500,500,500,0,10500,10500,4000,6500,0,0,0,0,0,0,0,0,0,580,200,100,30,20,56
2020,581800311,29090,8940,8940,7440,0,20150,17500,17500,0,0,2650,650,2000,0,12650,12650,9650,1000,4054,360,30,960,204,36
2020,581800331,17421,201,201,201,0,17220,17220,12000,5220,0,0,0,0,0,14018,14018,12838,0,1555,175,5,60,70,21
2020,581800341,64097,29572,29572,29572,0,34525,33000,33000,0,0,1525,1400,125,0,1600,0,0,0,3755,180,20,252,228,113
2020,581800351,35867,6467,6467,6467,0,29400,26100,26100,0,0,3300,3300,0,0,22000,22000,16500,0,5170,300,150,480,240,140
2020,581800361,57956,10648,10648,9648,0,47308,38000,23000,15000,0,9308,3210,5098,1000,11100,11100,0,11000,6178,216,10,820,234,741
2020,581800371,15534,5308,5308,5308,0,10226,10000,10000,0,0,226,0,226,0,0,0,0,0,992,180,108,108,36,35
2020,581800381,13880,3880,3880,3880,0,10000,10000,10000,0,0,0,0,0,0,13000,13000,13000,0,1458,240,240,100,48,26
2020,581800391,45094,44578,3578,3578,41000,516,0,0,0,0,516,290,226,0,22400,22400,21000,1400,4980,230,500,340,250,254
2020,581900341,22880,6880,6880,6880,0,16000,14000,12000,2000,0,2000,2000,0,0,0,0,0,0,2602,180,120,240,192,114
2020,581900351,83164,9364,9364,9364,0,73800,71000,25000,46000,0,2800,2500,300,0,42508,36508,33692,1632,2850,300,100,450,160,432
2020,581900371,72,2,2,2,0,70,0,0,0,0,70,70,0,0,7000,7000,0,7000,503,100,20,68,40,31
2020,581900381,22205,8155,8155,8155,0,14050,13000,13000,0,0,1050,1050,0,0,1679,1679,1400,0,4669,247,80,320,240,437
2020,582000312,7900,7600,2600,2600,5000,300,0,0,0,0,300,300,0,0,0,0,0,0,4860,720,60,240,360,47
2020,582000322,20860,4360,4360,3860,0,16500,16000,11000,5000,0,500,500,0,0,5500,5500,5500,0,1894,210,60,240,120,27
2020,582000332,160360,31480,31480,31480,0,128880,125000,38000,87000,0,3880,3880,0,0,2000,0,0,0,4554,396,300,504,72,387
2020,582000342,53540,9040,9040,9040,0,44500,43000,38000,5000,0,1500,1500,0,0,6500,6500,6500,0,5660,456,400,240,360,1305
2020,582000352,452,452,352,52,100,0,0,0,0,0,0,0,0,0,0,0,0,0,992,324,16,48,120,1
2020,582000372,5940,300,300,300,0,5640,5200,5200,0,0,440,440,0,0,0,0,0,0,791,136,180,112,42,46
2020,582000392,100997,12905,12905,12905,0,88092,86510,6010,80500,0,1582,830,752,0,925,925,0,925,1057,82,220,200,37,140
2020,582600301,25410,910,910,610,0,24500,24500,13500,11000,0,0,0,0,0,12880,3880,3700,160,2906,188,400,240,208,306
2020,582600311,44178,6715,6715,6715,0,37463,36000,21000,15000,0,1463,1350,113,0,3084,3084,2900,100,3255,290,5,180,300,901
2020,582600321,26711,4931,4931,4931,0,21780,21000,21000,0,0,780,780,0,0,4000,4000,4000,0,2743,265,60,330,228,954
2020,582600331,10154,2154,2154,2154,0,8000,8000,8000,0,0,0,0,0,0,5249,5249,4000,0,1553,132,360,240,36,12
2020,582600351,20449,399,399,399,0,20050,20000,20000,0,0,50,50,0,0,9000,9000,9000,0,1824,120,120,360,84,100
2020,582600381,14370,5170,5170,5170,0,9200,8400,8400,0,0,800,700,100,0,2320,2320,2000,0,1615,300,12,248,72,24
2020,582700311,969442,208600,208600,208600,0,760842,680000,40000,640000,0,80842,8342,72500,0,110000,100000,100000,0,6180,460,400,540,240,13254
2020,582700331,39029,4854,4854,4854,0,34175,33000,20000,13000,0,1175,1175,0,0,9050,9050,9000,0,1996,176,35,150,110,95
2020,582700341,37040,16071,16071,16071,0,20969,20000,11000,9000,0,969,580,389,0,2100,1600,0,1500,1854,174,70,240,300,150
2020,582700361,17604,3454,3454,2454,0,14150,13000,13000,0,0,1150,650,0,500,5100,5100,0,0,3872,300,96,72,360,51
2020,582700381,1600,1600,1600,1600,0,0,0,0,0,0,0,0,0,0,0,0,0,0,664,100,136,3,18,1
2020,582700391,56096,356,356,356,0,55740,54500,19500,35000,0,1240,200,740,300,51000,50500,41500,7500,1752,252,340,240,60,59
2020,582800311,20810,9710,9710,9710,0,11100,10500,5500,5000,0,600,600,0,0,550,550,550,0,3210,180,80,400,240,183
2020,582800321,11170,70,70,70,0,11100,11100,10000,1100,0,0,0,0,0,2018,18,0,0,2760,1800,180,20,100,12
2020,582800331,43750,13730,13730,10730,0,30020,22500,22500,0,0,7520,3970,3550,0,25078,25078,11100,13800,3142,264,36,600,120,58
2020,582800351,28416,5946,5946,5946,0,22470,10000,10000,0,0,12470,950,11520,0,8000,8000,6000,2000,2170,156,50,500,162,87
2020,582800361,12144,5401,5401,5401,0,6743,6500,6500,0,0,243,130,113,0,0,0,0,0,3413,252,20,360,240,180
2020,582800391,63067,1467,1467,1467,0,61600,60000,10000,50000,0,1600,100,1500,0,3160,3160,3160,0,1324,240,50,120,84,37
2020,582900331,95080,25760,25760,18760,0,69320,69000,25000,44000,0,320,320,0,0,37000,37000,25000,12000,5990,420,100,300,300,1666
2020,582900341,18102,8102,8102,8102,0,10000,10000,10000,0,0,0,0,0,0,6000,0,0,0,1870,220,240,120,60,16
2020,582900351,4249,19,19,19,0,4230,3880,3880,0,0,350,350,0,0,300,300,0,0,889,150,80,100,44,6
2020,582900361,3610,100,100,100,0,3510,3500,3500,0,0,10,0,10,0,0,0,0,0,928,120,180,24,24,3
2020,582900371,24497,997,997,997,0,23500,23000,0,23000,0,500,500,0,0,300,300,0,300,1173,127,300,60,36,18
2020,582900381,245,245,245,245,0,0,0,0,0,0,0,0,0,0,0,0,0,0,590,120,0,36,24,1
2020,582900391,19923,803,803,803,0,19120,19070,4000,15070,0,50,50,0,0,0,0,0,0,1067,131,110,87,24,20
2020,583000302,12920,4920,4920,4420,0,8000,6500,6500,0,0,1500,1500,0,0,2700,2700,0,2500,2894,98,50,120,360,55
2020,583000312,7594,2047,2047,2047,0,5547,5217,4260,957,0,330,300,30,0,500,500,0,500,2563,450,600,360,33,96
2020,583600301,8860,1860,1860,1860,0,7000,7000,7000,0,0,0,0,0,0,5300,5300,4500,800,1906,108,1300,100,48,25
2020,583700301,29145,9995,9995,9995,0,19150,17000,5000,12000,0,2150,150,2000,0,0,0,0,0,1118,88,100,180,120,31
2020,583700311,9711,336,336,336,0,9375,9375,7500,1875,0,0,0,0,0,4900,4900,4900,0,1249,162,500,84,63,7
2020,583800301,26980,350,350,350,0,26630,25000,25000,0,0,1630,1630,0,0,0,0,0,0,1366,173,21,125,130,104
2020,583900301,9080,3730,3730,3730,0,5350,5000,4000,1000,0,350,0,350,0,0,0,0,0,466,100,65,15,36,4
2020,590000252,9352,152,152,152,0,9200,9000,9000,0,0,200,200,0,0,5224,5224,3300,1924,1282,100,360,240,72,227
2020,590000272,8700,8700,700,700,8000,0,0,0,0,0,0,0,0,0,0,0,0,0,644,200,120,10,24,1
2020,590000292,26845,26595,15095,15095,11500,250,0,0,0,0,250,250,0,0,0,0,0,0,2778,420,70,140,144,71
2020,590000302,74944,4650,4650,4650,0,70294,70000,10000,60000,0,294,100,194,0,30,30,0,0,1230,70,10,200,70,63
2020,590000352,144050,19050,19050,19050,0,125000,125000,0,125000,0,0,0,0,0,0,0,0,0,1968,388,980,0,30,106
2020,590000362,76450,4350,4350,4350,0,72100,71000,51000,20000,0,1100,1000,100,0,0,0,0,0,3540,220,120,720,240,146
2020,590000392,21302,20602,20602,20602,0,700,0,0,0,0,700,700,0,0,0,0,0,0,3371,240,25,250,300,157
2020,590600211,2630,2565,65,65,2500,65,0,0,0,0,65,0,65,0,0,0,0,0,1110,250,10,50,100,1
2020,590600221,7210,6870,3310,3310,3560,340,0,0,0,0,340,0,340,0,425,425,275,0,1420,156,100,20,84,8
2020,590600231,131512,3652,3652,3652,0,127860,125000,15000,110000,0,2860,750,2110,0,15200,2200,2200,0,1985,75,300,264,144,72
2020,590600341,125508,12208,12208,12208,0,113300,113000,33000,80000,0,300,300,0,0,4000,2000,2000,0,2379,1120,20,300,108,331
2020,590600351,1026,803,703,703,100,223,0,0,0,0,223,100,123,0,1900,1900,0,1900,3170,550,300,200,360,13
2020,590600371,2538,538,38,38,500,2000,0,0,0,0,2000,2000,0,0,1000,1000,0,0,3251,169,12,360,468,340
2020,590600381,36767,6107,6107,6107,0,30660,30000,30000,0,0,660,660,0,0,13990,13990,13990,0,1358,120,24,120,240,576
2020,590600391,34698,18798,18798,18798,0,15900,15000,15000,0,0,900,900,0,0,200,200,0,0,3710,200,300,500,300,120
2020,590700201,32896,1896,1896,1896,0,31000,30000,30000,0,0,1000,1000,0,0,500,0,0,0,1215,276,3,240,48,48
2020,590700211,57165,1415,1415,1415,0,55750,55000,55000,0,0,750,750,0,0,100,100,0,0,4149,280,150,357,182,67
2020,590700301,9140,3340,3340,3340,0,5800,5000,5000,0,0,800,800,0,0,7000,7000,4000,3000,5190,240,300,1200,600,195
2020,590700311,204786,7496,7496,7496,0,197290,195000,20000,175000,0,2290,890,1400,0,3000,3000,3000,0,2696,170,480,604,120,324
2020,590700331,47380,20380,20380,20380,0,27000,25000,25000,0,0,2000,2000,0,0,2400,2400,0,1000,6930,200,200,550,400,201
2020,590700341,10,10,10,10,0,0,0,0,0,0,0,0,0,0,0,0,0,0,545,350,0,0,5,10
2020,590700351,24400,2600,2600,2600,0,21800,20000,0,20000,0,1800,1800,0,0,200,200,0,0,2690,180,10,140,240,23
2020,590700361,14450,3150,3150,3150,0,11300,10000,0,10000,0,1300,1300,0,0,0,0,0,0,930,50,30,100,100,94
2020,590700391,133973,11323,11323,11323,0,122650,62000,50000,12000,0,60650,450,20200,40000,0,0,0,0,3597,372,12,120,156,2465
2020,590800231,28589,16589,16589,16589,0,12000,12000,12000,0,0,0,0,0,0,0,0,0,0,1080,210,10,100,100,12
2020,590800241,50,50,50,50,0,0,0,0,0,0,0,0,0,0,0,0,0,0,1378,360,48,180,60,1
2020,590800251,23596,5096,5096,5096,0,18500,15500,15500,0,0,3000,3000,0,0,11030,11030,11030,0,3100,300,100,400,200,408
2020,590800271,9440,1440,1440,1440,0,8000,8000,8000,0,0,0,0,0,0,0,0,0,0,1900,180,550,50,120,105
2020,590800301,200,200,200,200,0,0,0,0,0,0,0,0,0,0,0,0,0,0,302,62,30,0,10,2
2020,590800311,135320,9070,9070,9070,0,126250,122000,20000,102000,0,4250,3050,1200,0,4000,4000,2000,2000,1396,70,60,70,116,865
2020,590800351,1535,1535,1535,1535,0,0,0,0,0,0,0,0,0,0,0,0,0,0,527,24,15,0,16,3
2020,590800361,980,330,280,280,50,650,0,0,0,0,650,650,0,0,0,0,0,0,3655,438,5,360,348,85
2020,590800381,96279,37484,20484,19484,17000,58795,53000,0,53000,0,5795,1900,2395,1500,11200,11200,11200,0,2620,150,50,180,300,108
2020,590900201,20058,800,800,800,0,19258,18000,18000,0,0,1258,1200,58,0,20,20,0,0,1890,360,600,120,120,49
2020,590900221,11641,6641,6641,6641,0,5000,4000,4000,0,0,1000,900,100,0,1400,1400,1400,0,2050,240,180,180,120,122
2020,590900231,17200,1200,1200,1200,0,16000,16000,16000,0,0,0,0,0,0,0,0,0,0,806,240,250,0,36,13
2020,590900251,100,100,100,100,0,0,0,0,0,0,0,0,0,0,0,0,0,0,559,60,240,24,0,1
2020,590900281,45610,5310,5310,5240,0,40300,37000,37000,0,0,3300,3300,0,0,0,0,0,0,2361,240,100,300,100,665
2020,590900291,47270,3810,3810,3810,0,43460,43000,43000,0,0,460,460,0,0,14750,14750,14750,0,4723,300,10,154,144,375
2020,590900311,440,440,340,340,100,0,0,0,0,0,0,0,0,0,1000,1000,0,0,1520,700,60,60,120,45
2020,590900331,167705,6505,6505,6505,0,161200,160000,15000,145000,0,1200,1200,0,0,0,0,0,0,1550,174,144,120,108,333
2020,590900351,350,350,250,250,100,0,0,0,0,0,0,0,0,0,1000,1000,1000,0,1640,500,150,150,240,1
2020,590900361,2007,2007,7,7,2000,0,0,0,0,0,0,0,0,0,2367,2367,667,0,1507,372,100,36,144,1
2020,591000202,19094,18394,7022,7022,11372,700,0,0,0,0,700,700,0,0,2020,2020,0,2020,2555,782,10,204,96,383
2020,591000212,151970,27020,27020,27020,0,124950,120000,70000,50000,0,4950,4950,0,0,32500,31500,26500,5000,3760,300,30,370,180,1795
2020,591000222,71500,600,600,600,0,70900,70000,70000,0,0,900,900,0,0,9000,9000,9000,0,4510,360,200,600,150,1236
2020,591000232,79728,7628,7628,7628,0,72100,70000,70000,0,0,2100,2100,0,0,8000,8000,8000,0,3460,480,60,480,480,278
2020,591000302,1100,1100,1100,1100,0,0,0,0,0,0,0,0,0,0,0,0,0,0,380,36,50,0,24,1
2020,591000312,12320,5720,5720,5720,0,6600,4300,4300,0,0,2300,2300,0,0,0,0,0,0,1638,72,110,480,264,39
2020,591000322,562,562,172,172,390,0,0,0,0,0,0,0,0,0,0,0,0,0,697,118,30,20,72,1
2020,591000342,24790,22590,13590,13590,9000,2200,0,0,0,0,2200,2200,0,0,0,0,0,0,2207,296,100,360,192,59
2020,591000352,14538,13788,5588,5588,8200,750,0,0,0,0,750,750,0,0,3000,3000,0,3000,3216,444,24,480,156,31
2020,591600311,15870,870,870,870,0,15000,15000,15000,0,0,0,0,0,0,0,0,0,0,1150,130,120,36,48,9
2020,591600331,90150,12950,12950,12950,0,77200,55000,20000,35000,0,22200,2200,15000,5000,0,0,0,0,4210,240,300,360,360,245
2020,591700301,12444,11654,7954,7954,3700,790,0,0,0,0,790,770,20,0,0,0,0,0,2086,150,100,120,96,52
2020,591700311,58457,19757,19757,12757,0,38700,32000,32000,0,0,6700,3700,1000,2000,14450,14450,14000,0,4994,250,120,1200,240,246
2020,591700321,43320,6980,6980,6980,0,36340,22000,22000,0,0,14340,3840,0,10500,0,0,0,0,2581,67,240,600,240,100
2020,591700331,100,100,100,100,0,0,0,0,0,0,0,0,0,0,0,0,0,0,810,172,100,0,18,1
2020,591700351,31748,2698,2698,2698,0,29050,22000,0,22000,0,7050,1950,5100,0,5000,5000,0,0,2460,720,60,300,240,78
2020,591800201,30860,3460,3460,3460,0,27400,27000,17000,10000,0,400,400,0,0,9000,6000,3000,3000,2564,360,400,350,144,183
2020,591800211,4768,3968,2468,2468,1500,800,0,0,0,0,800,800,0,0,7100,7100,0,7100,3930,450,1400,650,450,141
2020,591800241,368,268,30,30,238,100,0,0,0,0,100,100,0,0,5662,5662,0,5662,552,120,5,30,12,0
2020,591800281,81990,2720,2720,2720,0,79270,79100,15500,63600,0,170,140,30,0,4000,4000,4000,0,1058,148,132,300,96,254
2020,591800291,84078,16878,16878,16878,0,67200,67000,17000,50000,0,200,200,0,0,500,0,0,0,1270,197,116,181,48,249
2020,591800301,53900,11800,11800,11800,0,42100,40000,40000,0,0,2100,2100,0,0,300,300,0,0,5780,200,1000,300,120,707
2020,591800311,103240,6240,6240,6240,0,97000,91000,21000,70000,0,6000,1100,4900,0,1500,1500,1500,0,2140,540,20,200,200,139
2020,591800321,63000,2800,2800,2800,0,60200,60000,40000,20000,0,200,200,0,0,0,0,0,0,2476,96,60,250,48,185
2020,591800331,109320,20070,20070,20070,0,89250,76000,26000,50000,0,13250,250,13000,0,0,0,0,0,1628,109,20,240,48,414
2020,591800341,40370,17320,17320,17320,0,23050,21000,21000,0,0,2050,1800,250,0,120,120,0,0,5200,300,300,400,300,1626
2020,591900201,8604,8604,8604,8604,0,0,0,0,0,0,0,0,0,0,100,100,0,0,2464,300,216,340,96,295
2020,591900211,21883,20383,6383,6383,14000,1500,0,0,0,0,1500,1500,0,0,15870,15870,10170,5000,5100,300,200,400,400,305
2020,591900231,15114,14414,414,414,14000,700,0,0,0,0,700,700,0,0,4000,4000,4000,0,3170,270,150,200,300,146
2020,591900301,85714,8114,8114,8114,0,77600,75000,25000,50000,0,2600,2600,0,0,16800,13800,13000,200,5220,260,80,400,400,239
2020,591900311,45,15,15,15,0,30,0,0,0,0,30,0,30,0,1220,1220,0,0,894,204,30,36,12,1
2020,591900321,59947,3677,3677,3677,0,56270,53000,35000,18000,0,3270,2970,300,0,17700,17700,17400,0,5064,300,240,340,324,52
2020,591900331,20,20,20,20,0,0,0,0,0,0,0,0,0,0,0,0,0,0,395,60,50,0,15,1
2020,592800211,53757,7292,7292,5292,0,46465,44000,38000,6000,0,2465,1900,565,0,2000,2000,0,2000,4400,297,186,600,461,520
2020,592800251,26590,590,590,590,0,26000,26000,0,26000,0,0,0,0,0,0,0,0,0,557,120,174,25,20,51
2020,592800261,585,585,585,585,0,0,0,0,0,0,0,0,0,0,0,0,0,0,359,120,37,14,24,1
2020,592800271,85900,5400,5400,5400,0,80500,80000,28000,52000,0,500,500,0,0,25500,25000,25000,0,3050,200,200,900,100,2501
2020,592800291,286,286,286,286,0,0,0,0,0,0,0,0,0,0,0,0,0,0,701,120,436,10,0,1
2020,593800251,20060,20060,9060,9060,11000,0,0,0,0,0,0,0,0,0,2297,2297,0,2250,3790,600,50,600,120,958
2020,593800271,17610,3910,3910,2910,0,13700,12000,0,12000,0,1700,700,1000,0,9030,9030,8100,930,2750,200,200,400,250,87
2020,593800281,30300,27000,4000,4000,23000,3300,0,0,0,0,3300,3300,0,0,0,0,0,0,2710,300,60,500,180,53
2020,594800201,97565,27665,27665,27665,0,69900,62000,62000,0,0,7900,4900,3000,0,0,0,0,0,5176,420,800,600,216,334
2020,594800261,97694,29194,5194,5194,24000,68500,65000,0,65000,0,3500,3500,0,0,28820,1320,0,0,3780,450,150,300,360,450
2020,594800291,52781,9381,9381,9381,0,43400,42500,40000,0,2500,900,800,100,0,9926,9926,9926,0,2350,360,50,340,120,86
2020,595800231,43285,2210,2210,210,0,41075,40000,40000,0,0,1075,840,235,0,9000,9000,9000,0,2534,200,60,250,174,31
2020,610000102,127640,37640,37640,37640,0,90000,90000,80000,10000,0,0,0,0,0,1000,0,0,0,2370,290,250,300,250,192
2020,610000112,91350,6250,6250,6250,0,85100,85000,85000,0,0,100,100,0,0,28025,28025,28025,0,3350,280,400,100,100,66
2020,610000142,66705,5,5,5,0,66700,66700,66700,0,0,0,0,0,0,23000,23000,21000,2000,5460,240,240,240,240,363
2020,610000152,14930,14930,2930,2930,12000,0,0,0,0,0,0,0,0,0,3000,3000,3000,0,1905,120,50,240,45,43
2020,610000172,131000,1000,1000,1000,0,130000,130000,130000,0,0,0,0,0,0,0,0,0,0,1507,240,400,30,72,209
2020,610000182,57400,7900,7900,1900,0,49500,42000,42000,0,0,7500,1500,0,6000,0,0,0,0,2240,240,240,100,180,114
2020,610000192,29460,460,460,460,0,29000,29000,29000,0,0,0,0,0,0,19000,19000,18000,0,3187,180,5,72,300,26
2020,610000222,24943,2130,2130,2130,0,22813,22000,7000,15000,0,813,700,113,0,4000,0,0,0,1804,120,34,240,120,32
2020,610000252,95553,10603,10603,10403,0,84950,84000,36000,48000,0,950,950,0,0,23070,10070,10000,0,5240,700,70,340,240,368
2020,610000262,162880,44080,44080,44080,0,118800,118000,38000,80000,0,800,800,0,0,0,0,0,0,5000,560,120,840,240,975
2020,610000282,47056,16711,16711,11711,0,30345,30000,30000,0,0,345,300,45,0,11000,11000,10000,0,3726,360,60,360,240,247
2020,610000292,1000,1000,500,500,500,0,0,0,0,0,0,0,0,0,0,0,0,0,2166,600,60,360,96,14
2020,610000302,56800,9300,9300,9300,0,47500,45000,45000,0,0,2500,2500,0,0,23768,23768,21768,2000,4890,240,100,250,200,214
2020,610000312,12230,12080,80,80,12000,150,0,0,0,0,150,150,0,0,10000,10000,10000,0,2486,240,50,396,180,13
2020,610000322,320,20,20,20,0,300,0,0,0,0,300,300,0,0,0,0,0,0,1022,360,30,60,72,13
2020,610000332,308,308,308,308,0,0,0,0,0,0,0,0,0,0,0,0,0,0,780,480,0,10,70,0
2020,610000342,66353,15093,15093,9093,0,51260,47000,20000,27000,0,4260,3500,760,0,5073,5073,5073,0,3144,300,200,100,140,203
2020,610000352,13555,8855,7855,4855,1000,4700,0,0,0,0,4700,1700,0,3000,4000,4000,3000,1000,4190,1080,100,400,220,333
2020,610000372,5240,4890,890,890,4000,350,0,0,0,0,350,350,0,0,150,150,0,0,2068,498,150,180,192,37
2020,610000382,13000,12550,550,550,12000,450,0,0,0,0,450,450,0,0,9258,9258,8800,0,2132,216,30,100,252,11
2020,610000392,107960,3360,3360,3360,0,104600,104000,40000,64000,0,600,600,0,0,36500,13500,13500,0,4372,240,300,530,200,209
2020,610600121,1930,230,230,230,0,1700,0,0,0,0,1700,1700,0,0,3000,3000,3000,0,1560,320,150,80,300,646
2020,610600131,34670,1670,1670,1670,0,33000,30000,30000,0,0,3000,3000,0,0,15200,15200,11400,3800,2310,150,100,300,100,127
2020,610600141,19840,1440,1440,1440,0,18400,18000,18000,0,0,400,400,0,0,0,0,0,0,1500,70,20,80,30,104
2020,610600161,34498,2598,2598,2598,0,31900,30000,30000,0,0,1900,1900,0,0,6100,6100,5980,0,1160,100,300,80,200,80
2020,610600181,5575,5575,2575,2575,3000,0,0,0,0,0,0,0,0,0,950,950,900,0,622,180,50,72,120,10
2020,610600191,1355,1325,25,25,1300,30,0,0,0,0,30,0,30,0,1300,1300,700,0,914,240,4,120,60,1
2020,610600221,21270,21120,21120,21120,0,150,0,0,0,0,150,150,0,0,0,0,0,0,2036,120,150,180,96,506
2020,610600261,119380,16080,16080,16080,0,103300,99300,28000,71300,0,4000,2500,1500,0,70300,60300,59300,1000,5398,360,200,450,216,666
2020,610600271,113919,24028,24028,23028,0,89891,70000,25000,45000,0,19891,891,19000,0,9000,0,0,0,4113,228,900,330,160,293
2020,610600291,88570,29570,29570,27570,0,59000,50000,50000,0,0,9000,4000,5000,0,0,0,0,0,5800,700,100,500,300,754
2020,610600331,66272,9972,9972,9972,0,56300,55000,55000,0,0,1300,1300,0,0,16800,16800,15500,1200,7380,360,120,600,200,2922
2020,610600341,32342,6330,6330,6330,0,26012,25000,25000,0,0,1012,900,112,0,3842,3842,2707,1135,5058,310,125,443,352,479
2020,610600351,64505,25295,25295,25295,0,39210,38000,35000,3000,0,1210,1160,50,0,5500,5500,5500,0,5230,400,200,500,130,969
2020,610600371,25010,13010,3010,3010,10000,12000,12000,0,0,12000,0,0,0,0,7500,7500,0,7500,1146,240,140,60,126,10
2020,610600381,469060,1560,1560,1560,0,467500,455000,55000,400000,0,12500,6500,6000,0,318000,308000,284000,20000,3440,400,500,600,180,1491
2020,610600391,520,520,20,20,500,0,0,0,0,0,0,0,0,0,0,0,0,0,1632,600,60,120,72,1
2020,610601101,7080,7080,80,80,7000,0,0,0,0,0,0,0,0,0,700,700,700,0,1518,132,700,10,0,1
2020,610601111,133064,56774,56774,26774,0,76290,75000,35000,40000,0,1290,612,678,0,3500,0,0,0,5434,200,150,200,334,514
2020,610700121,20220,220,220,220,0,20000,20000,20000,0,0,0,0,0,0,0,0,0,0,1197,120,560,12,40,16
2020,610700131,20410,410,410,410,0,20000,20000,20000,0,0,0,0,0,0,1000,1000,1000,0,1990,150,120,120,120,36
2020,610700151,1465,665,165,165,500,800,0,0,0,0,800,750,50,0,0,0,0,0,3490,840,60,480,240,53
2020,610700161,71410,560,560,560,0,70850,70000,70000,0,0,850,350,500,0,19710,210,0,210,3290,320,120,180,120,95
2020,610700171,23600,23500,500,500,23000,100,0,0,0,0,100,100,0,0,0,0,0,0,1636,156,300,240,78,69
2020,610700211,435,435,135,135,300,0,0,0,0,0,0,0,0,0,5000,5000,0,0,1444,504,10,54,120,0
2020,610700221,22678,9178,9178,9178,0,13500,13000,13000,0,0,500,500,0,0,7000,7000,4000,0,3960,240,480,360,280,197
2020,610700261,34838,1750,1750,1750,0,33088,33000,7000,26000,0,88,0,88,0,3700,0,0,0,1710,100,300,10,50,19
2020,610700271,120,120,70,70,50,0,0,0,0,0,0,0,0,0,0,0,0,0,424,144,36,17,32,1
2020,610700281,5040,4940,1940,1940,3000,100,0,0,0,0,100,100,0,0,1000,1000,0,0,1839,119,300,220,120,11
2020,610700301,25720,25720,6720,6720,19000,0,0,0,0,0,0,0,0,0,12000,12000,12000,0,2536,276,240,72,324,3
2020,610700321,12327,6327,3327,1827,3000,6000,0,0,0,0,6000,0,3000,3000,11500,11500,0,1000,4304,864,700,400,300,112
2020,610700331,100050,13850,13850,13850,0,86200,75200,52000,23200,0,11000,4000,7000,0,18704,17704,17704,0,5400,500,500,500,100,165
2020,610700351,5990,5560,560,560,5000,430,0,0,0,0,430,430,0,0,0,0,0,0,1710,516,12,160,72,7
2020,610700361,49300,2300,2300,2300,0,47000,47000,33000,14000,0,0,0,0,0,0,0,0,0,1008,252,48,60,60,155
2020,610700371,50,50,50,50,0,0,0,0,0,0,0,0,0,0,310,310,0,310,1032,50,200,30,20,1
2020,610700381,73642,18942,18942,18942,0,54700,53000,30000,23000,0,1700,1700,0,0,2000,2000,2000,0,4010,350,60,350,220,341
2020,610701101,8012,6762,1262,1262,5500,1250,850,0,0,850,400,400,0,0,3250,3250,0,1300,3969,111,780,714,300,21
2020,610800141,25850,25850,7850,7850,18000,0,0,0,0,0,0,0,0,0,0,0,0,0,2020,70,1400,40,50,48
2020,610800191,166340,13140,8140,8140,5000,153200,150000,0,150000,0,3200,3200,0,0,99760,9760,9660,0,12500,3480,100,360,360,3975
2020,610800201,422,422,222,222,200,0,0,0,0,0,0,0,0,0,3000,3000,0,0,1011,396,5,84,36,1
2020,610800211,2298,2298,1298,1298,1000,0,0,0,0,0,0,0,0,0,0,0,0,0,2146,840,10,96,120,28
2020,610800221,33200,25200,17200,17200,8000,8000,5000,0,5000,0,3000,3000,0,0,1500,0,0,0,2538,336,10,300,72,85
2020,610800231,381,381,81,81,300,0,0,0,0,0,0,0,0,0,1500,1500,0,1500,996,180,80,60,24,0
2020,610800241,4804,2020,1520,1520,500,2784,0,0,0,0,2784,2700,84,0,2525,2525,0,500,2429,804,12,15,18,60
2020,610800251,4170,4170,2170,2170,2000,0,0,0,0,0,0,0,0,0,290,290,0,0,1286,160,5,15,80,2
2020,610800281,762,762,462,462,300,0,0,0,0,0,0,0,0,0,420,420,0,0,1500,450,300,60,100,1
2020,610800291,692,692,692,692,0,0,0,0,0,0,0,0,0,0,0,0,0,0,1637,240,30,120,207,1
2020,610800301,357556,101006,101006,51006,0,256550,253000,63000,190000,0,3550,3550,0,0,89000,28000,28000,0,4600,500,400,150,250,2487
2020,610800311,614,614,414,414,200,0,0,0,0,0,0,0,0,0,0,0,0,0,2024,420,20,300,84,30
2020,610800331,20686,20346,6346,6346,14000,340,0,0,0,0,340,340,0,0,5350,5350,4620,360,3144,720,20,480,144,471
2020,610800361,940,940,340,340,600,0,0,0,0,0,0,0,0,0,0,0,0,0,293,120,20,10,19,1
2020,610800371,48132,9632,9632,9632,0,38500,37000,30000,7000,0,1500,900,600,0,3000,0,0,0,1564,120,140,150,144,121
2020,610800381,100,100,100,100,0,0,0,0,0,0,0,0,0,0,300,300,0,300,1836,368,72,84,156,30
2020,610900141,220626,626,626,626,0,220000,220000,220000,0,0,0,0,0,0,0,0,0,0,6097,600,300,41,86,181
2020,610900181,8412,8412,2412,2412,6000,0,0,0,0,0,0,0,0,0,2500,2500,0,2500,2039,81,20,120,120,11
2020,610900201,9840,4840,4840,2840,0,5000,5000,5000,0,0,0,0,0,0,2000,2000,2000,0,1446,96,50,240,120,7
2020,610900211,28609,9127,9127,9127,0,19482,18000,18000,0,0,1482,1400,82,0,12675,12675,0,12300,6690,240,900,1080,360,632
2020,610900221,21734,5184,5184,4684,0,16550,14100,13600,500,0,2450,2200,200,50,2700,2700,2700,0,3306,960,10,480,216,181
2020,610900241,5552,2652,1652,1652,1000,2900,2400,0,2400,0,500,0,500,0,600,600,0,0,1096,600,50,10,66,8
2020,610900261,4210,3210,2210,1710,1000,1000,0,0,0,0,1000,0,1000,0,0,0,0,0,992,320,12,86,48,7
2020,610900271,31419,8893,8893,8893,0,22526,22000,22000,0,0,526,300,226,0,16442,3042,3000,0,1828,550,120,300,120,52
2020,610900301,80225,18950,18950,17950,0,61275,60000,60000,0,0,1275,1000,275,0,0,0,0,0,5860,500,200,200,200,1914
2020,610900311,18870,18570,5570,2570,13000,300,0,0,0,0,300,300,0,0,8780,8780,8000,750,2360,630,240,300,240,121
2020,610900331,30350,150,150,150,0,30200,30000,30000,0,0,200,200,0,0,16000,0,0,0,2294,150,340,260,115,246
2020,610900351,520,520,20,20,500,0,0,0,0,0,0,0,0,0,0,0,0,0,1375,400,50,320,90,78
2020,610900361,14410,1410,1410,1410,0,13000,12000,12000,0,0,1000,700,300,0,5080,5080,5000,0,3317,177,70,540,402,60
2020,610900381,42600,2950,2950,2950,0,39650,38000,38000,0,0,1650,1600,50,0,3000,3000,3000,0,4248,278,100,200,200,664
2020,610900391,53839,16079,16079,14579,0,37760,35000,35000,0,0,2760,2760,0,0,5125,5125,0,3000,3690,360,250,840,240,606
2020,611000102,29190,6060,560,560,5500,23130,15000,0,15000,0,8130,130,0,8000,15100,15100,13700,1000,1046,204,50,360,36,18
2020,611000132,203800,15000,15000,15000,0,188800,160000,160000,0,0,28800,28800,0,0,0,0,0,0,8400,600,200,1200,240,6039
2020,611000152,43310,7310,7310,7310,0,36000,35000,35000,0,0,1000,1000,0,0,0,0,0,0,1428,180,48,60,60,105
2020,611000172,41610,14410,14410,14410,0,27200,27000,27000,0,0,200,0,200,0,0,0,0,0,1982,240,120,12,240,95
2020,611000202,3050,3050,50,50,3000,0,0,0,0,0,0,0,0,0,3640,3640,0,3640,1391,156,0,48,60,1
2020,611000232,44863,44540,1540,1540,43000,323,0,0,0,0,323,300,23,0,0,0,0,0,2150,360,300,240,34,13
2020,611000242,37564,7564,7564,7564,0,30000,30000,30000,0,0,0,0,0,0,400,0,0,0,2902,60,12,240,360,31
2020,611000252,3720,3620,2620,2020,1000,100,0,0,0,0,100,0,0,100,1500,1500,0,0,1848,408,60,60,180,1
2020,611000262,6050,50,50,50,0,6000,6000,6000,0,0,0,0,0,0,0,0,0,0,505,55,200,15,10,7
2020,611000272,16704,1154,1154,1154,0,15550,6200,6000,200,0,9350,1750,0,7600,4500,4500,4500,0,1910,220,180,240,150,6
2020,611000292,74492,7492,7492,7492,0,67000,65000,60000,5000,0,2000,2000,0,0,0,0,0,0,4214,480,200,600,276,311
2020,611000302,64240,28790,13790,12790,15000,35450,35000,0,35000,0,450,400,50,0,7000,0,0,0,2874,90,1000,144,96,94
2020,611000332,20010,20010,10,10,20000,0,0,0,0,0,0,0,0,0,300,300,0,300,796,150,96,90,48,1
2020,611000352,1510,1510,10,10,1500,0,0,0,0,0,0,0,0,0,0,0,0,0,1183,360,50,10,28,1
2020,611000362,1742,1742,442,442,1300,0,0,0,0,0,0,0,0,0,0,0,0,0,1388,360,30,50,108,0
2020,611000372,12422,12422,422,422,12000,0,0,0,0,0,0,0,0,0,8000,8000,8000,0,2389,120,10,60,132,166
2020,611000382,61290,1140,1140,1140,0,60150,60000,50000,10000,0,150,150,0,0,5500,5500,5500,0,1329,108,48,240,48,60
2020,611000392,62640,7440,7440,7440,0,55200,55000,55000,0,0,200,200,0,0,3550,3550,3550,0,2609,200,20,200,99,598
2020,611600111,3020,3020,20,20,3000,0,0,0,0,0,0,0,0,0,5000,5000,0,0,1733,552,5,60,36,1
2020,611600121,2251,2251,1251,1251,1000,0,0,0,0,0,0,0,0,0,1581,1581,0,1581,1010,50,324,60,84,2
2020,611600131,67390,11390,11390,11390,0,56000,55000,40000,15000,0,1000,1000,0,0,3000,0,0,0,1694,180,120,110,120,175
2020,611600141,43338,7338,7338,7338,0,36000,36000,20000,16000,0,0,0,0,0,21800,10800,8800,2000,3952,180,90,180,200,781
2020,611600151,3150,3150,1150,1150,2000,0,0,0,0,0,0,0,0,0,700,700,0,0,1372,444,0,120,48,1
2020,611600181,1540,1540,40,40,1500,0,0,0,0,0,0,0,0,0,900,900,0,900,1000,336,10,36,90,0
2020,611600201,6870,3370,3370,3370,0,3500,3500,3500,0,0,0,0,0,0,0,0,0,0,1215,70,420,60,45,4
2020,611600211,20350,19750,1750,1750,18000,600,0,0,0,0,600,300,300,0,7000,7000,7000,0,2570,300,500,240,240,42
2020,611600231,650,650,650,650,0,0,0,0,0,0,0,0,0,0,982,982,0,432,1432,960,10,30,32,1
2020,611600241,10180,30,30,30,0,10150,10000,10000,0,0,150,150,0,0,2372,2372,1362,1000,1366,120,10,180,96,24
2020,611600261,23492,5142,5142,5142,0,18350,18000,0,18000,0,350,350,0,0,5150,150,0,100,2704,144,10,180,150,24
2020,611600281,13089,20,20,20,0,13069,13000,13000,0,0,69,0,69,0,0,0,0,0,394,168,36,12,24,15
2020,611600291,62820,8220,8220,8220,0,54600,51000,38000,13000,0,3600,3300,300,0,15030,4030,4000,0,2945,240,300,425,240,459
2020,611600311,630,630,430,430,200,0,0,0,0,0,0,0,0,0,3000,3000,0,0,473,80,0,20,48,0
2020,611600321,47541,2741,2741,2741,0,44800,42000,42000,0,0,2800,2800,0,0,11107,11107,6607,3300,4120,450,500,500,210,408
2020,611600331,162328,51148,6148,6148,45000,111180,110000,0,110000,0,1180,1180,0,0,51098,10098,8727,1371,6674,360,240,264,240,1425
2020,611600341,125951,29916,29916,29216,0,96035,93150,75000,18150,0,2885,2850,35,0,0,0,0,0,6200,450,250,500,400,639
2020,611600371,73700,100,100,100,0,73600,73500,40000,33500,0,100,100,0,0,10873,5873,5873,0,1347,140,150,180,72,98
2020,611600381,148712,8712,8712,8712,0,140000,140000,140000,0,0,0,0,0,0,15490,15490,15340,0,4561,450,137,40,108,601
2020,611700101,66290,5790,5790,5790,0,60500,60000,60000,0,0,500,500,0,0,0,0,0,0,7136,420,930,700,336,582
2020,611700111,64516,60590,24590,24590,36000,3926,3000,0,3000,0,926,700,226,0,0,0,0,0,3886,240,80,480,276,576
2020,611700121,69166,666,666,666,0,68500,68000,68000,0,0,500,500,0,0,26500,500,0,500,3840,480,100,360,180,51
2020,611700151,88119,2354,2354,2354,0,85765,85000,85000,0,0,765,450,315,0,9140,9140,9040,100,3347,77,50,50,156,489
2020,611700171,47850,1350,1350,1350,0,46500,45000,45000,0,0,1500,1500,0,0,10000,10000,10000,0,3380,130,80,180,300,1724
2020,611700181,24640,24640,1640,1640,23000,0,0,0,0,0,0,0,0,0,300,300,0,0,2280,250,500,100,120,11
2020,611700201,23364,1724,1724,1724,0,21640,19000,19000,0,0,2640,2500,140,0,15020,15020,12400,2220,4115,284,120,432,180,38
2020,611700221,16125,125,125,125,0,16000,16000,16000,0,0,0,0,0,0,0,0,0,0,564,72,48,24,36,19
2020,611700251,37044,3644,3644,3644,0,33400,32500,18000,14500,0,900,900,0,0,300,0,0,0,1625,200,100,300,150,49
2020,611700261,3965,3665,1665,1665,2000,300,0,0,0,0,300,0,300,0,0,0,0,0,790,60,100,20,40,7
2020,611700291,200,200,200,200,0,0,0,0,0,0,0,0,0,0,0,0,0,0,545,140,100,10,15,6
2020,611700301,2126,2126,626,626,1500,0,0,0,0,0,0,0,0,0,80,80,0,0,2030,636,300,72,108,3
2020,611700321,9500,9500,1000,1000,8500,0,0,0,0,0,0,0,0,0,1680,1680,0,1680,1222,100,150,72,120,66
2020,611700331,41027,2007,2007,2007,0,39020,38000,38000,0,0,1020,1020,0,0,0,0,0,0,2468,320,120,168,300,151
2020,611700371,34790,19490,19490,19490,0,15300,15000,15000,0,0,300,300,0,0,12000,12000,0,12000,3560,420,30,300,240,68
2020,611700381,210,210,10,10,200,0,0,0,0,0,0,0,0,0,1000,1000,0,1000,1146,250,10,120,96,2
2020,611800131,1150,1150,750,750,400,0,0,0,0,0,0,0,0,0,0,0,0,0,1408,480,10,96,72,1
2020,611800141,6968,3968,3968,3968,0,3000,0,0,0,0,3000,3000,0,0,2970,2970,500,2470,3466,480,36,240,180,72
2020,611800161,19560,19010,10010,10010,9000,550,0,0,0,0,550,450,100,0,50,50,0,0,1126,66,20,100,90,27
2020,611800201,45538,22340,6340,6340,16000,23198,22000,0,22000,0,1198,1150,48,0,22384,6384,6384,0,1728,160,40,260,98,63
2020,611800241,219670,36170,36170,36170,0,183500,181500,72000,109500,0,2000,2000,0,0,82000,73000,65000,8000,4580,380,250,150,210,1755
2020,611800261,22140,3140,2140,2140,1000,19000,18000,0,18000,0,1000,1000,0,0,0,0,0,0,3120,600,20,500,360,86
2020,611800271,1938,1638,1138,1138,500,300,0,0,0,0,300,0,300,0,240,240,0,0,2056,780,10,120,150,19
2020,611800281,17580,2500,2500,2500,0,15080,15000,15000,0,0,80,80,0,0,0,0,0,0,2077,520,240,180,142,22
2020,611800291,22138,21332,6332,6332,15000,806,0,0,0,0,806,790,16,0,9000,9000,0,0,4991,240,360,180,180,461
2020,611800301,65300,5300,5300,5300,0,60000,60000,60000,0,0,0,0,0,0,0,0,0,0,950,300,500,10,30,71
2020,611800331,64890,28590,5590,5460,23000,36300,33700,0,20000,13700,2600,2600,0,0,19200,16200,13700,0,3933,338,100,250,250,337
2020,611800341,235136,4936,4936,4936,0,230200,230000,70000,160000,0,200,200,0,0,78869,28869,23869,5000,3000,360,50,360,360,827
2020,611800371,237,237,12,12,225,0,0,0,0,0,0,0,0,0,0,0,0,0,919,180,20,28,90,1
2020,611800391,44992,11292,11292,8292,0,33700,31000,18000,13000,0,2700,700,0,2000,9560,8560,8060,0,3530,600,100,350,180,1442
2020,611900101,2096,2096,1796,1796,300,0,0,0,0,0,0,0,0,0,0,0,0,0,940,500,30,20,30,4
2020,611900121,469300,157300,157300,157300,0,312000,300000,180000,120000,0,12000,12000,0,0,0,0,0,0,8240,1000,40,260,250,2456
2020,611900141,24452,2152,2152,2152,0,22300,20000,20000,0,0,2300,2300,0,0,6300,6300,6000,300,2640,150,70,240,240,144
2020,611900151,7700,7700,2700,2700,5000,0,0,0,0,0,0,0,0,0,0,0,0,0,1216,96,10,150,80,9
2020,611900171,1,1,1,1,0,0,0,0,0,0,0,0,0,0,0,0,0,0,764,400,10,10,14,0
2020,611900211,6394,6194,2194,2194,4000,200,0,0,0,0,200,200,0,0,0,0,0,0,1025,310,15,100,90,9
2020,611900221,34158,150,150,150,0,34008,16708,10000,6708,0,17300,15300,0,2000,4540,4540,2100,2440,1750,120,20,480,60,59
2020,611900231,36696,15816,15816,15816,0,20880,19000,19000,0,0,1880,1780,100,0,19726,19726,11000,7766,4130,300,200,600,200,532
2020,611900241,41204,1204,1204,1204,0,40000,40000,0,40000,0,0,0,0,0,0,0,0,0,996,240,60,120,96,21
2020,611900251,8290,8290,4290,4290,4000,0,0,0,0,0,0,0,0,0,0,0,0,0,4490,360,720,360,330,52
2020,611900261,10892,4242,3942,3242,300,6650,0,0,0,0,6650,4650,2000,0,0,0,0,0,3390,480,10,360,280,278
2020,611900291,1205,1100,900,900,200,105,0,0,0,0,105,0,105,0,0,0,0,0,2251,280,20,380,51,36
2020,611900311,5700,5700,200,200,5500,0,0,0,0,0,0,0,0,0,0,0,0,0,724,84,15,15,50,1
2020,611900321,61860,11360,11360,11360,0,50500,50000,50000,0,0,500,500,0,0,1000,0,0,0,1910,120,120,180,120,185
2020,611900331,44640,3840,3840,3840,0,40800,40000,0,40000,0,800,800,0,0,4100,4100,4100,0,5746,576,150,200,300,1020
2020,611900341,97910,67660,34660,24660,33000,30250,30000,0,30000,0,250,250,0,0,28033,12033,12000,0,5160,230,300,200,200,595
2020,611900351,459860,113360,113360,113360,0,346500,340000,120000,220000,0,6500,6500,0,0,0,0,0,0,25720,1200,120,800,600,1705
2020,611900381,20818,16018,14018,9018,2000,4800,0,0,0,0,4800,1800,0,3000,600,600,0,0,3358,720,60,600,120,27
2020,611900391,34150,2200,2200,2200,0,31950,29950,29950,0,0,2000,2000,0,0,21847,21847,17357,4490,1990,200,30,200,160,198
2020,612000132,2200,2200,200,200,2000,0,0,0,0,0,0,0,0,0,0,0,0,0,822,124,100,0,18,1
2020,612000142,1609,1609,9,9,1600,0,0,0,0,0,0,0,0,0,8832,8832,0,832,1237,288,4,192,144,0
2020,612000152,1305,1305,5,5,1300,0,0,0,0,0,0,0,0,0,0,0,0,0,870,84,30,10,36,0
2020,612000162,6050,6050,50,50,6000,0,0,0,0,0,0,0,0,0,0,0,0,0,515,120,120,5,10,1
2020,612000172,51436,23786,23786,18786,0,27650,27000,27000,0,0,650,650,0,0,0,0,0,0,2570,370,450,30,160,183
2020,612000202,17500,3000,3000,3000,0,14500,13000,13000,0,0,1500,1500,0,0,0,0,0,0,924,256,10,260,48,130
2020,612000212,8820,1820,1820,1820,0,7000,7000,7000,0,0,0,0,0,0,0,0,0,0,1120,120,20,50,30,7
2020,612000222,3930,3930,130,130,3800,0,0,0,0,0,0,0,0,0,200,200,200,0,1123,288,10,100,60,1
2020,612000242,18560,17810,1310,310,16500,750,0,0,0,0,750,550,200,0,1900,1900,0,1300,4776,204,60,720,312,172
2020,612000272,113068,10718,10718,8718,0,102350,91500,16500,75000,0,10850,50,5000,5800,30300,28300,27000,1000,3440,350,200,300,300,147
2020,612000282,96960,3960,3960,3960,0,93000,86000,74000,12000,0,7000,7000,0,0,48000,48000,48000,0,6060,120,120,600,360,268
2020,612000292,25700,700,700,700,0,25000,24000,24000,0,0,1000,900,100,0,0,0,0,0,1232,120,60,120,72,26
2020,612000302,3916,3916,916,916,3000,0,0,0,0,0,0,0,0,0,0,0,0,0,984,432,12,72,60,1
2020,612000312,3405,3405,105,105,3300,0,0,0,0,0,0,0,0,0,250,250,0,0,909,54,33,12,92,0
2020,612000332,48820,3320,3320,3240,0,45500,44000,44000,0,0,1500,1400,100,0,19781,19781,19731,0,4540,235,50,130,288,227
2020,612000342,6370,5570,5570,5570,0,800,0,0,0,0,800,800,0,0,6200,6200,4700,1500,1924,300,60,240,180,80
2020,612000352,119540,10340,10340,10340,0,109200,108000,70000,38000,0,1200,1200,0,0,32400,18400,11400,0,3730,650,150,500,180,1247
2020,612000372,20726,1726,1726,1726,0,19000,19000,14000,5000,0,0,0,0,0,2900,2900,2300,600,1580,120,10,150,100,33
2020,612000382,5550,5550,50,50,5500,0,0,0,0,0,0,0,0,0,0,0,0,0,566,80,12,10,24,1
2020,612000392,5100,5100,100,100,5000,0,0,0,0,0,0,0,0,0,982,982,982,0,680,120,10,10,60,1
2020,612600111,17340,17340,840,840,16500,0,0,0,0,0,0,0,0,0,7500,7500,0,7500,2200,280,250,260,160,1
2020,612600131,24430,130,130,130,0,24300,23500,23500,0,0,800,800,0,0,800,800,0,800,2526,218,100,132,192,61
2020,612600141,553,553,153,153,400,0,0,0,0,0,0,0,0,0,9520,9520,0,7978,1298,444,10,110,54,23
2020,612600151,9000,9000,7000,5000,2000,0,0,0,0,0,0,0,0,0,0,0,0,0,2515,1300,100,70,100,35
2020,612600161,78170,170,170,170,0,78000,78000,65000,13000,0,0,0,0,0,14030,4530,4530,0,1990,180,660,60,50,91
2020,612600181,30320,13020,3020,3020,10000,17300,17000,0,17000,0,300,300,0,0,12000,9000,9000,0,3570,480,10,240,240,116
2020,612600221,60,60,60,60,0,0,0,0,0,0,0,0,0,0,0,0,0,0,461,50,250,1,10,1
2020,612600241,32718,4598,4598,4598,0,28120,28000,28000,0,0,120,0,120,0,250,250,0,250,3931,235,1500,90,86,121
2020,612600261,26346,1346,1346,1346,0,25000,25000,25000,0,0,0,0,0,0,4600,0,0,0,1282,180,240,48,24,15
2020,612600271,380,380,30,30,350,0,0,0,0,0,0,0,0,0,0,0,0,0,749,240,10,36,48,1
2020,612600331,73220,14768,8768,8768,6000,58452,55000,0,55000,0,3452,3000,452,0,20050,20050,0,20000,4390,390,30,360,120,131
2020,612600351,28370,1920,1920,1920,0,26450,25800,25800,0,0,650,650,0,0,13000,13000,13000,0,3180,380,500,360,240,133
2020,612600381,31180,4230,4230,4230,0,26950,25000,25000,0,0,1950,450,1500,0,0,0,0,0,2008,340,40,150,168,55
2020,612600391,37528,1528,1528,1528,0,36000,28000,28000,0,0,8000,1000,0,7000,9104,9104,7824,1280,3050,260,390,520,270,24
2020,612700111,72060,11760,11760,8760,0,60300,60000,60000,0,0,300,300,0,0,0,0,0,0,3406,600,150,200,156,189
2020,612700121,130,130,20,20,110,0,0,0,0,0,0,0,0,0,0,0,0,0,1017,372,12,30,20,0
2020,612700151,30020,520,520,520,0,29500,29500,29500,0,0,0,0,0,0,0,0,0,0,956,112,264,10,30,57
2020,612700181,20210,5210,5210,5210,0,15000,15000,15000,0,0,0,0,0,0,2920,2920,1940,980,4454,240,100,84,120,18
2020,612700211,92102,1652,1652,1652,0,90450,89000,60000,29000,0,1450,1450,0,0,38802,29802,28802,1000,3650,420,300,360,180,434
2020,612700221,117624,10604,10604,10604,0,107020,105000,65000,40000,0,2020,1220,800,0,25000,0,0,0,3278,300,300,280,228,3253
2020,612700241,7100,2280,2280,1580,0,4820,0,0,0,0,4820,3800,1020,0,2509,2509,0,2409,5564,864,300,600,300,204
2020,612700261,43170,8670,8670,8670,0,34500,32000,32000,0,0,2500,2500,0,0,16000,16000,16000,0,3025,430,350,500,230,260
2020,612700281,25650,3000,3000,3000,0,22650,14000,14000,0,0,8650,1650,0,7000,0,0,0,0,1150,120,240,60,60,94
2020,612700291,10688,553,553,553,0,10135,10000,10000,0,0,135,0,135,0,0,0,0,0,627,156,20,25,36,12
2020,612700301,9293,9213,6213,6213,3000,80,0,0,0,0,80,80,0,0,0,0,0,0,1997,384,40,122,140,13
2020,612700311,83980,2280,2280,2280,0,81700,78000,36000,42000,0,3700,2700,1000,0,17833,17833,16000,300,2861,156,400,250,255,441
2020,612700321,81034,10434,10434,10434,0,70600,70000,70000,0,0,600,600,0,0,25500,25500,25500,0,1570,400,100,120,150,314
2020,612700331,26900,1300,1300,1300,0,25600,25000,25000,0,0,600,600,0,0,2620,2620,2620,0,2448,252,180,360,180,224
2020,612700351,5520,2620,620,620,2000,2900,0,0,0,0,2900,2900,0,0,2695,2695,0,0,1310,70,30,100,110,1
2020,612800101,19075,3240,3240,3240,0,15835,15000,15000,0,0,835,800,35,0,0,0,0,0,2216,180,60,200,120,33
2020,612800111,48565,10265,10265,10265,0,38300,38000,38000,0,0,300,0,300,0,0,0,0,0,3634,248,800,156,180,175
2020,612800131,10170,7820,7820,820,0,2350,0,0,0,0,2350,350,0,2000,12020,12020,0,3520,3260,840,50,360,180,172
2020,612800161,160460,45750,8250,8250,37500,114710,113000,0,113000,0,1710,1600,110,0,69000,30000,30000,0,4596,480,36,720,180,236
2020,612800171,84070,20370,20370,20370,0,63700,59000,59000,0,0,4700,3700,1000,0,156,156,0,0,3130,300,100,550,170,318
2020,612800201,13150,8050,8050,8050,0,5100,5000,5000,0,0,100,0,100,0,0,0,0,0,2848,156,290,115,72,14
2020,612800211,14047,1047,1047,1047,0,13000,13000,13000,0,0,0,0,0,0,3500,3500,3500,0,649,108,120,12,39,12
2020,612800221,2800,1300,300,300,1000,1500,0,0,0,0,1500,1500,0,0,0,0,0,0,2350,444,20,60,96,74
2020,612800231,30295,8795,8795,8795,0,21500,20000,20000,0,0,1500,1500,0,0,0,0,0,0,4620,500,300,250,200,73
2020,612800241,21355,2005,2005,2005,0,19350,19000,19000,0,0,350,350,0,0,5972,5972,5972,0,1618,244,330,300,84,34
2020,612800251,4300,4300,4300,4300,0,0,0,0,0,0,0,0,0,0,0,0,0,0,1405,103,120,12,26,1
2020,612800261,227,227,11,11,216,0,0,0,0,0,0,0,0,0,0,0,0,0,614,132,15,30,4,0
2020,612800271,227,227,7,7,220,0,0,0,0,0,0,0,0,0,0,0,0,0,622,144,80,32,24,0
2020,612800281,152520,20870,20870,20870,0,131650,131000,30000,101000,0,650,200,450,0,41018,10018,9968,0,5575,240,150,135,360,238
2020,612800291,353910,5982,5982,5982,0,347928,347000,37000,310000,0,928,250,678,0,6000,0,0,0,6220,480,360,360,360,269
2020,612800311,2175,1325,825,825,500,850,0,0,0,0,850,850,0,0,800,800,0,0,2481,576,60,240,240,79
2020,612800341,36630,33530,5530,1530,28000,3100,0,0,0,0,3100,0,1100,2000,27650,27650,22500,5000,4600,480,120,360,240,7
2020,612800351,34500,1500,1500,1500,0,33000,33000,25000,8000,0,0,0,0,0,0,0,0,0,1730,300,360,50,120,97
2020,612900111,9070,7570,4570,3570,3000,1500,0,0,0,0,1500,1500,0,0,500,500,0,0,5100,780,1000,480,300,104
2020,612900131,96103,22003,22003,22003,0,74100,74000,68000,6000,0,100,100,0,0,3000,3000,3000,0,3560,320,50,300,180,1060
2020,612900151,65350,300,300,300,0,65050,65000,65000,0,0,50,50,0,0,2000,2000,0,0,2114,360,840,24,120,68
2020,612900161,79736,3836,3836,3636,0,75900,75000,75000,0,0,900,900,0,0,700,700,0,700,4210,410,120,240,240,1969
2020,612900171,144700,30500,30500,30500,0,114200,114000,20000,94000,0,200,200,0,0,63000,0,0,0,2190,150,120,310,160,543
2020,612900191,3350,3350,2350,2350,1000,0,0,0,0,0,0,0,0,0,0,0,0,0,2737,600,5,108,144,109
2020,612900211,3887,1387,387,387,1000,2500,0,0,0,0,2500,2500,0,0,1400,1400,0,1200,2370,480,300,300,180,110
2020,612900221,48182,8912,8912,8912,0,39270,37000,37000,0,0,2270,2150,120,0,12163,12163,11543,0,3444,240,100,605,240,107
2020,612900231,500,500,400,400,100,0,0,0,0,0,0,0,0,0,0,0,0,0,447,146,10,21,24,0
2020,612900241,6030,6030,4530,4530,1500,0,0,0,0,0,0,0,0,0,0,0,0,0,1051,118,121,24,42,1
2020,612900261,14520,3320,3320,2320,0,11200,10000,10000,0,0,1200,600,600,0,2100,2100,2100,0,3100,180,120,180,360,88
2020,612900281,74460,26760,12260,8760,14500,47700,39000,0,39000,0,8700,1200,3000,4500,27300,300,0,0,3626,276,120,780,360,153
2020,612900311,40220,12820,12820,12820,0,27400,27000,27000,0,0,400,400,0,0,5688,5688,5688,0,3185,290,40,245,290,202
2020,612900321,36693,7293,7293,7293,0,29400,27950,24000,0,3950,1450,1220,230,0,2000,2000,0,0,3436,280,40,320,76,224
2020,612900331,66797,1797,1797,1797,0,65000,64000,42000,22000,0,1000,1000,0,0,500,0,0,0,3860,300,200,250,200,904
2020,612900351,2578,2578,2578,2578,0,0,0,0,0,0,0,0,0,0,1570,1570,0,1128,3320,300,150,180,240,54
2020,612900361,1185,485,65,65,420,700,0,0,0,0,700,700,0,0,573,573,0,0,1308,120,29,486,23,0
2020,612900381,134868,11068,11068,11068,0,123800,121000,56000,65000,0,2800,2800,0,0,55200,16200,10000,6200,4565,125,150,360,180,701
2020,612900391,76200,15200,15200,15200,0,61000,60000,60000,0,0,1000,1000,0,0,13000,13000,13000,0,4550,250,100,600,400,192
2020,613000102,59186,27460,27460,27460,0,31726,30000,30000,0,0,1726,1500,226,0,0,0,0,0,1282,300,50,100,72,278
2020,613000132,32896,1496,1496,1496,0,31400,31000,31000,0,0,400,400,0,0,11920,11920,11920,0,3014,180,60,150,200,54
2020,613000142,30525,225,225,225,0,30300,30000,30000,0,0,300,300,0,0,0,0,0,0,1470,240,100,100,50,70
2020,613000152,17590,2190,2190,2190,0,15400,15400,12400,3000,0,0,0,0,0,800,800,800,0,1092,150,200,120,42,21
2020,613000162,2,2,2,2,0,0,0,0,0,0,0,0,0,0,0,0,0,0,300,10,50,10,10,1
2020,613000192,50850,750,750,750,0,50100,50000,50000,0,0,100,100,0,0,6000,6000,6000,0,1740,240,70,240,60,112
2020,613000202,21640,1840,1840,1840,0,19800,19800,19800,0,0,0,0,0,0,3000,0,0,0,3170,180,150,300,180,31
2020,613000222,17820,70,70,70,0,17750,17500,17500,0,0,250,250,0,0,2100,2100,2000,0,2400,240,120,300,324,43
2020,613000252,155310,5810,5810,5810,0,149500,140000,140000,0,0,9500,7000,2500,0,67020,62520,62520,0,5317,324,30,480,276,308
2020,613000272,19450,450,250,250,200,19000,18000,0,18000,0,1000,1000,0,0,5535,4535,1835,2700,2118,355,0,360,73,296
2020,613000302,555,555,55,55,500,0,0,0,0,0,0,0,0,0,1200,1200,0,1100,2194,630,80,324,360,49
2020,613000312,38909,8409,8409,8409,0,30500,30000,30000,0,0,500,500,0,0,19000,19000,19000,0,6460,400,60,500,300,62
2020,613000332,17258,1858,1858,1858,0,15400,15000,15000,0,0,400,400,0,0,6200,6200,5000,1200,3600,118,300,280,300,25
2020,613000342,31100,1100,1100,1100,0,30000,30000,10000,20000,0,0,0,0,0,0,0,0,0,1850,780,60,50,60,162
2020,613000352,22250,4250,4250,4250,0,18000,18000,18000,0,0,0,0,0,0,6850,6850,6400,450,1640,300,100,100,180,28
2020,613000362,18770,490,490,490,0,18280,18000,18000,0,0,280,0,280,0,7400,7400,6400,1000,2892,224,120,120,180,15
2020,613000372,24580,1380,1380,1380,0,23200,23000,23000,0,0,200,200,0,0,6200,6200,6200,0,1980,420,120,240,180,92
2020,613000382,23260,260,260,260,0,23000,23000,23000,0,0,0,0,0,0,0,0,0,0,2202,360,150,150,192,61
2020,613600111,42026,2026,2026,2026,0,40000,40000,40000,0,0,0,0,0,0,0,0,0,0,2720,320,350,160,130,268
2020,613600131,9210,8410,410,410,8000,800,0,0,0,0,800,800,0,0,40,40,0,0,4216,486,10,400,210,31
2020,613600141,59932,4012,4012,3012,0,55920,55000,19000,36000,0,920,600,320,0,19300,17800,17800,0,3840,300,300,240,240,108
2020,613600171,15200,200,200,200,0,15000,15000,15000,0,0,0,0,0,0,0,0,0,0,965,180,30,12,18,15
2020,613600181,18100,5100,5100,5100,0,13000,13000,10000,3000,0,0,0,0,0,0,0,0,0,1345,144,302,10,78,12
2020,613600201,40008,8388,8388,8388,0,31620,30000,30000,0,0,1620,1500,120,0,0,0,0,0,4144,314,100,480,250,1410
2020,613600211,7100,4100,1500,500,2600,3000,0,0,0,0,3000,0,0,3000,0,0,0,0,1324,100,120,80,124,13
2020,613600221,4390,4390,2590,2590,1800,0,0,0,0,0,0,0,0,0,0,0,0,0,809,185,86,60,30,1
2020,613600231,245,245,5,5,240,0,0,0,0,0,0,0,0,0,1000,1000,0,0,1509,180,10,100,216,1
2020,613600241,27110,4060,4060,4060,0,23050,23000,20000,3000,0,50,0,50,0,700,0,0,0,749,59,40,20,30,138
2020,613600251,52980,8480,8480,8480,0,44500,42000,42000,0,0,2500,2500,0,0,19320,19320,19320,0,4430,420,100,260,310,137
2020,613600261,112000,5500,5500,5500,0,106500,106500,45000,61500,0,0,0,0,0,0,0,0,0,908,80,20,60,48,215
2020,613600271,1800,1800,300,300,1500,0,0,0,0,0,0,0,0,0,12300,12300,0,2600,1804,384,600,100,80,1
2020,613600321,510,510,10,10,500,0,0,0,0,0,0,0,0,0,0,0,0,0,1211,372,480,12,22,1
2020,613600331,33540,1940,1940,1940,0,31600,30000,30000,0,0,1600,1600,0,0,0,0,0,0,2060,240,240,360,180,137
2020,613600361,23496,22296,2296,2296,20000,1200,0,0,0,0,1200,1200,0,0,12000,12000,0,12000,1300,90,10,180,40,90
2020,613600371,44241,30137,137,137,30000,14104,11220,0,0,11220,2884,2884,0,0,22473,22473,0,22440,1763,276,100,100,97,376
2020,613600381,29761,7261,7261,7261,0,22500,20000,20000,0,0,2500,2500,0,0,16,16,0,0,3580,240,30,600,240,221
2020,613700101,35045,45,45,45,0,35000,35000,35000,0,0,0,0,0,0,3830,3830,3800,0,854,180,50,24,60,21
2020,613700121,248200,3700,3700,3700,0,244500,240000,80000,160000,0,4500,4500,0,0,165000,105000,105000,0,5700,600,300,400,300,1506
2020,613700141,20518,3518,3518,3518,0,17000,17000,17000,0,0,0,0,0,0,8789,8789,4969,3800,2652,120,350,55,27,12
2020,613700151,5146,5146,3146,3146,2000,0,0,0,0,0,0,0,0,0,700,700,0,0,1708,1134,12,60,108,5
2020,613700171,6080,6080,80,80,6000,0,0,0,0,0,0,0,0,0,0,0,0,0,783,130,150,15,48,1
2020,613700211,52163,9050,9050,9050,0,43113,38000,25000,13000,0,5113,5000,113,0,5000,0,0,0,3138,240,50,204,144,264
2020,613700221,209010,23650,23650,23650,0,185360,180000,150000,30000,0,5360,5150,210,0,32500,20000,20000,0,4450,392,18,696,144,1660
2020,613700231,25601,25550,20550,20550,5000,51,0,0,0,0,51,0,51,0,0,0,0,0,3192,1080,120,120,192,20
2020,613700241,66350,1250,1250,1250,0,65100,65000,32000,33000,0,100,0,100,0,28200,2200,0,0,1292,231,84,24,36,75
2020,613700261,23700,7550,7550,7550,0,16150,16000,16000,0,0,150,50,100,0,100,0,0,0,3214,180,200,220,244,67
2020,613700301,10400,3400,3400,3400,0,7000,7000,7000,0,0,0,0,0,0,0,0,0,0,968,170,150,60,88,9
2020,613700321,34600,5400,5400,5400,0,29200,29000,29000,0,0,200,200,0,0,0,0,0,0,1664,216,50,180,48,76
2020,613700331,11630,2930,2930,2930,0,8700,7500,0,7500,0,1200,1200,0,0,1300,1300,0,1200,3676,480,100,200,300,41
2020,613700351,11610,4260,3260,3260,1000,7350,7000,0,7000,0,350,250,100,0,6060,60,0,0,2600,500,100,300,100,298
2020,613700361,670,670,670,670,0,0,0,0,0,0,0,0,0,0,0,0,0,0,760,120,135,25,48,1
2020,613700371,5005,5005,5,5,5000,0,0,0,0,0,0,0,0,0,0,0,0,0,492,72,24,24,24,1
2020,613700391,1400,1400,900,900,500,0,0,0,0,0,0,0,0,0,0,0,0,0,1886,816,12,36,84,3
2020,613800101,52650,3930,3930,3930,0,48720,42720,42000,720,0,6000,500,0,5500,2700,2700,0,2700,3988,290,3000,10,48,40
2020,613800121,1570,1570,640,640,930,0,0,0,0,0,0,0,0,0,800,800,800,0,1364,360,100,180,120,15
2020,613800131,5360,5360,1060,1060,4300,0,0,0,0,0,0,0,0,0,2700,2700,2700,0,1126,144,30,20,192,58
2020,613800151,3744,3394,3394,3394,0,350,0,0,0,0,350,350,0,0,1230,1230,0,1100,2940,360,60,240,240,83
2020,613800161,43500,40900,10900,10900,30000,2600,1400,0,0,1400,1200,1200,0,0,11000,11000,1000,0,3432,240,12,180,120,251
2020,613800171,10082,9482,9482,9482,0,600,0,0,0,0,600,600,0,0,0,0,0,0,1845,160,62,204,85,100
2020,613800191,49465,31165,9165,9165,22000,18300,15000,0,15000,0,3300,3300,0,0,11000,9000,8000,0,2786,180,70,200,156,23
2020,613800201,14043,43,43,43,0,14000,14000,14000,0,0,0,0,0,0,13700,7400,0,900,784,102,67,41,75,21
2020,613800211,41990,3800,3800,1300,0,38190,30500,27000,3500,0,7690,3800,990,2900,2800,0,0,0,1812,132,25,216,93,61
2020,613800231,2500,2000,1000,1000,1000,500,0,0,0,0,500,500,0,0,0,0,0,0,1950,670,80,250,120,20
2020,613800241,47251,9371,9371,9371,0,37880,36000,16000,20000,0,1880,1880,0,0,1500,1500,0,1500,3540,340,150,480,380,84
2020,613800301,178224,14824,14824,12824,0,163400,160000,90000,70000,0,3400,1400,0,2000,55000,0,0,0,4810,400,10,600,240,1052
2020,613800321,9175,175,175,175,0,9000,9000,9000,0,0,0,0,0,0,0,0,0,0,651,144,72,10,20,10
2020,613800331,85910,110,110,110,0,85800,85000,30000,55000,0,800,800,0,0,22850,22850,22850,0,2190,340,300,200,240,131
2020,613800341,55550,450,450,450,0,55100,54500,16500,38000,0,600,600,0,0,0,0,0,0,792,120,30,50,36,271
2020,613800351,59171,1218,1218,1218,0,57953,57250,31500,25750,0,703,703,0,0,10733,10733,10600,0,3243,310,360,287,119,156
2020,613800361,37042,4090,4090,4090,0,32952,31500,31500,0,0,1452,1452,0,0,0,0,0,0,3006,420,300,270,96,306
2020,613900101,19790,2790,2790,2790,0,17000,17000,17000,0,0,0,0,0,0,5864,5864,5864,0,1020,130,40,85,85,35
2020,613900131,3520,3480,3480,3480,0,40,0,0,0,0,40,40,0,0,0,0,0,0,1855,180,450,110,100,26
2020,613900141,650,650,150,150,500,0,0,0,0,0,0,0,0,0,0,0,0,0,1285,478,200,36,32,1
2020,613900161,56540,6540,6540,6540,0,50000,50000,22000,28000,0,0,0,0,0,5000,0,0,0,3930,240,800,420,360,522
2020,613900171,32300,29300,5300,5300,24000,3000,0,0,0,0,3000,3000,0,0,6000,6000,6000,0,2930,180,220,300,230,562
2020,613900191,146020,7120,7120,7120,0,138900,131000,100000,31000,0,7900,600,300,7000,21000,0,0,0,2026,196,700,36,180,346
2020,613900221,972,972,612,612,360,0,0,0,0,0,0,0,0,0,0,0,0,0,1230,50,400,100,0,1
2020,613900241,21806,706,706,706,0,21100,16000,16000,0,0,5100,2050,50,3000,5432,5432,2350,3082,3869,420,140,386,338,90
2020,613900251,14240,940,940,940,0,13300,13000,13000,0,0,300,300,0,0,0,0,0,0,2726,180,60,80,240,65
2020,613900261,67356,7456,7456,5456,0,59900,33000,33000,0,0,26900,3900,19000,4000,23280,23280,22680,600,3710,610,30,350,260,85
2020,613900321,6045,45,45,45,0,6000,6000,6000,0,0,0,0,0,0,0,0,0,0,675,150,100,10,12,15
2020,613900371,58075,7625,7625,7625,0,50450,45000,35000,10000,0,5450,4200,1250,0,15000,9000,7000,1700,2222,168,60,240,288,275
2020,614000102,25618,118,118,118,0,25500,25000,25000,0,0,500,500,0,0,3020,3020,2800,0,1220,72,250,90,60,23
2020,614000112,120550,550,550,550,0,120000,120000,120000,0,0,0,0,0,0,20,20,0,0,1162,280,72,60,150,104
2020,614000122,87341,2841,2841,2841,0,84500,84000,84000,0,0,500,500,0,0,23000,23000,20000,3000,3956,240,50,66,160,508
2020,614000132,48535,48535,23535,23535,25000,0,0,0,0,0,0,0,0,0,0,0,0,0,1650,204,50,120,156,773
2020,614000142,195202,72702,7702,7702,65000,122500,120000,0,120000,0,2500,2500,0,0,0,0,0,0,3390,480,100,150,200,4026
2020,614000152,169800,49800,49800,49800,0,120000,120000,120000,0,0,0,0,0,0,26427,26427,26347,0,3140,360,260,360,120,1313
2020,614000162,3100,3100,2100,2100,1000,0,0,0,0,0,0,0,0,0,0,0,0,0,4091,1440,1,120,360,1
2020,614000172,3010,3010,10,10,3000,0,0,0,0,0,0,0,0,0,0,0,0,0,4194,840,700,240,264,46
2020,614000182,3800,3800,3800,3800,0,0,0,0,0,0,0,0,0,0,0,0,0,0,1566,60,60,84,62,396
2020,614000192,31735,29335,18335,18335,11000,2400,0,0,0,0,2400,2400,0,0,7100,7100,7100,0,1583,50,10,378,102,99
2020,614000322,49620,19120,19120,19120,0,30500,30000,30000,0,0,500,500,0,0,0,0,0,0,1980,264,420,120,24,68
2020,614000332,25580,8080,7580,1580,500,17500,0,0,0,0,17500,2500,15000,0,11000,11000,0,0,1411,600,0,25,72,32
2020,614000342,25328,25328,1828,1828,23500,0,0,0,0,0,0,0,0,0,5000,5000,0,5000,2313,120,30,48,180,146
2020,614000362,83880,9080,9080,9080,0,74800,70000,30000,40000,0,4800,4800,0,0,0,0,0,0,4950,180,15,600,108,143
2020,614000372,373340,71840,71840,71840,0,301500,300000,100000,200000,0,1500,1500,0,0,89780,19780,19780,0,7940,1800,120,480,240,7342
2020,614000392,30783,183,183,183,0,30600,30000,30000,0,0,600,600,0,0,1400,1400,1400,0,2128,297,350,322,197,291
2020,614600111,63250,3000,3000,3000,0,60250,60000,55000,5000,0,250,250,0,0,0,0,0,0,1545,170,120,255,30,323
2020,614600131,28180,150,150,150,0,28030,28000,28000,0,0,30,30,0,0,0,0,0,0,950,200,220,70,60,58
2020,614600141,32100,100,100,100,0,32000,32000,25000,7000,0,0,0,0,0,2000,0,0,0,1350,250,60,120,50,119
2020,614600161,76675,35875,9875,9875,26000,40800,40000,0,40000,0,800,800,0,0,21000,1000,0,1000,3296,576,50,110,240,1270
2020,614600191,299080,24580,24580,19580,0,274500,270000,160000,110000,0,4500,4500,0,0,43000,3000,3000,0,4076,1800,80,400,260,879
2020,614600301,123820,6420,6420,6420,0,117400,115000,115000,0,0,2400,1500,900,0,18000,18000,12000,6000,4696,240,750,252,288,5456
2020,614600311,32130,9340,9340,9340,0,22790,20000,20000,0,0,2790,2700,90,0,5550,5550,5000,500,1860,200,170,160,170,424
2020,614600321,54708,47208,14208,14208,33000,7500,5200,0,0,5200,2300,2300,0,0,30,30,0,0,3750,250,130,300,160,831
2020,614600341,57500,500,500,500,0,57000,55000,55000,0,0,2000,2000,0,0,0,0,0,0,1030,190,80,170,70,532
2020,614600361,167460,34060,34060,24060,0,133400,120000,100000,20000,0,13400,3400,0,10000,9000,0,0,0,8400,600,100,840,200,11059
2020,614600371,114370,34370,10770,10770,23600,80000,80000,0,80000,0,0,0,0,0,36000,0,0,0,3458,288,24,120,266,380
2020,614700101,150850,850,850,850,0,150000,150000,150000,0,0,0,0,0,0,0,0,0,0,1541,400,310,130,120,263
2020,614700111,20770,19370,7370,7170,12000,1400,0,0,0,0,1400,1400,0,0,2600,2600,2500,0,760,80,10,200,70,43
2020,614700121,136169,12569,12569,12569,0,123600,121000,100000,21000,0,2600,2600,0,0,1000,0,0,0,3500,400,300,350,120,885
2020,614700131,96640,25840,25840,25840,0,70800,70000,0,70000,0,800,800,0,0,43000,6000,0,6000,3080,240,200,100,200,119
2020,614700151,50818,9318,9318,9318,0,41500,38000,38000,0,0,3500,3500,0,0,9800,9800,9800,0,4960,360,50,420,300,544
2020,614700341,141022,42240,42240,40240,0,98782,98000,48000,50000,0,782,330,452,0,0,0,0,0,2635,285,80,125,130,177
2020,614700351,647840,66040,66040,66040,0,581800,530000,330000,200000,0,51800,6300,5500,40000,305000,175000,112000,63000,12720,960,1200,480,360,38456
2020,614700361,71370,32880,32880,31380,0,38490,35000,35000,0,0,3490,2290,1200,0,7000,7000,7000,0,4480,300,360,1200,120,160
2020,614700371,113790,39190,5190,5190,34000,74600,68000,0,68000,0,6600,4600,2000,0,66760,28760,23760,5000,5660,320,280,630,310,1661
2020,614700391,28045,15245,15245,15245,0,12800,11000,11000,0,0,1800,1500,300,0,8860,8860,2500,5860,4024,180,170,480,350,48
2020,614800101,103180,29990,29990,29990,0,73190,64500,11500,53000,0,8690,6660,2030,0,5000,0,0,0,2795,470,250,320,180,487
2020,614800131,555,555,55,55,500,0,0,0,0,0,0,0,0,0,0,0,0,0,1479,372,15,48,84,1
2020,614800141,290,290,20,20,270,0,0,0,0,0,0,0,0,0,0,0,0,0,749,144,20,20,15,1
2020,614800151,192,192,42,42,150,0,0,0,0,0,0,0,0,0,800,800,0,0,1044,144,40,60,20,0
2020,614800161,50044,43544,8544,8544,35000,6500,6000,0,0,6000,500,500,0,0,29000,29000,20000,9000,1620,180,10,240,100,1583
2020,614800171,7561,6761,4311,2761,2450,800,0,0,0,0,800,0,0,800,650,650,0,0,3786,384,264,1200,108,12
2020,614800181,6844,6844,844,844,6000,0,0,0,0,0,0,0,0,0,3210,3210,3210,0,1725,149,105,125,96,8
2020,614800311,56422,4102,4102,4102,0,52320,50000,50000,0,0,2320,2320,0,0,37000,37000,20000,14000,8295,420,360,560,365,2370
2020,614800331,194270,3000,3000,3000,0,191270,190000,50000,140000,0,1270,1270,0,0,116600,90000,90000,0,2510,240,60,120,60,267
2020,614800341,22520,620,620,120,0,21900,20000,20000,0,0,1900,200,700,1000,700,700,0,700,1836,240,420,180,48,70
2020,614800361,23450,10850,8850,8850,2000,12600,12000,0,12000,0,600,600,0,0,11300,11300,7950,3350,2300,300,100,100,100,132
2020,614800371,179940,55440,55440,55440,0,124500,124000,45000,79000,0,500,200,300,0,34000,31000,31000,0,4043,360,120,480,120,3358
2020,614800381,93400,47500,2500,2500,45000,45900,45000,0,0,45000,900,900,0,0,20000,20000,20000,0,3814,360,120,444,300,590
2020,614800391,4250,4250,250,250,4000,0,0,0,0,0,0,0,0,0,4900,4900,2200,1900,2747,310,600,120,200,1
2020,614900101,32020,12020,12020,12020,0,20000,20000,20000,0,0,0,0,0,0,3100,3100,0,3100,1984,220,20,200,204,883
2020,614900121,89920,420,420,420,0,89500,85000,85000,0,0,4500,4500,0,0,34000,34000,34000,0,5530,360,50,240,80,925
2020,614900141,54120,2220,2220,2220,0,51900,50000,50000,0,0,1900,1900,0,0,27400,27400,27400,0,1168,156,100,60,72,120
2020,614900151,34136,436,436,436,0,33700,32000,32000,0,0,1700,1700,0,0,17288,17288,15600,840,1680,180,60,120,120,113
2020,614900161,26180,22660,12660,12660,10000,3520,3220,0,3220,0,300,300,0,0,0,0,0,0,4270,540,36,540,264,134
2020,614900321,26349,4499,4499,1699,0,21850,21000,21000,0,0,850,650,200,0,8440,8440,7440,1000,3719,324,124,485,125,18
2020,614900341,48070,13070,2070,2070,11000,35000,35000,0,35000,0,0,0,0,0,3000,0,0,0,1028,120,66,36,24,34
2020,614900361,12408,10908,10908,10908,0,1500,0,0,0,0,1500,1500,0,0,38900,38900,33200,5700,3620,350,200,350,120,1156
2020,614900371,38440,6440,6440,6440,0,32000,32000,26000,6000,0,0,0,0,0,17557,17057,17057,0,3043,276,600,120,67,81
2020,614900381,27332,21532,1732,1732,19800,5800,5000,0,0,5000,800,800,0,0,16900,16900,16000,0,1910,240,400,480,240,47
2020,615000102,62730,130,130,130,0,62600,61000,51000,10000,0,1600,1600,0,0,10000,2000,0,0,7619,179,1200,600,420,358
2020,615000112,21004,18004,8004,7004,10000,3000,0,0,0,0,3000,0,0,3000,2520,2520,0,2520,2124,912,150,70,240,48
2020,615000122,43056,1856,1856,1856,0,41200,40000,40000,0,0,1200,1200,0,0,9000,9000,8700,0,3604,360,10,144,180,198
2020,615000132,45948,3148,3148,3148,0,42800,40000,40000,0,0,2800,2800,0,0,0,0,0,0,1854,288,100,100,84,28
2020,615000152,10,10,10,10,0,0,0,0,0,0,0,0,0,0,0,0,0,0,278,80,10,38,6,1
2020,615000162,1237700,805000,805000,805000,0,432700,432000,100000,332000,0,700,700,0,0,48200,18320,18320,0,7660,1380,500,200,280,6197
2020,615000182,6800,6800,5800,5800,1000,0,0,0,0,0,0,0,0,0,6736,6736,0,4336,2720,100,110,180,120,2
2020,615000192,54577,3377,3377,3377,0,51200,50400,50400,0,0,800,800,0,0,11750,7750,7000,750,2099,175,100,284,240,138
2020,615000302,26155,25635,8635,8635,17000,520,0,0,0,0,520,520,0,0,11000,11000,0,11000,2548,268,24,600,300,104
2020,615000322,2100,2100,100,100,2000,0,0,0,0,0,0,0,0,0,600,600,0,0,2570,120,300,960,360,161
2020,615000332,30500,2500,2500,2500,0,28000,26000,26000,0,0,2000,2000,0,0,15193,15193,15193,0,2186,300,36,240,300,95
2020,615000342,39440,2540,2540,2540,0,36900,36500,30000,6500,0,400,400,0,0,19930,19930,19000,900,2985,300,48,120,212,75
2020,615000352,18920,320,320,320,0,18600,15000,15000,0,0,3600,3100,0,500,1150,1150,1150,0,2512,267,200,280,200,71
2020,615000372,57808,36148,19148,19148,17000,21660,20800,0,0,20800,860,860,0,0,19000,19000,0,19000,3998,120,40,540,324,131
2020,615000382,2375,375,75,75,300,2000,2000,0,2000,0,0,0,0,0,800,800,0,800,1130,420,30,40,90,0
2020,615600101,172000,12500,12500,12500,0,159500,150000,150000,0,0,9500,5500,4000,0,0,0,0,0,3730,480,500,600,150,1206
2020,615600141,31275,7205,7205,7205,0,24070,24000,12000,12000,0,70,70,0,0,12000,3000,3000,0,1195,68,5,150,52,96
2020,615600151,12053,11553,8553,8553,3000,500,0,0,0,0,500,500,0,0,0,0,0,0,3564,900,240,444,240,102
2020,615600181,13003,10003,7103,7103,2900,3000,0,0,0,0,3000,3000,0,0,3890,3890,690,0,2330,110,200,480,360,129
2020,615600191,2534,2534,134,134,2400,0,0,0,0,0,0,0,0,0,1580,1580,1580,0,699,144,25,20,60,1
2020,615600321,4007,4007,507,507,3500,0,0,0,0,0,0,0,0,0,0,0,0,0,1084,52,240,60,52,8
2020,615600341,121102,10602,10602,5602,0,110500,110000,105000,5000,0,500,500,0,0,35450,9450,9300,0,2122,360,80,192,180,326
2020,615600371,6180,6180,3480,3480,2700,0,0,0,0,0,0,0,0,0,0,0,0,0,2898,475,85,254,145,1
2020,615600381,90960,11040,11040,11040,0,79920,79000,34000,45000,0,920,670,250,0,44812,9812,9052,700,3679,360,405,384,125,188
2020,615600391,87538,9538,9538,9538,0,78000,75000,70000,5000,0,3000,1000,2000,0,2050,2050,0,0,3192,480,120,180,96,166
2020,615700121,33250,350,350,350,0,32900,32000,18000,14000,0,900,900,0,0,6000,4000,0,4000,4150,300,550,500,300,127
2020,615700141,82270,24470,3470,3470,21000,57800,53000,0,0,53000,4800,4800,0,0,200,200,0,200,4120,360,400,360,360,1362
2020,615700181,519280,101780,101780,101780,0,417500,400000,260000,140000,0,17500,12300,5200,0,125000,120000,120000,0,10070,720,330,700,180,9119
2020,615700191,4820,4820,1920,1920,2900,0,0,0,0,0,0,0,0,0,1000,1000,1000,0,757,96,10,154,132,13
2020,615700301,975,975,975,975,0,0,0,0,0,0,0,0,0,0,29640,29640,20000,9640,2912,245,141,319,174,7
2020,615700311,20590,2290,290,290,2000,18300,18000,0,18000,0,300,300,0,0,15630,2630,1000,1600,2500,93,15,300,108,29
2020,615700331,58452,33452,23452,23452,10000,25000,20000,0,0,20000,5000,5000,0,0,14967,14967,0,14967,5410,1750,150,720,300,7156
2020,615700341,51660,19960,19960,19960,0,31700,29000,29000,0,0,2700,2000,700,0,0,0,0,0,4040,280,650,350,300,169
2020,615700361,1530,290,100,100,190,1240,1000,0,1000,0,240,240,0,0,0,0,0,0,685,60,24,120,36,7
2020,615700371,44669,31189,14189,11189,17000,13480,9000,0,9000,0,4480,0,480,4000,14600,14000,14000,0,4200,720,20,80,180,354
2020,615700381,3732,2232,232,232,2000,1500,0,0,0,0,1500,1500,0,0,300,300,0,0,1217,192,100,156,144,1
2020,615700391,28499,24499,999,999,23500,4000,0,0,0,0,4000,4000,0,0,27700,27700,27600,0,2580,240,60,240,360,37
2020,615800111,116472,6472,6472,6472,0,110000,110000,60000,50000,0,0,0,0,0,3000,0,0,0,1780,300,100,120,180,138
2020,615800121,15850,550,550,550,0,15300,15000,15000,0,0,300,180,120,0,2800,2800,2200,600,1044,108,10,120,74,78
2020,615800181,59260,57260,7260,7260,50000,2000,0,0,0,0,2000,2000,0,0,8100,8100,0,8100,8730,1080,300,200,150,3210
2020,615800191,1055,1055,1055,1055,0,0,0,0,0,0,0,0,0,0,0,0,0,0,1158,432,10,36,50,6
2020,615800301,257526,10726,10726,7966,0,246800,125000,65000,60000,0,121800,1400,400,120000,5390,390,0,150,6260,480,100,720,180,313
2020,615800331,35612,30412,10412,10412,20000,5200,0,0,0,0,5200,3200,2000,0,0,0,0,0,1840,360,100,200,60,639
2020,615800381,23850,21150,150,150,21000,2700,0,0,0,0,2700,2700,0,0,0,0,0,0,5220,900,1000,600,200,314
2020,615900101,16495,13895,3895,3895,10000,2600,200,0,200,0,2400,2400,0,0,200,200,0,0,4468,1080,150,180,156,546
2020,615900111,110648,60298,60298,298,0,50350,50000,50000,0,0,350,350,0,0,28100,28100,23000,0,3822,150,22,540,300,55
2020,615900121,9545,8945,6945,6945,2000,600,0,0,0,0,600,600,0,0,1000,1000,0,0,2292,624,60,420,302,37
2020,615900141,14526,14326,5326,5326,9000,200,0,0,0,0,200,0,200,0,620,620,620,0,1089,216,100,60,156,23
2020,615900161,15550,14550,1550,1550,13000,1000,0,0,0,0,1000,1000,0,0,8000,8000,8000,0,2325,204,10,60,300,28
2020,615900311,35970,34240,18240,18240,16000,1730,0,0,0,0,1730,1480,250,0,1700,1700,1700,0,4120,300,120,480,360,72
2020,615900341,301774,40811,40811,10811,0,260963,260000,50000,210000,0,963,850,113,0,43070,13070,12920,0,4483,480,180,518,294,926
2020,615900361,23828,20468,10468,7468,10000,3360,0,0,0,0,3360,860,1500,1000,0,0,0,0,3408,540,10,480,250,47
2020,615900371,38865,4565,4565,2565,0,34300,34000,34000,0,0,300,300,0,0,11000,11000,11000,0,946,180,2,120,84,68
2020,615900381,40100,23000,4000,4000,19000,17100,16000,0,0,16000,1100,500,600,0,5900,5900,5900,0,2073,240,20,180,150,47
2020,615900391,250,0,0,0,0,250,0,0,0,0,250,0,250,0,1300,1300,0,1000,1580,726,20,10,72,1
2020,616000112,4600,4600,300,300,4300,0,0,0,0,0,0,0,0,0,0,0,0,0,2108,72,60,120,156,0
2020,616000122,10600,570,570,570,0,10030,10000,10000,0,0,30,30,0,0,30,30,0,0,2382,250,30,240,280,72
2020,616000142,38280,780,780,780,0,37500,35000,35000,0,0,2500,2500,0,0,0,0,0,0,1752,180,240,210,120,184
2020,616000152,3100,3100,100,100,3000,0,0,0,0,0,0,0,0,0,0,0,0,0,1080,480,0,60,120,1
2020,616000162,28950,28950,950,950,28000,0,0,0,0,0,0,0,0,0,27100,27100,27100,0,1042,240,10,120,72,34
2020,616000182,117730,26730,1730,230,25000,91000,90000,0,90000,0,1000,1000,0,0,60770,20770,20000,0,1774,180,204,120,300,190
2020,616000302,6912,912,712,712,200,6000,0,0,0,0,6000,1000,0,5000,0,0,0,0,2402,216,20,1200,96,3
2020,616000322,85220,10950,10950,9550,0,74270,70000,65000,5000,0,4270,4270,0,0,11000,10000,5000,0,3960,420,120,360,480,356
2020,616000332,40540,540,540,540,0,40000,40000,40000,0,0,0,0,0,0,13000,13000,13000,0,2978,372,1000,140,156,1055
2020,616000342,82520,26270,26270,23270,0,56250,56000,56000,0,0,250,250,0,0,60,60,0,0,2344,240,200,360,54,140
2020,616000352,116448,59048,59048,59048,0,57400,56000,56000,0,0,1400,1400,0,0,0,0,0,0,5871,212,650,234,113,3185
2020,616000362,198920,15720,15720,15720,0,183200,175000,75000,100000,0,8200,8200,0,0,53300,53300,53300,0,4540,540,120,240,240,532
2020,616000372,63470,8320,8320,8320,0,55150,55000,55000,0,0,150,150,0,0,25000,25000,25000,0,2524,480,120,180,144,446
2020,616000382,80200,7200,7200,7200,0,73000,64000,64000,0,0,9000,7000,2000,0,3000,3000,0,0,5700,500,500,1000,200,4814
2020,616000392,6470,170,170,170,0,6300,6300,6300,0,0,0,0,0,0,0,0,0,0,748,77,40,84,27,9
2020,616600111,30621,120,120,120,0,30501,30000,30000,0,0,501,0,501,0,200,0,0,0,694,191,31,96,16,38
2020,616600121,9657,9657,4657,4657,5000,0,0,0,0,0,0,0,0,0,108,108,0,100,1530,70,20,96,228,28
2020,616600131,51768,1768,1768,1768,0,50000,49000,29000,20000,0,1000,1000,0,0,0,0,0,0,4773,168,60,600,156,120
2020,616600151,26190,26040,6040,6040,20000,150,0,0,0,0,150,150,0,0,3500,3500,3500,0,2580,540,30,180,120,19
2020,616600161,155466,15366,15366,9366,0,140100,140000,90000,50000,0,100,100,0,0,6000,0,0,0,1764,240,180,50,84,183
2020,616600171,108502,4302,4302,4302,0,104200,103000,90000,13000,0,1200,1200,0,0,10500,10000,9700,0,5898,1000,440,480,276,1205
2020,616600321,46640,4640,4640,4640,0,42000,42000,0,42000,0,0,0,0,0,7400,0,0,0,1650,420,120,50,60,1084
2020,616600341,15980,880,880,880,0,15100,15000,15000,0,0,100,100,0,0,0,0,0,0,796,240,30,60,66,85
2020,616600361,148457,39427,20927,20927,18500,109030,107200,0,107200,0,1830,1424,406,0,3000,3000,3000,0,4864,288,350,300,216,215
2020,616600371,71030,28030,28030,28030,0,43000,42000,40000,2000,0,1000,1000,0,0,16700,16700,13000,3700,3978,288,200,250,240,1226
2020,616600381,23590,7640,7640,7640,0,15950,14000,14000,0,0,1950,1300,650,0,8700,8700,8700,0,4800,252,50,320,312,91
2020,616600391,94533,8833,8833,8833,0,85700,85000,85000,0,0,700,500,200,0,0,0,0,0,5976,360,220,540,360,968
2020,616700101,5482,5462,962,962,4500,20,0,0,0,0,20,0,20,0,2913,2913,2900,0,825,121,100,36,28,2
2020,616700111,2560,2110,110,110,2000,450,0,0,0,0,450,450,0,0,7000,7000,0,5000,4624,744,30,960,250,254
2020,616700131,65215,4215,4215,4215,0,61000,60000,0,60000,0,1000,1000,0,0,300,300,0,0,3360,240,240,600,204,344
2020,616700141,50524,1894,1894,1194,0,48630,38000,38000,0,0,10630,2030,100,8500,1800,1800,0,1800,2303,360,40,300,120,58
2020,616700151,173163,8163,8163,8163,0,165000,165000,120000,45000,0,0,0,0,0,31500,2000,0,0,1875,240,120,60,120,104
2020,616700161,3180,3180,2680,2680,500,0,0,0,0,0,0,0,0,0,587,587,0,587,1926,600,42,60,84,1
2020,616700171,255836,221836,157836,157836,64000,34000,32000,0,32000,0,2000,2000,0,0,51000,51000,40000,11000,7900,300,2020,430,300,714
2020,616700351,144739,33220,33220,33220,0,111519,110000,65000,45000,0,1519,1290,229,0,1000,0,0,0,3896,420,100,60,168,5093
2020,616700361,41125,20125,20125,16125,0,21000,21000,21000,0,0,0,0,0,0,18,18,0,0,1960,200,50,100,110,129
2020,616700381,116060,1060,1060,1060,0,115000,115000,100000,15000,0,0,0,0,0,80000,0,0,0,946,360,72,70,84,122
2020,616700391,42236,34236,34236,34236,0,8000,8000,0,8000,0,0,0,0,0,0,0,0,0,1724,120,20,228,36,202
2020,616800101,32090,90,90,90,0,32000,30000,30000,0,0,2000,2000,0,0,500,500,500,0,3195,760,120,330,185,122
2020,616800111,23318,14518,14018,13358,500,8800,0,0,0,0,8800,1800,7000,0,2000,2000,2000,0,4092,660,730,200,102,168
2020,616800131,9260,9260,9260,9260,0,0,0,0,0,0,0,0,0,0,2850,2850,0,2800,1754,144,150,240,120,452
2020,616800311,1300,1300,400,400,900,0,0,0,0,0,0,0,0,0,0,0,0,0,900,252,120,120,36,1
2020,616800331,14418,5718,5718,5718,0,8700,7000,7000,0,0,1700,120,1580,0,3500,3500,0,3500,1161,264,130,120,60,14
2020,616800341,342040,1380,1380,1380,0,340660,340000,12000,328000,0,660,260,400,0,6000,6000,0,6000,936,156,100,120,36,121
2020,616800351,3800,3800,2100,2100,1700,0,0,0,0,0,0,0,0,0,5700,5700,1700,4000,2603,372,40,150,141,2
2020,616800361,41851,7006,7006,7006,0,34845,29500,29500,0,0,5345,5345,0,0,25137,25137,15100,10000,4116,290,150,396,316,455
2020,616800371,186900,15300,15300,15300,0,171600,170000,66000,104000,0,1600,1500,100,0,1000,0,0,0,3330,700,200,360,120,1134
2020,616800381,30010,10,10,10,0,30000,30000,30000,0,0,0,0,0,0,8000,0,0,0,1124,270,500,0,14,33
2020,616800391,23815,2785,2785,2785,0,21030,20900,20900,0,0,130,130,0,0,0,0,0,0,2067,235,300,120,120,72
2020,616900101,52905,17505,17505,17505,0,35400,35000,21000,14000,0,400,400,0,0,1000,0,0,0,1676,126,38,240,120,61
2020,616900121,785,785,75,75,710,0,0,0,0,0,0,0,0,0,0,0,0,0,1098,208,144,0,60,1
2020,616900151,9106,9090,90,90,9000,16,0,0,0,0,16,0,16,0,6630,6630,6550,0,1651,76,20,120,120,7
2020,616900161,210258,5258,5258,5258,0,205000,205000,195000,10000,0,0,0,0,0,0,0,0,0,4200,600,50,240,240,3390
2020,616900171,731,731,231,231,500,0,0,0,0,0,0,0,0,0,0,0,0,0,640,300,0,10,22,0
2020,616900181,29750,2550,2050,1550,500,27200,25000,0,25000,0,2200,2200,0,0,700,700,0,0,2013,60,25,180,120,63
2020,616900191,104209,34009,34009,34009,0,70200,70000,70000,0,0,200,200,0,0,0,0,0,0,3778,490,350,180,40,1072
2020,616900301,2517,2517,17,17,2500,0,0,0,0,0,0,0,0,0,0,0,0,0,1160,436,54,120,54,1
2020,616900311,13584,12584,8184,8184,4400,1000,0,0,0,0,1000,1000,0,0,0,0,0,0,2308,224,300,180,144,8
2020,616900331,9060,7060,5060,4060,2000,2000,0,0,0,0,2000,0,0,2000,0,0,0,0,1314,420,120,60,144,1
2020,616900361,63238,600,600,600,0,62638,62500,50000,12500,0,138,120,18,0,0,0,0,0,1850,360,20,180,120,129
2020,616900391,15500,100,100,100,0,15400,14200,14200,0,0,1200,1200,0,0,0,0,0,0,1636,360,280,240,120,48
2020,617000102,20360,360,360,360,0,20000,20000,20000,0,0,0,0,0,0,30,30,0,0,894,84,36,100,24,11
2020,617000112,20492,19492,3492,3492,16000,1000,0,0,0,0,1000,1000,0,0,0,0,0,0,1686,360,120,210,156,25
2020,617000132,140020,8820,8820,8820,0,131200,130000,130000,0,0,1200,1200,0,0,15700,15700,15600,0,5730,360,100,1000,120,649
2020,617000142,52640,640,640,640,0,52000,52000,52000,0,0,0,0,0,0,34900,34900,34900,0,1040,240,30,140,120,40
2020,617000152,34454,4454,4454,4454,0,30000,30000,30000,0,0,0,0,0,0,0,0,0,0,1008,240,20,38,60,61
2020,617000162,42650,2050,50,50,2000,40600,40600,0,40600,0,0,0,0,0,40573,39373,31800,73,2559,890,82,200,216,0
2020,617000192,18900,1900,1900,1900,0,17000,17000,17000,0,0,0,0,0,0,1880,1880,1880,0,1598,168,10,120,120,37
2020,617000302,13776,13396,2596,2596,10800,380,0,0,0,0,380,380,0,0,0,0,0,0,5450,830,30,480,240,582
2020,617000312,76465,21360,9360,9360,12000,55105,50000,0,50000,0,5105,5105,0,0,24700,24700,20000,2000,7617,790,200,600,500,67
2020,617000332,43908,9708,9708,6708,0,34200,30000,7500,22500,0,4200,1200,1000,2000,0,0,0,0,1291,204,36,180,84,26
2020,617000342,41805,285,285,285,0,41520,30900,30900,0,0,10620,2620,8000,0,20154,20154,17000,2854,5198,353,20,300,262,413
2020,617000352,38796,4276,4276,4276,0,34520,30900,30900,0,0,3620,3570,50,0,9595,9595,9595,0,2170,350,80,400,170,224
2020,617000362,53230,18730,18730,18730,0,34500,31000,31000,0,0,3500,2900,600,0,5465,5465,0,5465,6120,2000,200,300,180,868
2020,617000372,64500,17200,17200,17200,0,47300,46000,46000,0,0,1300,1300,0,0,15000,15000,10000,5000,3168,360,36,500,240,1363
2020,617000382,51800,2800,2800,2800,0,49000,48000,48000,0,0,1000,1000,0,0,0,0,0,0,4565,360,120,160,240,1256
2020,617000392,24100,2100,2100,2100,0,22000,18000,18000,0,0,4000,4000,0,0,17663,17663,10463,7200,5210,340,100,240,240,345
2020,617600101,135183,24815,24815,24815,0,110368,110000,110000,0,0,368,300,68,0,22070,22070,10570,500,3723,900,100,150,100,1216
2020,617600141,29260,29260,12260,12260,17000,0,0,0,0,0,0,0,0,0,2000,2000,2000,0,1450,250,240,80,200,5
2020,617600321,90330,21280,21280,21280,0,69050,66000,66000,0,0,3050,2750,300,0,10000,10000,10000,0,8451,864,55,1000,312,1921
2020,617600331,1640,1640,40,40,1600,0,0,0,0,0,0,0,0,0,1200,1200,1200,0,831,120,300,40,31,1
2020,617600341,35269,3369,3369,3369,0,31900,27000,23000,4000,0,4900,4900,0,0,0,0,0,0,6280,300,300,1000,300,872
2020,617600351,25090,290,290,290,0,24800,22500,22500,0,0,2300,2300,0,0,9956,9956,9956,0,3392,300,100,300,200,52
2020,617600361,1300,1300,1300,1300,0,0,0,0,0,0,0,0,0,0,0,0,0,0,528,90,110,15,36,1
2020,617600371,83860,29650,29650,18450,0,54210,52000,52000,0,0,2210,210,2000,0,0,0,0,0,5469,780,120,520,324,111
2020,617700151,5800,5800,1300,1300,4500,0,0,0,0,0,0,0,0,0,200,200,0,0,1870,240,50,50,120,11
2020,617700161,132180,3080,3080,3080,0,129100,127000,62000,65000,0,2100,2100,0,0,47500,0,0,0,2966,270,100,450,156,217
2020,617700171,72160,8560,8560,8560,0,63600,60000,60000,0,0,3600,3600,0,0,0,0,0,0,4220,330,470,200,160,529
2020,617700311,12920,320,320,320,0,12600,12600,12600,0,0,0,0,0,0,3200,3200,3200,0,1336,360,10,90,92,53
2020,617700341,9965,265,265,265,0,9700,9000,3000,6000,0,700,700,0,0,3000,2500,0,0,1571,162,120,120,96,20
2020,617700361,16900,2530,2530,2530,0,14370,14000,14000,0,0,370,370,0,0,0,0,0,0,1049,319,20,150,120,100
2020,617700381,94114,20994,20994,20994,0,73120,72000,72000,0,0,1120,1000,120,0,7000,7000,7000,0,5842,360,720,130,192,845
2020,617800101,118404,78204,78204,78204,0,40200,40000,40000,0,0,200,200,0,0,20,20,0,0,2787,339,100,224,156,1548
2020,617800121,251378,69128,19128,19128,50000,182250,180000,0,180000,0,2250,2250,0,0,100300,20300,20000,300,5745,600,3000,300,25,577
2020,617800161,76621,6621,6621,6621,0,70000,70000,70000,0,0,0,0,0,0,32104,32104,23991,8113,2320,400,200,180,180,785
2020,617800301,23988,7548,7548,7548,0,16440,15000,15000,0,0,1440,1100,340,0,1700,1700,0,1700,3956,360,120,240,240,568
2020,617800311,103909,12370,12370,8870,0,91539,87500,32000,55500,0,4039,3700,339,0,42658,16658,13646,1500,4200,540,150,480,360,271
2020,617800321,281566,36466,36466,34966,0,245100,243000,32000,211000,0,2100,2100,0,0,9000,0,0,0,8400,360,300,500,360,693
2020,617800331,16552,2052,2052,2052,0,14500,14000,14000,0,0,500,500,0,0,0,0,0,0,1540,240,20,240,120,44
2020,617800351,21260,19760,4260,4260,15500,1500,0,0,0,0,1500,1500,0,0,3880,3880,3500,300,3336,290,50,300,180,35
2020,617800371,24127,7547,7547,5547,0,16580,15000,15000,0,0,1580,1580,0,0,2842,2842,2842,0,1654,300,35,195,72,62
2020,617800391,11305,5005,4505,3505,500,6300,0,0,0,0,6300,2300,0,4000,4920,4920,0,3000,3340,300,50,840,300,134
2020,617900101,71600,6200,6200,4900,0,65400,65000,65000,0,0,400,400,0,0,0,0,0,0,2190,300,180,240,100,1000
2020,617900111,74620,9120,9120,9120,0,65500,65500,65000,500,0,0,0,0,0,70,70,0,0,2200,192,450,156,132,75
2020,617900121,2000,2000,0,0,2000,0,0,0,0,0,0,0,0,0,3600,3600,0,1600,960,120,180,20,38,1
2020,617900131,157300,1450,1450,1450,0,155850,155000,155000,0,0,850,850,0,0,115000,15000,15000,0,1198,180,10,240,48,203
2020,617900151,4172,4172,3372,3372,800,0,0,0,0,0,0,0,0,0,0,0,0,0,2623,276,60,480,282,96
2020,617900161,86500,3000,3000,3000,0,83500,82000,82000,0,0,1500,1500,0,0,9571,9571,9571,0,2830,240,50,400,480,299
2020,617900191,542860,32860,32860,32860,0,510000,500000,300000,200000,0,10000,10000,0,0,207800,186000,186000,0,6850,1200,500,800,250,3683
2020,617900321,2781,2281,481,481,1800,500,0,0,0,0,500,500,0,0,1850,1850,1400,450,1826,444,8,156,110,21
2020,617900331,35320,320,320,320,0,35000,35000,35000,0,0,0,0,0,0,0,0,0,0,2502,480,480,120,72,47
2020,617900341,289684,17184,15184,15184,2000,272500,267000,0,267000,0,5500,3500,2000,0,103450,99000,97900,1100,4978,840,70,360,300,213
2020,617900361,22185,185,185,185,0,22000,22000,22000,0,0,0,0,0,0,11233,11233,9733,0,3425,485,50,100,240,31
2020,617900391,50,50,50,50,0,0,0,0,0,0,0,0,0,0,0,0,0,0,979,90,720,10,24,3
2020,618000102,1058,1058,58,58,1000,0,0,0,0,0,0,0,0,0,0,0,0,0,1170,520,0,120,60,2
2020,618000112,44450,150,150,150,0,44300,44300,44300,0,0,0,0,0,0,5000,0,0,0,919,209,72,40,36,49
2020,618000122,501,501,1,1,500,0,0,0,0,0,0,0,0,0,0,0,0,0,1115,170,24,100,84,0
2020,618000132,20240,8240,8240,8240,0,12000,10000,10000,0,0,2000,2000,0,0,932,932,932,0,2322,192,30,360,200,112
2020,618000142,2815,2815,1815,1815,1000,0,0,0,0,0,0,0,0,0,0,0,0,0,4550,1950,30,420,70,29
2020,618000152,12800,12800,800,800,12000,0,0,0,0,0,0,0,0,0,0,0,0,0,1804,360,240,120,120,1
2020,618000302,5798,4848,3448,3448,1400,950,0,0,0,0,950,950,0,0,2420,2420,0,1500,3050,370,90,270,210,29
2020,618000322,40542,6212,6212,6212,0,34330,31500,0,31500,0,2830,2830,0,0,2600,2600,1900,0,3226,370,36,360,240,78
2020,618000332,6060,60,60,60,0,6000,6000,6000,0,0,0,0,0,0,0,0,0,0,550,90,78,15,17,48
2020,618600121,176880,165280,35280,35280,130000,11600,4000,0,4000,0,7600,7000,600,0,400,0,0,0,5980,420,60,360,300,14384
2020,618600151,19806,19806,2806,2806,17000,0,0,0,0,0,0,0,0,0,0,0,0,0,978,104,150,60,62,9
2020,618600311,12703,12473,8473,8473,4000,230,0,0,0,0,230,230,0,0,0,0,0,0,1052,180,12,200,60,275
2020,618600331,17750,1750,1750,1750,0,16000,16000,16000,0,0,0,0,0,0,8860,8860,8860,0,1030,120,420,60,36,34
2020,618600341,24600,2370,2370,2300,0,22230,22000,22000,0,0,230,0,230,0,0,0,0,0,475,100,20,5,20,28
2020,618700121,215630,14330,14330,14330,0,201300,200000,200000,0,0,1300,600,700,0,0,0,0,0,3908,480,180,120,228,2088
2020,618700171,2599,2599,2099,2099,500,0,0,0,0,0,0,0,0,0,300,300,0,300,3766,694,120,360,204,4
2020,618700191,81200,1200,1200,1200,0,80000,80000,80000,0,0,0,0,0,0,4000,0,0,0,1792,90,204,20,48,114
2020,618700301,275050,91100,69600,69600,21500,183950,170000,0,170000,0,13950,3950,10000,0,62400,57400,49000,8400,4240,500,300,1050,240,2526
2020,618700311,22560,22060,4060,4060,18000,500,0,0,0,0,500,500,0,0,3000,3000,3000,0,4035,300,75,120,300,218
2020,618700321,29372,7365,7365,7365,0,22007,21330,21000,0,330,677,677,0,0,100,100,0,100,3137,252,120,360,276,95
2020,618700341,6450,5500,1500,1500,4000,950,0,0,0,0,950,950,0,0,0,0,0,0,800,66,35,120,72,36
2020,618700351,55540,48340,10340,10340,38000,7200,7000,0,0,7000,200,200,0,0,0,0,0,0,4220,240,120,300,120,984
2020,618800111,808500,230000,105000,105000,125000,578500,575000,0,575000,0,3500,3000,500,0,62500,0,0,0,7800,400,300,500,300,6228
2020,618800121,24362,2362,362,362,2000,22000,22000,0,22000,0,0,0,0,0,18250,18250,12000,2000,1880,600,30,60,100,98
2020,618800131,6300,6300,300,300,6000,0,0,0,0,0,0,0,0,0,2000,2000,2000,0,908,120,500,10,18,5
2020,618800151,74514,33404,13904,13904,19500,41110,30000,0,30000,0,11110,9110,2000,0,4656,4656,0,656,4598,360,60,500,240,128
2020,618800171,124936,4636,4636,4636,0,120300,120000,50000,70000,0,300,300,0,0,7000,4000,4000,0,4700,360,150,540,180,201
2020,618800181,33500,13500,500,500,13000,20000,20000,0,20000,0,0,0,0,0,14000,0,0,0,991,240,10,24,15,27
2020,618800321,105140,52200,52200,52200,0,52940,50000,40000,10000,0,2940,2500,440,0,0,0,0,0,1894,300,10,200,84,225
2020,618900131,926,926,776,776,150,0,0,0,0,0,0,0,0,0,0,0,0,0,564,96,5,24,24,1
2020,618900151,463782,41082,41082,41082,0,422700,416000,250000,166000,0,6700,6700,0,0,28500,27000,27000,0,8830,480,30,400,420,1510
2020,618900161,89920,65420,25420,20420,40000,24500,20000,0,20000,0,4500,1500,3000,0,39000,29000,0,29000,10540,3600,100,1740,200,1498
2020,618900171,9400,9400,400,400,9000,0,0,0,0,0,0,0,0,0,0,0,0,0,450,120,20,36,24,1
2020,618900301,38836,7936,7936,7936,0,30900,28800,8800,20000,0,2100,2000,100,0,0,0,0,0,1175,300,24,180,60,139
2020,618900311,9290,1160,1160,1160,0,8130,8000,8000,0,0,130,130,0,0,600,600,0,0,1152,180,120,84,40,5
2020,618900321,9500,500,500,500,0,9000,9000,9000,0,0,0,0,0,0,0,0,0,0,622,100,50,20,42,8
2020,619000102,84750,4500,4500,4500,0,80250,80000,80000,0,0,250,250,0,0,0,0,0,0,4444,252,80,600,360,434
2020,619000122,15460,15350,1350,1350,14000,110,0,0,0,0,110,110,0,0,6000,6000,6000,0,3190,456,60,192,108,453
2020,619000132,138600,39600,4600,4600,35000,99000,95000,0,95000,0,4000,4000,0,0,0,0,0,0,4300,660,96,360,144,1520
2020,619000152,52596,14096,14096,12696,0,38500,35000,35000,0,0,3500,3500,0,0,6500,6500,6500,0,1874,252,2,144,180,311
2020,619000162,73600,70200,17700,17700,52500,3400,0,0,0,0,3400,3400,0,0,0,0,0,0,6206,300,50,80,276,4255
2020,619000172,57630,7630,630,630,7000,50000,50000,0,50000,0,0,0,0,0,36400,400,400,0,1490,120,30,120,60,80
2020,619000182,22500,22500,7500,7500,15000,0,0,0,0,0,0,0,0,0,0,0,0,0,3400,480,800,240,240,8
2020,619000192,11545,3319,1319,1319,2000,8226,8000,0,8000,0,226,0,226,0,0,0,0,0,2684,720,340,204,72,25
2020,619600111,123362,63062,3062,3062,60000,60300,60000,0,60000,0,300,300,0,0,34500,2500,2000,0,3080,360,10,360,240,2543
2020,619600121,22325,22325,2325,2325,20000,0,0,0,0,0,0,0,0,0,1000,1000,0,0,785,180,120,30,180,2
2020,619600151,427370,92010,63910,63910,28100,335360,335000,0,335000,0,360,360,0,0,268630,229400,229400,0,2100,450,20,200,180,912
2020,619700101,12880,11580,6580,6580,5000,1300,0,0,0,0,1300,900,400,0,330,330,0,300,6000,360,70,600,300,31
2020,619700111,151000,28400,28400,28400,0,122600,120000,120000,0,0,2600,2600,0,0,0,0,0,0,2314,700,150,60,84,516
2020,619700131,18280,17080,4080,4080,13000,1200,0,0,0,0,1200,1200,0,0,0,0,0,0,5940,300,300,250,240,1611
2020,619700141,279750,1550,1550,1550,0,278200,278000,250000,28000,0,200,200,0,0,30000,0,0,0,3520,600,240,360,120,362
2020,619800111,101711,1388,1388,1388,0,100323,100000,100000,0,0,323,300,23,0,2000,2000,0,2000,1890,290,120,108,96,137
2020,619800161,9150,9150,150,150,9000,0,0,0,0,0,0,0,0,0,0,0,0,0,1607,1200,1,10,24,1
2020,619800171,700,700,200,200,500,0,0,0,0,0,0,0,0,0,0,0,0,0,867,420,5,10,120,2
2020,619800181,14270,14270,5270,5270,9000,0,0,0,0,0,0,0,0,0,10180,10180,6680,1300,1450,648,120,48,96,1
2020,619800191,108110,7810,6810,6810,1000,100300,100000,0,100000,0,300,300,0,0,14900,14900,14000,600,3610,240,100,300,480,187
2020,619900101,1,1,1,1,0,0,0,0,0,0,0,0,0,0,1000,1000,0,0,496,150,0,10,96,0
2020,619900161,7288,7288,2288,2288,5000,0,0,0,0,0,0,0,0,0,3000,3000,3000,0,1402,240,220,24,420,6
2020,619900171,9100,9100,5100,5100,4000,0,0,0,0,0,0,0,0,0,1430,1430,180,300,1410,550,10,100,100,14
2020,619900191,644,644,644,644,0,0,0,0,0,0,0,0,0,0,9500,9500,5000,2000,3609,300,210,150,270,318
2020,620000212,9530,530,530,530,0,9000,9000,9000,0,0,0,0,0,0,3040,3040,3040,0,894,84,0,15,15,15
2020,620000222,3340,340,140,140,200,3000,0,0,0,0,3000,3000,0,0,0,0,0,0,2072,409,10,264,144,17
2020,620000232,30200,150,150,150,0,30050,30000,30000,0,0,50,50,0,0,500,0,0,0,2815,240,440,360,115,102
2020,620000242,38866,37916,15916,15916,22000,950,0,0,0,0,950,900,50,0,60,60,0,0,1880,238,40,140,72,422
2020,620000252,870,870,370,370,500,0,0,0,0,0,0,0,0,0,0,0,0,0,2760,600,30,30,180,1
2020,620000262,22000,7000,7000,7000,0,15000,15000,15000,0,0,0,0,0,0,0,0,0,0,1125,180,15,30,30,46
2020,620000272,29810,3010,1010,1010,2000,26800,24800,0,22000,2800,2000,2000,0,0,9000,9000,9000,0,931,400,30,125,36,168
2020,620000282,10195,45,45,45,0,10150,10000,10000,0,0,150,150,0,0,0,0,0,0,1070,60,120,120,18,23
2020,620000292,68991,6391,6391,6391,0,62600,59000,33000,26000,0,3600,3600,0,0,27500,11500,11500,0,4990,300,400,300,240,258
2020,620000302,6028,5228,2728,2728,2500,800,0,0,0,0,800,800,0,0,700,700,700,0,1288,444,60,180,60,13
2020,620000312,29200,5600,5600,5600,0,23600,21800,17800,4000,0,1800,1800,0,0,0,0,0,0,4501,291,120,960,282,765
2020,620000322,26772,4772,4772,4772,0,22000,22000,18000,4000,0,0,0,0,0,1080,1080,1080,0,3564,366,120,72,240,153
2020,620000332,24238,5638,5638,5638,0,18600,17000,17000,0,0,1600,1600,0,0,500,500,0,0,2306,168,5,72,324,259
2020,620000342,48788,25236,25236,25236,0,23552,22500,18500,4000,0,1052,600,452,0,0,0,0,0,1690,216,20,426,95,114
2020,620000352,650,50,50,50,0,600,0,0,0,0,600,100,500,0,0,0,0,0,525,80,70,120,30,20
2020,620000362,551,121,121,121,0,430,0,0,0,0,430,430,0,0,310,310,0,160,2010,225,20,540,300,55
2020,620000392,8360,360,360,360,0,8000,8000,8000,0,0,0,0,0,0,2500,2500,2500,0,630,204,10,84,42,51
2020,620600221,16065,9325,9325,9325,0,6740,6500,6500,0,0,240,150,90,0,0,0,0,0,2150,350,500,240,80,39
2020,620600231,15103,3063,3063,3063,0,12040,12000,12000,0,0,40,0,40,0,2380,2380,2360,0,2430,200,30,100,200,47
2020,620600251,28136,26706,5706,5706,21000,1430,0,0,0,0,1430,1400,30,0,17300,17300,17000,0,3546,336,50,350,150,229
2020,620600261,101500,34300,34300,34160,0,67200,62200,35000,6200,21000,5000,3000,2000,0,100,100,0,100,4144,295,271,378,315,806
2020,620600301,45416,18816,18816,18816,0,26600,25000,25000,0,0,1600,1600,0,0,0,0,0,0,2386,396,0,180,240,63
2020,620600311,38380,1230,1230,1230,0,37150,35000,35000,0,0,2150,1900,250,0,12782,12782,7952,4800,4074,360,50,310,240,97
2020,620600351,49726,2826,2826,2826,0,46900,46000,16000,30000,0,900,900,0,0,1350,1350,1350,0,3910,250,400,300,240,189
2020,620600371,105,105,105,105,0,0,0,0,0,0,0,0,0,0,0,0,0,0,1222,120,450,60,20,1
2020,620600381,106188,19098,19098,19098,0,87090,86000,16000,70000,0,1090,700,390,0,0,0,0,0,1582,200,30,152,168,116
2020,620600391,19000,200,200,200,0,18800,16500,16500,0,0,2300,2300,0,0,0,0,0,0,1364,300,36,140,48,57
2020,620700211,2038,1980,180,130,1800,58,0,0,0,0,58,0,58,0,0,0,0,0,588,240,12,16,36,1
2020,620700221,6910,2210,860,860,1350,4700,3000,0,0,3000,1700,1200,0,500,3200,3200,0,3000,2034,360,100,150,180,17
2020,620700241,393,393,118,118,275,0,0,0,0,0,0,0,0,0,0,0,0,0,592,60,15,18,24,1
2020,620700251,46890,29200,17200,17200,12000,17690,17200,0,16000,1200,490,350,140,0,12000,12000,0,12000,2580,260,600,150,270,131
2020,620700261,15728,11278,11278,11278,0,4450,4300,0,4300,0,150,50,100,0,120,120,0,0,3263,168,130,350,220,139
2020,620700271,10230,200,200,200,0,10030,10000,10000,0,0,30,0,30,0,0,0,0,0,734,180,50,24,40,16
2020,620700291,12200,200,200,200,0,12000,12000,12000,0,0,0,0,0,0,0,0,0,0,553,150,27,13,35,21
2020,620700301,82720,920,920,920,0,81800,68000,0,68000,0,13800,1500,12300,0,800,800,0,800,1799,240,360,300,84,23
2020,620700331,42494,14068,14068,14068,0,28426,27000,27000,0,0,1426,1200,226,0,1336,1336,1320,0,3219,240,140,264,185,128
2020,620700341,497336,85036,85036,85036,0,412300,403400,31800,371600,0,8900,0,8900,0,99000,92000,0,92000,4000,360,60,0,48,762
2020,620700351,12200,200,200,200,0,12000,12000,12000,0,0,0,0,0,0,400,0,0,0,842,180,30,60,24,21
2020,620700361,4968,2968,2668,2668,300,2000,0,0,0,0,2000,2000,0,0,3300,3300,0,3300,4096,564,400,360,300,343
2020,620700371,57740,13040,13040,13040,0,44700,42000,17000,25000,0,2700,2700,0,0,600,0,0,0,2830,280,180,390,300,2213
2020,620700381,259146,10870,10870,10870,0,248276,246000,11000,235000,0,2276,0,2276,0,16000,16000,16000,0,1058,240,8,290,96,497
2020,620700391,22621,9530,9530,6530,0,13091,11000,11000,0,0,2091,1300,791,0,0,0,0,0,3672,232,100,660,240,49
2020,620800201,1141,1099,799,799,300,42,0,0,0,0,42,0,42,0,0,0,0,0,1691,480,10,47,128,2
2020,620800221,25056,7236,7236,7236,0,17820,17000,10000,7000,0,820,320,500,0,4170,170,0,0,4470,600,400,1000,300,678
2020,620800241,10110,50,50,50,0,10060,10000,10000,0,0,60,0,60,0,0,0,0,0,575,160,20,10,30,6
2020,620800271,40370,18370,18370,18370,0,22000,22000,22000,0,0,0,0,0,0,0,0,0,0,2717,220,240,150,140,91
2020,620800281,1522,372,372,372,0,1150,0,0,0,0,1150,1000,150,0,1955,1955,1955,0,3500,240,300,150,200,51
2020,620800291,54010,8410,8410,8410,0,45600,43800,16000,6000,21800,1800,1800,0,0,5500,5500,1000,4500,4938,698,220,300,228,271
2020,620800301,170,170,170,170,0,0,0,0,0,0,0,0,0,0,0,0,0,0,1990,240,120,120,120,3
2020,620800321,25770,8190,8190,8190,0,17580,15000,15000,0,0,2580,1580,1000,0,17200,17200,7000,8000,3322,336,50,360,156,77
2020,620800331,2750,2750,1750,1750,1000,0,0,0,0,0,0,0,0,0,0,0,0,0,1720,800,50,20,60,1
2020,620800341,7020,20,20,20,0,7000,7000,7000,0,0,0,0,0,0,1496,1496,1496,0,812,176,72,60,90,12
2020,620800351,9460,160,160,160,0,9300,9300,2300,7000,0,0,0,0,0,5850,350,350,0,1211,129,280,12,36,43
2020,620800361,29326,100,100,100,0,29226,29000,0,29000,0,226,0,226,0,15000,0,0,0,770,240,24,12,12,31
2020,620800371,543,543,543,543,0,0,0,0,0,0,0,0,0,0,0,0,0,0,272,102,0,10,24,2
2020,620800381,43450,3400,3400,1400,0,40050,33000,23000,10000,0,7050,4000,50,3000,7775,7775,7000,700,4859,344,150,360,25,139
2020,620800391,45760,5660,5660,5660,0,40100,40000,25000,15000,0,100,100,0,0,1093,193,0,0,3834,320,500,240,180,370
2020,620900201,10850,850,850,850,0,10000,10000,10000,0,0,0,0,0,0,0,0,0,0,804,240,200,6,16,11
2020,620900211,2020,1920,920,920,1000,100,0,0,0,0,100,100,0,0,3135,3135,700,1700,4393,964,300,450,99,276
2020,620900231,575,575,70,70,505,0,0,0,0,0,0,0,0,0,0,0,0,0,739,70,40,12,25,0
2020,620900241,100,100,100,100,0,0,0,0,0,0,0,0,0,0,0,0,0,0,525,150,50,12,15,1
2020,620900251,34482,16552,16552,11552,0,17930,17200,12000,5200,0,730,650,80,0,65,65,0,0,3453,295,10,500,200,59
2020,620900261,2070,2070,70,70,2000,0,0,0,0,0,0,0,0,0,0,0,0,0,416,84,30,10,12,1
2020,620900281,16640,280,280,280,0,16360,12000,12000,0,0,4360,4200,160,0,7140,7140,2800,0,2278,240,36,280,240,69
2020,620900301,60880,8080,8080,8080,0,52800,51000,28000,23000,0,1800,1800,0,0,9000,8000,8000,0,6296,360,60,540,180,889
2020,620900311,32312,8012,8012,6712,0,24300,22000,15000,7000,0,2300,1100,200,1000,300,0,0,0,4601,255,200,1200,180,97
2020,620900321,99324,18144,18144,18144,0,81180,79000,49000,30000,0,2180,2000,180,0,50500,16500,8000,8500,8740,300,100,240,240,1672
2020,620900341,30898,6878,6878,6878,0,24020,21000,21000,0,0,3020,1420,1600,0,3808,3808,3808,0,3366,222,800,240,132,306
2020,620900351,30432,2132,2132,2132,0,28300,26000,16000,10000,0,2300,2300,0,0,8200,7200,7200,0,1208,240,21,70,96,166
2020,620900361,60,60,60,60,0,0,0,0,0,0,0,0,0,0,2000,2000,0,0,1462,300,200,180,60,2
2020,620900371,5644,644,644,644,0,5000,5000,5000,0,0,0,0,0,0,0,0,0,0,1311,180,240,96,36,9
2020,620900381,78996,21296,21296,21296,0,57700,51500,33500,18000,0,6200,6200,0,0,0,0,0,0,4918,480,120,600,168,2009
2020,620900391,87070,19500,19500,19500,0,67570,65500,18000,47500,0,2070,70,2000,0,4100,600,0,600,2546,282,900,300,144,155
2020,621000202,131925,25925,24925,21925,1000,106000,100000,0,100000,0,6000,2000,2000,2000,35200,30200,30000,0,4020,300,20,200,200,1145
2020,621000222,15250,50,50,50,0,15200,15000,15000,0,0,200,200,0,0,0,0,0,0,702,96,70,60,24,25
2020,621000232,7000,7000,2000,2000,5000,0,0,0,0,0,0,0,0,0,700,700,0,700,1210,130,8,25,40,1
2020,621000242,81300,300,300,300,0,81000,81000,45000,36000,0,0,0,0,0,16000,16000,16000,0,1088,200,30,60,48,90
2020,621000262,61440,3090,3090,90,0,58350,53000,53000,0,0,5350,350,5000,0,20900,12900,12000,0,2820,360,20,360,360,62
2020,621000272,32628,32128,19128,19128,13000,500,0,0,0,0,500,0,500,0,0,0,0,0,2140,300,100,300,120,158
2020,621000282,52695,6017,6017,6017,0,46678,40000,40000,0,0,6678,6000,678,0,0,0,0,0,3800,250,50,150,200,8983
2020,621000292,25620,5000,5000,5000,0,20620,19800,19800,0,0,820,800,20,0,0,0,0,0,1580,170,200,500,60,35
2020,621000302,14817,14517,6517,6517,8000,300,0,0,0,0,300,300,0,0,0,0,0,0,1192,240,70,180,132,33
2020,621000312,28873,6660,6660,6660,0,22213,17000,17000,0,0,5213,5100,113,0,380,380,0,350,4192,312,300,260,280,474
2020,621000322,3263,150,150,150,0,3113,3000,3000,0,0,113,0,113,0,0,0,0,0,830,90,60,30,60,6
2020,621000332,7679,6521,3321,3321,3200,1158,0,0,0,0,1158,1090,68,0,270,270,0,0,1990,216,34,180,120,25
2020,621000342,52354,11954,11954,11954,0,40400,39000,19000,20000,0,1400,1400,0,0,5400,5400,5400,0,1394,120,360,40,180,119
2020,621000352,33980,9280,9280,9280,0,24700,23000,23000,0,0,1700,1700,0,0,0,0,0,0,2295,215,200,260,240,86
2020,621000362,18478,1878,1878,1878,0,16600,15900,15700,200,0,700,700,0,0,10000,10000,10000,0,840,100,48,60,72,27
2020,621000372,8900,5200,5200,200,0,3700,2000,0,2000,0,1700,1700,0,0,1540,1540,0,700,2384,160,270,264,180,1070
2020,621000382,10350,350,350,350,0,10000,10000,10000,0,0,0,0,0,0,0,0,0,0,900,180,60,24,36,10
2020,621000392,170,170,70,70,100,0,0,0,0,0,0,0,0,0,0,0,0,0,993,180,15,36,72,0
2020,621600201,28130,330,330,330,0,27800,27000,26000,1000,0,800,800,0,0,13574,13574,13574,0,3980,250,10,540,240,36
2020,621600231,31306,10376,10376,9376,0,20930,17000,17000,0,0,3930,1400,2530,0,9400,9400,9000,400,1840,240,100,180,270,24
2020,621600251,2930,2930,2430,2430,500,0,0,0,0,0,0,0,0,0,150,150,0,0,3250,700,20,210,230,54
2020,621600281,2250,2250,2250,2250,0,0,0,0,0,0,0,0,0,0,0,0,0,0,447,0,160,0,12,0
2020,621600311,260,260,30,30,230,0,0,0,0,0,0,0,0,0,0,0,0,0,802,232,0,120,70,1
2020,621600321,124860,18360,18360,18360,0,106500,105200,33000,62500,9700,1300,1300,0,0,16060,13560,13560,0,3074,250,90,460,204,790
2020,621600341,26271,6476,6476,6476,0,19795,17800,7800,10000,0,1995,720,1275,0,0,0,0,0,1698,240,200,96,72,16
2020,621600351,56826,2726,2726,1426,0,54100,53000,8000,45000,0,1100,300,800,0,5000,0,0,0,1790,200,340,70,180,53
2020,621600361,6816,6606,6006,6006,600,210,0,0,0,0,210,210,0,0,2248,2248,0,2188,2230,620,300,250,60,28
2020,621600371,57223,9945,9945,9645,0,47278,42800,35000,7800,0,4478,3800,678,0,13650,13550,8550,5000,4120,600,50,480,300,612
2020,621600381,18078,5948,5948,5948,0,12130,11000,11000,0,0,1130,900,230,0,5098,5098,3900,1000,3526,348,40,460,442,91
2020,621600391,10315,2315,2315,2315,0,8000,5000,5000,0,0,3000,3000,0,0,2820,2820,0,0,650,180,10,30,30,76
2020,621700201,17554,7704,7704,6704,0,9850,7000,7000,0,0,2850,1800,1050,0,3500,3500,0,0,1336,180,10,240,120,38
2020,621700211,5150,5100,3100,3100,2000,50,0,0,0,0,50,0,50,0,0,0,0,0,311,50,15,50,15,8
2020,621700221,250,250,200,200,50,0,0,0,0,0,0,0,0,0,0,0,0,0,554,199,60,10,15,0
2020,621700231,21510,1510,1510,1510,0,20000,20000,20000,0,0,0,0,0,0,0,0,0,0,1386,196,60,40,50,16
2020,621700241,106063,26000,26000,26000,0,80063,80000,80000,0,0,63,0,63,0,0,0,0,0,1188,300,72,30,36,74
2020,621700251,145321,3188,3188,3188,0,142133,142000,84000,58000,0,133,80,53,0,20000,0,0,0,1900,290,400,190,120,247
2020,621700261,12640,7840,2840,2840,5000,4800,0,0,0,0,4800,4000,800,0,1800,1800,0,0,3070,400,300,500,420,132
2020,621700271,34294,4104,4104,4104,0,30190,30000,30000,0,0,190,0,190,0,1100,100,0,0,1416,156,60,36,60,28
2020,621700291,40202,8702,8702,8702,0,31500,30000,15000,15000,0,1500,1500,0,0,100,100,0,0,3100,200,300,400,150,211
2020,621700321,2200,2200,200,200,2000,0,0,0,0,0,0,0,0,0,0,0,0,0,2195,120,1200,60,50,29
2020,621700341,100,100,100,100,0,0,0,0,0,0,0,0,0,0,0,0,0,0,561,262,72,12,15,1
2020,621700351,8700,100,100,100,0,8600,8600,7000,1600,0,0,0,0,0,0,0,0,0,514,146,60,30,48,9
2020,621700361,26,26,26,26,0,0,0,0,0,0,0,0,0,0,0,0,0,0,1144,70,40,10,144,1
2020,621700371,21406,2606,2606,2606,0,18800,18000,10000,8000,0,800,800,0,0,7280,7280,7200,0,3040,450,300,360,280,1250
2020,621700381,8160,7360,2360,2360,5000,800,0,0,0,0,800,800,0,0,770,770,770,0,1115,140,70,110,95,43
2020,621800201,6201,4731,3731,3431,1000,1470,0,0,0,0,1470,320,1150,0,0,0,0,0,1937,762,41,68,144,55
2020,621800211,57191,3691,3691,3691,0,53500,53000,20000,33000,0,500,0,500,0,27600,17500,9500,0,1893,350,300,180,250,62
2020,621800221,15402,14842,5842,5842,9000,560,0,0,0,0,560,500,60,0,250,250,0,0,545,120,5,60,80,11
2020,621800231,35600,15150,15150,15150,0,20450,20000,20000,0,0,450,450,0,0,0,0,0,0,3484,350,700,300,144,148
2020,621800241,60,60,10,10,50,0,0,0,0,0,0,0,0,0,0,0,0,0,1092,420,0,72,240,0
2020,621800251,3005,3005,5,5,3000,0,0,0,0,0,0,0,0,0,0,0,0,0,282,60,70,12,18,1
2020,621800271,3589,3389,1389,1209,2000,200,0,0,0,0,200,0,200,0,230,230,200,0,1326,480,200,100,36,1
2020,621800301,84379,8019,8019,8019,0,76360,74000,8000,66000,0,2360,1000,1360,0,2540,2540,2500,0,1182,276,60,84,108,48
2020,621800311,10590,1590,1590,1590,0,9000,9000,9000,0,0,0,0,0,0,4890,4890,4890,0,1496,204,350,64,108,13
2020,621800341,32380,7130,7130,7130,0,25250,22000,18000,4000,0,3250,2750,500,0,14027,14027,10905,600,1733,168,100,280,100,7
2020,621800361,2523,23,23,23,0,2500,2500,2500,0,0,0,0,0,0,500,500,0,500,547,90,30,30,17,3
2020,621800381,2350,2220,2020,2020,200,130,0,0,0,0,130,130,0,0,0,0,0,0,1448,360,48,80,80,7
2020,621900201,24886,2766,2766,2266,0,22120,19500,11500,8000,0,2620,1500,1120,0,3000,2500,2500,0,1650,180,110,310,100,22
2020,621900211,9780,1280,1280,1280,0,8500,8500,8500,0,0,0,0,0,0,0,0,0,0,685,130,110,15,66,8
2020,621900241,13260,12560,7560,7560,5000,700,0,0,0,0,700,700,0,0,0,0,0,0,1700,30,200,400,60,546
2020,621900271,74946,9146,7146,5146,2000,65800,63000,0,63000,0,2800,400,400,2000,40150,33150,23150,7000,4780,500,100,500,340,160
2020,621900311,33555,8810,8810,8610,0,24745,23000,23000,0,0,1745,1700,45,0,0,0,0,0,1760,216,10,128,36,67
2020,621900321,18693,18370,13370,13370,5000,323,0,0,0,0,323,300,23,0,0,0,0,0,2050,240,10,120,96,471
2020,621900351,22928,3678,3678,3678,0,19250,19000,9000,10000,0,250,250,0,0,0,0,0,0,2155,108,240,300,120,43
2020,621900361,806,806,806,806,0,0,0,0,0,0,0,0,0,0,300,300,0,300,1033,160,3,100,150,0
2020,621900371,1030,30,30,30,0,1000,1000,1000,0,0,0,0,0,0,0,0,0,0,510,70,90,50,30,1
2020,621900381,17640,13340,13340,13340,0,4300,4300,4300,0,0,0,0,0,0,0,0,0,0,1948,364,14,100,130,9
2020,621900391,13687,4661,4661,4661,0,9026,8000,8000,0,0,1026,800,226,0,150,0,0,0,2318,144,120,340,144,131
2020,622000202,14000,14000,0,0,14000,0,0,0,0,0,0,0,0,0,2750,2750,0,1700,3790,400,300,300,240,158
2020,622000212,1160,960,460,410,500,200,0,0,0,0,200,200,0,0,0,0,0,0,1446,480,60,100,132,91
2020,622000222,181500,16300,16300,16300,0,165200,159200,55000,104200,0,6000,5500,500,0,137737,130737,113587,17000,8550,150,50,200,150,1307
2020,622000232,60140,25793,25793,25793,0,34347,30000,30000,0,0,4347,4275,72,0,0,0,0,0,5303,305,57,472,240,2685
2020,622000242,43210,6610,6610,6610,0,36600,32000,27000,5000,0,4600,4000,600,0,0,0,0,0,2110,300,100,400,60,182
2020,622000252,129555,32655,32655,22655,0,96900,93900,38000,51000,4900,3000,3000,0,0,75277,35277,22042,7200,3735,298,330,350,142,1489
2020,622000262,674,674,374,374,300,0,0,0,0,0,0,0,0,0,1396,1396,0,0,780,144,180,60,24,0
2020,622000292,19480,6180,6180,6180,0,13300,13000,13000,0,0,300,300,0,0,0,0,0,0,2038,240,12,120,108,473
2020,622000302,23289,8056,8056,8056,0,15233,15000,15000,0,0,233,120,113,0,0,0,0,0,3560,2250,200,120,100,11
2020,622000312,4160,1960,1960,1960,0,2200,400,400,0,0,1800,1800,0,0,1000,1000,0,1000,1048,210,30,96,180,21
2020,622000322,104361,12201,12201,12201,0,92160,85000,15000,70000,0,7160,1900,5260,0,0,0,0,0,2270,320,50,150,120,133
2020,622000332,25254,1154,1154,1154,0,24100,24100,4100,20000,0,0,0,0,0,0,0,0,0,1146,201,200,40,80,14
2020,622600201,47865,47565,32565,32565,15000,300,0,0,0,0,300,200,100,0,0,0,0,0,3500,180,50,360,240,42
2020,622600231,25339,3539,3539,1539,0,21800,20000,20000,0,0,1800,600,1200,0,1000,1000,1000,0,1870,300,40,200,130,34
2020,622600241,76339,42589,16589,16589,26000,33750,30000,0,30000,0,3750,3600,150,0,0,0,0,0,6800,520,160,600,450,1678
2020,622600251,20100,100,100,100,0,20000,20000,20000,0,0,0,0,0,0,1000,0,0,0,2800,2200,100,70,70,25
2020,622600271,40472,19994,19994,17994,0,20478,18000,0,18000,0,2478,1800,678,0,0,0,0,0,2480,200,100,500,180,436
2020,622600281,26312,25312,312,312,25000,1000,0,0,0,0,1000,1000,0,0,10800,10800,10000,800,3100,400,200,600,100,58
2020,622600291,35780,100,100,100,0,35680,33000,33000,0,0,2680,2550,130,0,19515,19515,19475,0,3143,300,36,480,204,105
2020,622600301,8190,2390,2390,2390,0,5800,5000,5000,0,0,800,800,0,0,500,500,0,0,2263,366,160,290,264,49
2020,622600311,7870,1870,1870,1870,0,6000,6000,6000,0,0,0,0,0,0,0,0,0,0,482,68,36,15,20,1
2020,622600321,47950,10550,10550,10550,0,37400,35000,35000,0,0,2400,2000,400,0,10000,0,0,0,2602,432,100,300,70,178
2020,622600331,12530,3680,3680,3680,0,8850,8450,7000,1450,0,400,400,0,0,0,0,0,0,1398,180,300,250,132,26
2020,622600341,268166,33516,33516,1516,0,234650,234000,16000,218000,0,650,200,450,0,30000,30000,30000,0,2520,240,50,240,280,351
2020,622600351,1930,1730,1730,1730,0,200,0,0,0,0,200,200,0,0,0,0,0,0,1180,240,60,360,120,31
2020,622700201,18526,4126,4126,4126,0,14400,9300,9300,0,0,5100,1900,3200,0,0,0,0,0,3615,170,200,100,125,15
2020,622700251,3505,3505,5,5,3500,0,0,0,0,0,0,0,0,0,0,0,0,0,329,55,50,36,18,1
2020,622700261,35172,18772,2972,2972,15800,16400,15000,0,0,15000,1400,1200,200,0,3000,3000,3000,0,2400,360,120,240,240,53
2020,622700271,3944,3544,3544,3544,0,400,0,0,0,0,400,400,0,0,0,0,0,0,1176,120,6,60,60,46
2020,622700291,874,804,504,504,300,70,0,0,0,0,70,70,0,0,0,0,0,0,1280,420,10,120,60,6
2020,622700301,27398,6108,6108,6108,0,21290,21000,21000,0,0,290,290,0,0,8400,8400,8400,0,4630,486,120,240,198,28
2020,622700311,24310,1220,1220,1220,0,23090,18000,18000,0,0,5090,4700,390,0,5700,5700,0,3000,3090,150,200,200,280,416
2020,622700321,48838,19386,19386,19386,0,29452,28000,8000,20000,0,1452,800,652,0,0,0,0,0,1174,220,20,190,64,87
2020,622700331,5063,100,100,100,0,4963,4850,4850,0,0,113,0,113,0,0,0,0,0,1055,652,60,15,48,3
2020,622700341,2820,820,820,820,0,2000,2000,2000,0,0,0,0,0,0,0,0,0,0,684,204,60,35,16,7
2020,622700351,527,477,477,477,0,50,0,0,0,0,50,50,0,0,0,0,0,0,1575,120,5,400,118,36
2020,622700361,54,54,54,54,0,0,0,0,0,0,0,0,0,0,0,0,0,0,553,145,100,60,18,1
2020,622800231,11300,11300,2300,2300,9000,0,0,0,0,0,0,0,0,0,3631,3631,3500,0,1640,220,30,190,160,18
2020,622800241,7410,7410,4560,2560,2850,0,0,0,0,0,0,0,0,0,0,0,0,0,1646,660,180,124,72,2
2020,622800261,120868,22618,22618,22618,0,98250,97000,60000,37000,0,1250,1250,0,0,48000,23000,23000,0,5620,600,100,230,130,1253
2020,622800271,1249,1232,32,32,1200,17,0,0,0,0,17,0,17,0,800,800,0,0,1447,240,60,48,54,30
2020,622800281,42880,37684,10184,10184,27500,5196,0,0,0,0,5196,3800,1396,0,16200,16200,15000,1200,7456,288,250,660,265,883
2020,622800301,40806,12166,12166,12166,0,28640,23900,8000,15900,0,4740,200,4540,0,500,0,0,0,2970,280,750,200,60,126
2020,622800311,3023,23,23,23,0,3000,3000,3000,0,0,0,0,0,0,0,0,0,0,947,192,450,10,30,1
2020,622800321,17178,10452,10452,10452,0,6726,6000,6000,0,0,726,500,226,0,1300,1300,1200,0,978,210,60,120,48,13
2020,622800351,120980,6280,6280,6280,0,114700,110000,0,110000,0,4700,200,4500,0,40000,40000,40000,0,2960,396,100,120,180,400
2020,622900211,59571,3721,3721,3721,0,55850,55000,55000,0,0,850,850,0,0,5000,5000,3000,2000,6230,200,300,390,180,890
2020,622900241,85743,3263,3263,3263,0,82480,77000,22000,55000,0,5480,2300,3180,0,63657,47857,38757,8500,4260,360,300,600,200,220
2020,622900251,43365,10848,10848,10848,0,32517,30500,30500,0,0,2017,1950,67,0,100,100,0,0,4868,240,45,540,204,781
2020,622900261,18641,16266,12266,10266,4000,2375,0,0,0,0,2375,2200,175,0,5500,5500,5000,300,5700,2700,50,450,200,2079
2020,622900281,2490,1870,870,870,1000,620,0,0,0,0,620,600,20,0,8000,8000,0,0,4150,780,150,460,360,27
2020,622900291,28032,2832,2832,2832,0,25200,25000,25000,0,0,200,200,0,0,0,0,0,0,2658,170,196,720,192,168
2020,622900321,61060,19260,19260,19260,0,41800,40000,12000,28000,0,1800,1800,0,0,18000,0,0,0,4100,300,100,600,110,654
2020,622900331,50367,5912,5912,5912,0,44455,41375,0,41375,0,3080,3080,0,0,69200,69200,30000,37500,5040,360,400,800,300,1368
2020,622900351,59240,11730,11730,11730,0,47510,40000,10000,30000,0,7510,1610,5900,0,9500,9500,9500,0,6295,360,2700,220,120,69
2020,623000202,36390,36340,13340,13340,23000,50,0,0,0,0,50,50,0,0,9800,9800,2000,7800,4950,200,100,200,250,1311
2020,623000212,66900,10600,10600,10600,0,56300,55300,32000,23300,0,1000,1000,0,0,4200,0,0,0,2095,240,700,300,92,160
2020,623000222,16340,300,300,300,0,16040,16000,16000,0,0,40,0,40,0,0,0,0,0,1297,300,72,24,72,17
2020,623600201,25550,500,500,500,0,25050,25000,25000,0,0,50,50,0,0,200,200,0,0,2830,400,500,200,50,52
2020,623600211,55146,12163,12163,12163,0,42983,42000,42000,0,0,983,570,413,0,4100,4100,3400,500,5860,420,100,100,240,496
2020,623600221,445550,850,850,850,0,444700,440000,40000,400000,0,4700,2200,2500,0,300,300,0,0,4170,400,400,200,200,131
2020,623600241,13233,7703,5203,5203,2500,5530,0,0,0,0,5530,5500,30,0,2300,2300,2300,0,2790,195,30,800,130,170
2020,623700201,14665,1665,1665,1665,0,13000,13000,13000,0,0,0,0,0,0,0,0,0,0,1104,280,110,84,120,14
2020,623700211,6682,6182,6182,6182,0,500,0,0,0,0,500,250,250,0,0,0,0,0,2170,150,30,200,240,27
2020,623700221,3050,2850,2850,2850,0,200,0,0,0,0,200,0,200,0,40,40,0,0,806,130,30,20,120,1
2020,623700231,26406,6306,6306,6306,0,20100,12000,12000,0,0,8100,3600,4500,0,4100,4100,4000,0,3360,100,500,200,240,63
2020,623700241,38248,7748,7748,7748,0,30500,28000,15000,13000,0,2500,2500,0,0,2100,1100,550,0,1870,150,100,200,120,112
2020,623800201,18523,17827,5327,5327,12500,696,0,0,0,0,696,650,46,0,4500,4500,4500,0,2600,240,200,300,200,63
2020,623800211,46435,9535,9535,9535,0,36900,34000,28000,0,6000,2900,2900,0,0,6000,6000,0,6000,3080,250,30,360,300,242
2020,623800221,19595,1520,1520,1520,0,18075,17000,17000,0,0,1075,1000,75,0,70,70,0,0,1230,150,160,120,90,111
2020,623800251,200,200,200,200,0,0,0,0,0,0,0,0,0,0,0,0,0,0,695,300,60,15,20,0
2020,623900201,39810,3110,3110,3110,0,36700,36000,36000,0,0,700,200,500,0,0,0,0,0,2730,250,80,150,100,871
2020,623900211,96340,7440,7440,7440,0,88900,86000,38000,48000,0,2900,2700,200,0,2000,0,0,0,9640,300,200,800,140,757
2020,623900231,25156,1110,1110,1110,0,24046,24000,21000,3000,0,46,0,46,0,0,0,0,0,2048,240,200,72,96,15
2020,623900241,230,230,30,30,200,0,0,0,0,0,0,0,0,0,0,0,0,0,784,120,100,60,24,1
2020,630000212,44430,14930,1930,1930,13000,29500,27000,0,27000,0,2500,2500,0,0,0,0,0,0,3772,372,100,480,312,90
2020,630000232,31920,7200,7200,7200,0,24720,24000,24000,0,0,720,720,0,0,4400,4400,0,4400,2258,240,70,318,144,111
2020,630000242,82984,8184,8184,8184,0,74800,74800,37800,37000,0,0,0,0,0,4000,0,0,0,1192,101,60,60,96,75
2020,630000252,8600,1100,1100,1100,0,7500,7500,7500,0,0,0,0,0,0,0,0,0,0,1815,92,100,120,120,11
2020,630000262,4660,4660,2310,2310,2350,0,0,0,0,0,0,0,0,0,2220,2220,0,0,1880,150,10,120,110,18
2020,630000282,65540,1380,1380,1380,0,64160,63300,21000,42300,0,860,860,0,0,22095,18095,17920,0,3350,888,350,260,144,168
2020,630000302,2188,1948,1948,1948,0,240,0,0,0,0,240,0,240,0,0,0,0,0,403,50,34,12,33,1
2020,630000312,4660,4660,4660,4660,0,0,0,0,0,0,0,0,0,0,0,0,0,0,527,220,48,36,12,5
2020,630000322,19555,10825,10825,10825,0,8730,4800,4800,0,0,3930,430,3500,0,0,0,0,0,1406,356,10,180,60,33
2020,630000332,9400,1000,1000,1000,0,8400,8000,8000,0,0,400,400,0,0,0,0,0,0,1951,689,355,360,40,9
2020,630000342,30620,6650,6350,6050,300,23970,20000,0,20000,0,3970,1670,2300,0,8600,8600,8600,0,3472,736,36,204,153,329
2020,630000352,1520,1520,20,20,1500,0,0,0,0,0,0,0,0,0,0,0,0,0,1255,50,450,40,15,1
2020,630000362,1750,1750,750,250,1000,0,0,0,0,0,0,0,0,0,200,200,0,200,1065,360,10,20,72,68
2020,630000372,89934,32684,32684,32684,0,57250,57000,43000,14000,0,250,250,0,0,15100,15100,15000,100,6506,540,100,450,216,716
2020,630000382,65080,80,80,80,0,65000,65000,15000,50000,0,0,0,0,0,2000,0,0,0,1250,300,500,13,17,201
2020,630000392,33000,16300,16300,15300,0,16700,15000,15000,0,0,1700,500,200,1000,0,0,0,0,2994,240,100,540,360,48
2020,630600221,51540,51540,48540,40540,3000,0,0,0,0,0,0,0,0,0,0,0,0,0,1564,1152,7,12,48,54
2020,630600231,36150,12150,150,150,12000,24000,24000,0,24000,0,0,0,0,0,22000,0,0,0,1150,180,20,20,80,51
2020,630600241,18125,2125,2125,625,0,16000,16000,13000,3000,0,0,0,0,0,24,24,0,0,1121,206,330,36,26,36
2020,630600251,12628,128,128,128,0,12500,12500,12500,0,0,0,0,0,0,5728,5728,5728,0,1035,163,120,120,68,17
2020,630600261,21062,6012,6012,5812,0,15050,11000,11000,0,0,4050,2300,350,1400,10754,10754,6643,2950,1948,209,10,50,192,117
2020,630600271,1040,1040,40,40,1000,0,0,0,0,0,0,0,0,0,0,0,0,0,1651,700,2,72,72,1
2020,630600281,5070,3570,1570,1570,2000,1500,0,0,0,0,1500,1500,0,0,1000,1000,0,1000,1576,60,150,130,76,137
2020,630600311,13150,1000,1000,1000,0,12150,12000,12000,0,0,150,150,0,0,0,0,0,0,1030,80,400,20,30,22
2020,630600321,51791,21151,21151,21151,0,30640,30000,30000,0,0,640,640,0,0,6300,6300,6300,0,4062,336,450,400,396,1415
2020,630600341,23222,2622,2622,2622,0,20600,19000,19000,0,0,1600,1600,0,0,4660,4660,3560,0,1850,360,160,456,144,125
2020,630600361,330,330,30,30,300,0,0,0,0,0,0,0,0,0,0,0,0,0,939,420,15,24,8,1
2020,630600371,23528,5528,5528,5528,0,18000,18000,18000,0,0,0,0,0,0,4500,4500,4500,0,1318,440,250,55,96,19
2020,630700241,24450,3745,3745,3745,0,20705,20000,20000,0,0,705,705,0,0,1400,1400,900,500,2268,180,24,240,240,50
2020,630700261,36915,1800,1800,1800,0,35115,35000,35000,0,0,115,0,115,0,1000,0,0,0,1608,388,180,36,24,40
2020,630700271,53238,14738,4738,4738,10000,38500,36000,0,36000,0,2500,2500,0,0,6900,0,0,0,4184,704,300,240,120,187
2020,630700281,20802,2002,2002,2002,0,18800,18000,18000,0,0,800,800,0,0,13682,13682,10452,3230,4900,720,200,250,350,1456
2020,630700301,2100,100,100,100,0,2000,2000,2000,0,0,0,0,0,0,0,0,0,0,1209,172,850,20,22,3
2020,630700311,120,120,120,120,0,0,0,0,0,0,0,0,0,0,0,0,0,0,1001,180,50,35,40,137
2020,630700331,17332,2264,2264,2264,0,15068,15000,15000,0,0,68,0,68,0,7700,4200,0,4200,584,200,60,36,59,9
2020,630700341,2800,300,300,300,0,2500,2500,2500,0,0,0,0,0,0,0,0,0,0,648,160,40,30,18,1
2020,630700361,18697,4492,4492,4492,0,14205,12000,12000,0,0,2205,2160,45,0,10611,10611,9919,500,3000,480,600,480,180,564
2020,630700381,44567,13317,13317,13317,0,31250,30200,20000,10200,0,1050,400,650,0,4500,3000,3000,0,1030,120,30,200,120,201
2020,630700391,58937,8937,8937,8937,0,50000,46000,24000,22000,0,4000,3900,100,0,28245,16245,16245,0,6234,528,24,1830,480,226
2020,630800201,79915,16915,415,415,16500,63000,63000,0,63000,0,0,0,0,0,45000,16000,16000,0,2749,276,240,144,260,91
2020,630800211,3265,3265,3265,3265,0,0,0,0,0,0,0,0,0,0,0,0,0,0,754,60,360,5,14,1
2020,630800221,10998,500,500,500,0,10498,10000,10000,0,0,498,498,0,0,2780,2780,2780,0,2770,180,100,300,360,25
2020,630800231,3050,3050,50,50,3000,0,0,0,0,0,0,0,0,0,530,530,0,530,2017,160,32,100,260,1
2020,630800261,45165,3488,3488,3488,0,41677,40000,40000,0,0,1677,1139,538,0,8300,8300,8300,0,3652,276,20,240,216,422
2020,630800291,106214,12314,12314,12314,0,93900,93000,45000,48000,0,900,900,0,0,20500,0,0,0,6220,550,1200,300,220,719
2020,630800301,8333,433,433,433,0,7900,6000,6000,0,0,1900,1900,0,0,0,0,0,0,3320,180,100,240,360,42
2020,630800311,990,890,590,90,300,100,0,0,0,0,100,0,100,0,700,700,0,0,1145,540,280,15,20,1
2020,630800321,8863,1813,1813,1813,0,7050,7000,7000,0,0,50,50,0,0,0,0,0,0,1500,150,120,230,120,18
2020,630800331,7770,7470,470,470,7000,300,0,0,0,0,300,300,0,0,0,0,0,0,2451,240,160,480,91,32
2020,630800341,12200,1600,1600,1600,0,10600,10000,10000,0,0,600,500,100,0,0,0,0,0,3760,520,120,240,120,52
2020,630800351,1413,1413,1413,1413,0,0,0,0,0,0,0,0,0,0,0,0,0,0,1694,76,36,140,216,1
2020,630800361,10160,100,100,100,0,10060,10000,10000,0,0,60,0,60,0,0,0,0,0,446,70,57,11,8,4
2020,630800371,29098,19558,19558,19558,0,9540,9000,9000,0,0,540,200,340,0,212,212,0,0,3212,360,96,180,84,542
2020,630800391,164237,16837,11837,4837,5000,147400,141000,0,141000,0,6400,2100,1300,3000,142100,52000,35000,14500,7730,1220,1200,450,360,509
2020,630900201,1073,1073,533,533,540,0,0,0,0,0,0,0,0,0,823,823,0,693,2191,250,150,183,66,1
2020,630900211,9908,4608,4108,4108,500,5300,0,0,0,0,5300,3300,2000,0,2500,2500,0,0,2832,660,15,600,180,102
2020,630900221,1020,1020,520,520,500,0,0,0,0,0,0,0,0,0,0,0,0,0,2502,612,50,360,300,1
2020,630900241,34060,3660,3660,3660,0,30400,29000,29000,0,0,1400,1400,0,0,17800,17800,17800,0,3504,300,0,600,144,70
2020,630900251,80512,5460,5460,3460,0,75052,70000,30000,40000,0,5052,2600,952,1500,46920,44920,43000,0,3700,360,100,500,240,190
2020,630900291,89099,22893,22893,21893,0,66206,55000,50000,5000,0,11206,1206,10000,0,8500,8500,8500,0,4608,384,120,60,288,123
2020,630900301,31602,6200,6200,6200,0,25402,24000,24000,0,0,1402,950,452,0,500,0,0,0,1206,204,85,156,38,35
2020,630900321,9665,1638,1638,1638,0,8027,6300,5900,400,0,1727,1500,227,0,1516,1516,0,0,1558,144,22,180,180,22
2020,630900341,16100,8000,8000,8000,0,8100,7000,7000,0,0,1100,1100,0,0,912,912,0,0,4510,1060,730,240,120,237
2020,630900351,18790,1340,1340,1340,0,17450,17000,17000,0,0,450,450,0,0,0,0,0,0,820,180,10,120,60,66
2020,630900361,15600,2100,100,100,2000,13500,13000,0,13000,0,500,500,0,0,0,0,0,0,3090,840,30,240,200,203
2020,630900371,24710,11110,4210,4210,6900,13600,12000,0,12000,0,1600,1500,100,0,12790,12790,12390,400,2400,300,120,96,204,350
2020,630900381,508,508,8,8,500,0,0,0,0,0,0,0,0,0,0,0,0,0,781,300,50,60,36,1
2020,630900391,15,15,15,15,0,0,0,0,0,0,0,0,0,0,0,0,0,0,407,95,0,10,2,0
2020,631000222,41990,790,790,790,0,41200,40000,40000,0,0,1200,1000,200,0,4200,4200,3900,0,4842,950,150,200,288,109
2020,631000232,47360,4676,4676,4676,0,42684,42000,42000,0,0,684,300,384,0,5469,5469,5469,0,3953,576,170,400,123,610
2020,631000242,11031,10204,4204,4204,6000,827,0,0,0,0,827,827,0,0,100,100,100,0,2760,300,30,70,80,44
2020,631000252,260,60,10,10,50,200,0,0,0,0,200,0,200,0,0,0,0,0,783,300,60,23,78,1
2020,631000262,22858,19358,6858,6858,12500,3500,3500,0,0,3500,0,0,0,0,9796,9796,8388,1408,1514,115,75,36,60,164
2020,631000272,37420,3560,3560,3560,0,33860,32950,29000,0,3950,910,910,0,0,10000,10000,0,0,2353,552,80,366,276,824
2020,631000292,42049,9170,9170,9170,0,32879,30000,30000,0,0,2879,2189,690,0,0,0,0,0,4498,276,10,370,228,711
2020,631000302,19964,1964,1964,1964,0,18000,18000,18000,0,0,0,0,0,0,1500,1500,1500,0,4080,320,100,150,220,203
2020,631000312,49740,17240,17240,17240,0,32500,30000,30000,0,0,2500,2500,0,0,0,0,0,0,4066,240,180,360,120,522
2020,631000332,247580,21880,7880,7880,14000,225700,225000,0,225000,0,700,700,0,0,49500,0,0,0,2400,240,100,480,120,2822
2020,631000342,48276,7976,7976,7976,0,40300,40000,40000,0,0,300,300,0,0,10600,10000,10000,0,1200,203,100,40,54,89
2020,631000352,450,210,90,90,120,240,0,0,0,0,240,240,0,0,0,0,0,0,1796,336,20,200,70,31
2020,631000362,18710,230,230,230,0,18480,18000,0,0,18000,480,480,0,0,700,700,0,700,5174,192,72,480,240,361
2020,631000372,4248,3798,798,798,3000,450,0,0,0,0,450,450,0,0,0,0,0,0,972,264,300,60,72,38
2020,631000382,1710,1710,410,410,1300,0,0,0,0,0,0,0,0,0,5600,5600,0,0,1254,264,30,30,120,8
2020,631000392,19043,4643,3343,3343,1300,14400,10000,0,0,10000,4400,4300,100,0,15500,15500,15000,0,2858,288,20,700,360,69
2020,631600201,9058,990,990,990,0,8068,8000,8000,0,0,68,0,68,0,0,0,0,0,1284,120,240,120,180,11
2020,631600231,49350,3850,3850,3850,0,45500,45500,42000,3500,0,0,0,0,0,500,0,0,0,1044,350,320,18,27,61
2020,631600301,5598,1028,1028,1028,0,4570,4500,4500,0,0,70,70,0,0,0,0,0,0,1189,159,43,240,114,11
2020,631600311,1775,1775,775,775,1000,0,0,0,0,0,0,0,0,0,2000,2000,0,0,2098,688,213,25,95,2
2020,631600331,39613,9113,9113,8713,0,30500,30000,10000,20000,0,500,400,100,0,12000,10000,10000,0,3117,230,60,315,186,28
2020,631600341,213300,3000,3000,3000,0,210300,210000,160000,50000,0,300,300,0,0,32620,5120,5000,0,3000,180,60,240,36,382
2020,631600371,6062,362,362,362,0,5700,5500,5500,0,0,200,0,200,0,684,684,624,0,1448,250,150,60,48,6
2020,631600381,24200,1100,1100,1100,0,23100,21000,15000,6000,0,2100,1400,700,0,8000,8000,3200,4800,1421,60,910,156,80,107
2020,631700201,37330,7330,7330,7330,0,30000,30000,30000,0,0,0,0,0,0,0,0,0,0,1540,180,30,60,96,72
2020,631700211,47555,9955,9955,9955,0,37600,35000,33000,2000,0,2600,2600,0,0,2600,2600,2600,0,3460,240,100,200,120,358
2020,631700221,16984,16984,2984,2984,14000,0,0,0,0,0,0,0,0,0,10600,10600,9050,1550,2620,150,100,550,240,9
2020,631700231,11515,3115,3115,2715,0,8400,7500,7500,0,0,900,900,0,0,0,0,0,0,3005,130,1140,195,108,72
2020,631700261,61544,20674,20674,20674,0,40870,40000,40000,0,0,870,370,500,0,0,0,0,0,4543,324,150,100,144,410
2020,631700271,22802,1302,1302,1302,0,21500,21500,21500,0,0,0,0,0,0,0,0,0,0,1553,250,600,36,84,80
2020,631700281,16309,4409,4409,4409,0,11900,10000,10000,0,0,1900,1900,0,0,1104,1104,0,0,2195,140,80,370,360,39
2020,631700321,51250,150,150,150,0,51100,51000,0,51000,0,100,100,0,0,28718,3718,0,3700,1564,108,200,250,42,93
2020,631700361,1745,945,745,745,200,800,0,0,0,0,800,800,0,0,797,797,0,0,1598,396,10,250,144,73
2020,631700381,30944,6544,6544,6544,0,24400,22000,10000,12000,0,2400,1100,1300,0,0,0,0,0,2870,400,50,300,120,342
2020,631700391,24043,9343,9343,9343,0,14700,13000,13000,0,0,1700,1700,0,0,7000,7000,7000,0,5600,500,80,360,480,194
2020,631800211,94858,230,230,230,0,94628,94000,36000,58000,0,628,579,49,0,30000,0,0,0,1066,210,15,300,84,108
2020,631800231,5391,3511,3011,2811,500,1880,0,0,0,0,1880,1880,0,0,10180,10180,700,180,2380,800,200,200,250,1061
2020,631800261,12342,2592,2592,2592,0,9750,9100,9100,0,0,650,650,0,0,4500,4500,0,0,1713,188,480,252,117,39
2020,631800271,18297,1097,1097,1097,0,17200,17000,17000,0,0,200,200,0,0,19210,19210,15400,670,1636,240,20,60,264,115
2020,631800281,23390,5500,5500,5500,0,17890,17660,17660,0,0,230,0,230,0,0,0,0,0,2084,360,650,60,132,30
2020,631800291,1040,1040,40,40,1000,0,0,0,0,0,0,0,0,0,0,0,0,0,857,432,100,24,36,1
2020,631800301,87714,19514,19514,19514,0,68200,64800,55000,9800,0,3400,3400,0,0,10236,8236,8130,0,2710,300,300,220,200,492
2020,631800311,31180,4100,4100,4100,0,27080,25000,25000,0,0,2080,2080,0,0,13436,13436,13436,0,3050,280,50,700,250,518
2020,631800321,12727,727,727,727,0,12000,12000,12000,0,0,0,0,0,0,0,0,0,0,1140,200,80,30,30,31
2020,631800331,32726,8626,2126,2126,6500,24100,20500,0,20500,0,3600,3600,0,0,15600,2600,2600,0,3730,280,70,400,180,66
2020,631800341,20476,3676,3676,2676,0,16800,15000,15000,0,0,1800,1800,0,0,1730,1730,1730,0,3068,240,40,180,300,55
2020,631800351,71674,30849,4849,4849,26000,40825,37125,0,37125,0,3700,3700,0,0,46935,30435,0,30435,4410,300,200,600,240,1510
2020,631800361,99208,14908,14908,12908,0,84300,83000,32000,51000,0,1300,800,500,0,14000,7000,7000,0,4706,264,800,150,180,216
2020,631800371,34366,5466,5466,5466,0,28900,20900,17500,3400,0,8000,3000,5000,0,5530,5530,5000,530,2264,120,360,480,84,70
2020,631800381,12998,10460,10460,10460,0,2538,2500,2500,0,0,38,0,38,0,0,0,0,0,551,136,84,30,48,4
2020,631800391,3430,290,290,290,0,3140,3000,3000,0,0,140,0,140,0,0,0,0,0,487,100,100,10,17,2
2020,631900211,1020,1020,20,20,1000,0,0,0,0,0,0,0,0,0,0,0,0,0,1608,660,100,160,96,60
2020,631900221,23340,6640,6640,6640,0,16700,16000,16000,0,0,700,450,250,0,0,0,0,0,4134,336,600,300,228,245
2020,631900241,3550,3550,350,350,3200,0,0,0,0,0,0,0,0,0,2000,2000,2000,0,3744,384,100,240,240,81
2020,631900261,1085,1085,585,585,500,0,0,0,0,0,0,0,0,0,14,14,0,0,487,184,60,50,15,1
2020,631900281,59060,3760,3760,3760,0,55300,47000,22000,25000,0,8300,3300,5000,0,51529,51529,48929,0,3378,348,100,20,360,1961
2020,631900291,59875,32190,32190,31190,0,27685,27000,27000,0,0,685,125,560,0,0,0,0,0,2302,288,300,240,204,138
2020,631900301,18643,4643,4643,4643,0,14000,12000,12000,0,0,2000,2000,0,0,3668,3668,2768,900,4500,420,35,550,320,591
2020,631900331,74550,14300,14300,14300,0,60250,60000,60000,0,0,250,250,0,0,400,0,0,0,2174,180,700,240,84,140
2020,631900341,20120,7720,7720,7720,0,12400,11000,11000,0,0,1400,1400,0,0,0,0,0,0,1450,120,20,120,120,156
2020,631900351,18304,9804,9804,9804,0,8500,8000,8000,0,0,500,500,0,0,0,0,0,0,3020,240,200,600,120,113
2020,631900361,81736,25736,25736,17736,0,56000,46000,24000,22000,0,10000,2000,8000,0,0,0,0,0,5680,300,160,240,360,407
2020,631900371,49730,25230,12230,12230,13000,24500,22000,0,0,22000,2500,2500,0,0,0,0,0,0,5556,360,90,380,286,744
2020,631900381,3535,2935,2935,2935,0,600,0,0,0,0,600,600,0,0,0,0,0,0,1292,180,10,220,132,13
2020,631900391,37655,7655,7655,7655,0,30000,30000,4000,26000,0,0,0,0,0,900,900,900,0,741,170,200,6,65,30
2020,632000212,3080,2480,2480,2480,0,600,0,0,0,0,600,600,0,0,7865,7865,7865,0,1149,115,60,84,90,52
2020,632000232,65040,3990,3990,3990,0,61050,60700,30700,30000,0,350,350,0,0,57500,30000,30000,0,1860,360,30,120,160,82
2020,632000242,40140,1640,1640,1640,0,38500,35000,35000,0,0,3500,3500,0,0,1495,1495,1495,0,2170,420,250,250,150,135
2020,632000252,19258,14758,2258,2258,12500,4500,4500,0,0,4500,0,0,0,0,6000,6000,6000,0,2026,120,220,180,96,40
2020,632000282,1960,1960,1460,1460,500,0,0,0,0,0,0,0,0,0,0,0,0,0,1247,600,10,60,72,25
2020,632000292,8030,30,30,30,0,8000,8000,8000,0,0,0,0,0,0,0,0,0,0,959,180,36,3,0,4
2020,632000302,69320,7230,7230,4230,0,62090,50000,20000,30000,0,12090,5890,6200,0,3000,3000,0,3000,5180,150,200,1000,350,62
2020,632000312,2397,17,17,17,0,2380,2000,2000,0,0,380,380,0,0,350,350,350,0,452,117,40,13,89,23
2020,632000322,44717,9297,9297,9297,0,35420,35420,7970,27450,0,0,0,0,0,0,0,0,0,1127,125,384,35,46,25
2020,632000332,8038,5038,738,738,4300,3000,0,0,0,0,3000,3000,0,0,70,70,0,0,2232,144,20,300,168,71
2020,632600201,54180,4180,4180,4180,0,50000,50000,15000,35000,0,0,0,0,0,35400,3400,3400,0,640,84,36,30,60,43
2020,632600231,13668,6168,2168,2168,4000,7500,4500,0,0,4500,3000,3000,0,0,1072,1072,0,0,1648,228,60,300,240,137
2020,632600241,5502,5502,3102,3102,2400,0,0,0,0,0,0,0,0,0,0,0,0,0,1485,384,60,60,60,1
2020,632600261,61840,4930,4930,4930,0,56910,56000,56000,0,0,910,850,60,0,7500,7500,7500,0,2980,240,60,240,180,44
2020,632600271,46200,600,600,600,0,45600,43000,43000,0,0,2600,2600,0,0,0,0,0,0,2852,240,500,240,300,457
2020,632600291,102794,29444,29444,29444,0,73350,72000,55000,17000,0,1350,1350,0,0,15500,7500,7500,0,5828,420,400,360,288,443
2020,632600311,500,500,500,500,0,0,0,0,0,0,0,0,0,0,0,0,0,0,589,56,100,30,18,8
2020,632600321,92505,9405,9405,9405,0,83100,78500,14000,64500,0,4600,2300,2300,0,7700,7700,7700,0,1786,98,120,200,178,141
2020,632600331,4650,150,150,150,0,4500,4500,4500,0,0,0,0,0,0,0,0,0,0,1200,240,240,120,24,1033
2020,632600341,17291,11041,11041,6041,0,6250,5000,5000,0,0,1250,1250,0,0,7850,7850,7500,150,4990,400,50,660,360,160
2020,632700201,15481,3862,3862,3862,0,11619,11000,11000,0,0,619,619,0,0,3000,3000,3000,0,3114,156,30,600,340,336
2020,632700221,27420,5240,5240,5240,0,22180,21500,21500,0,0,680,680,0,0,8953,8953,8953,0,5520,340,800,700,300,84
2020,632700261,4400,4400,800,800,3600,0,0,0,0,0,0,0,0,0,0,0,0,0,515,300,10,36,0,1
2020,632700301,520,520,20,20,500,0,0,0,0,0,0,0,0,0,0,0,0,0,498,100,60,20,8,1
2020,632700311,9640,8140,8140,8140,0,1500,1500,1500,0,0,0,0,0,0,0,0,0,0,1510,140,360,144,76,8
2020,632700331,9300,300,300,300,0,9000,9000,0,9000,0,0,0,0,0,0,0,0,0,659,132,84,12,12,12
2020,632800201,28236,26783,6783,6783,20000,1453,0,0,0,0,1453,1340,113,0,15000,15000,15000,0,4824,631,250,200,240,420
2020,632800241,77650,25550,25550,25050,0,52100,50000,50000,0,0,2100,2100,0,0,29000,29000,27000,2000,6676,456,800,540,360,91
2020,632800251,21761,20491,4491,4491,16000,1270,0,0,0,0,1270,700,570,0,12000,12000,12000,0,2832,228,36,177,240,19
2020,632800271,17095,2795,2795,2795,0,14300,14000,14000,0,0,300,300,0,0,1900,1900,1900,0,1720,270,10,40,100,31
2020,632800281,15200,5700,5700,5700,0,9500,9000,9000,0,0,500,500,0,0,0,0,0,0,2040,180,20,100,180,621
2020,632800291,44848,5048,5048,5048,0,39800,38000,38000,0,0,1800,1800,0,0,6500,6500,3500,0,3554,234,95,382,160,133
2020,632800301,73935,12235,12235,12235,0,61700,56000,21000,15000,20000,5700,2500,3200,0,43120,43120,21200,2900,3670,220,630,100,290,584
2020,632800311,11401,751,751,751,0,10650,10600,1800,8800,0,50,0,50,0,0,0,0,0,616,148,120,24,32,8
2020,632800331,68160,7760,7760,7760,0,60400,59000,4000,55000,0,1400,1400,0,0,0,0,0,0,3095,200,650,400,108,74
2020,632900221,5354,4744,2444,2444,2300,610,0,0,0,0,610,610,0,0,1758,1758,1508,0,1609,396,210,156,120,7
2020,632900241,10020,20,20,20,0,10000,10000,10000,0,0,0,0,0,0,6500,6500,5000,0,1790,240,10,360,260,67
2020,632900251,46042,1992,1992,1992,0,44050,41050,40000,1050,0,3000,2000,1000,0,3000,3000,1500,0,1872,400,30,72,300,96
2020,632900281,110800,30200,30200,28400,0,80600,79100,30000,47600,1500,1500,1500,0,0,8800,0,0,0,2755,144,160,200,91,96
2020,632900301,28000,11500,11500,11500,0,16500,12000,12000,0,0,4500,4500,0,0,840,840,0,0,2418,180,156,220,192,856
2020,632900311,27690,1550,1550,1550,0,26140,25100,550,24550,0,1040,1000,40,0,0,0,0,0,1516,60,500,150,96,20
2020,632900331,3340,240,240,240,0,3100,3100,3100,0,0,0,0,0,0,0,0,0,0,452,156,50,16,22,2
2020,633000212,316,316,316,316,0,0,0,0,0,0,0,0,0,0,0,0,0,0,632,155,52,60,15,1
2020,633000222,82200,1000,1000,1000,0,81200,80000,20000,60000,0,1200,1200,0,0,10000,10000,10000,0,2370,180,480,240,60,84
2020,633600211,18070,1170,1170,1170,0,16900,10000,10000,0,0,6900,1600,300,5000,0,0,0,0,1272,140,500,180,12,62
2020,633600221,7550,100,100,100,0,7450,6500,3000,3500,0,950,250,350,350,300,300,300,0,695,60,20,30,25,15
2020,633700201,34360,7380,7380,7380,0,26980,26500,23000,3500,0,480,480,0,0,0,0,0,0,2638,200,40,400,98,106
2020,633700211,60705,15738,15738,11238,0,44967,42000,42000,0,0,2967,1067,1900,0,18500,18500,18500,0,3940,280,120,360,240,121
2020,633800201,91230,6030,6030,6030,0,85200,85000,30000,20000,35000,200,200,0,0,38000,30000,30000,0,3150,300,200,300,300,391
2020,633900201,221760,1060,1060,1060,0,220700,220000,75000,145000,0,700,700,0,0,89000,54000,54000,0,1830,280,50,240,120,165
2020,633900211,7640,4640,4640,4640,0,3000,3000,3000,0,0,0,0,0,0,0,0,0,0,1146,280,30,40,36,3
2020,640000202,18254,2473,2473,2073,0,15781,14900,14900,0,0,881,650,231,0,9034,9034,9000,0,3901,264,55,540,192,119
2020,640000212,88745,11106,11106,9106,0,77639,75000,75000,0,0,2639,1500,1139,0,38000,38000,38000,0,5142,1566,480,425,226,251
2020,640000222,56573,17015,17015,17015,0,39558,37500,20000,17500,0,2058,1380,678,0,0,0,0,0,3387,241,105,241,121,198
2020,640000242,22973,5006,5006,5006,0,17967,17200,17200,0,0,767,700,67,0,0,0,0,0,1921,222,308,364,121,1153
2020,640000252,245,245,45,45,200,0,0,0,0,0,0,0,0,0,0,0,0,0,1085,168,14,96,222,1
2020,640000262,29845,13561,13561,13561,0,16284,16000,16000,0,0,284,199,85,0,300,0,0,0,1613,156,93,31,84,73
2020,640000272,522,122,122,122,0,400,0,0,0,0,400,400,0,0,0,0,0,0,1932,286,156,184,98,1
2020,640000282,52822,19602,19602,19602,0,33220,21200,21200,0,0,12020,1840,180,10000,0,0,0,0,2152,336,87,192,94,2013
2020,640000292,4536,4421,2921,2921,1500,115,0,0,0,0,115,115,0,0,2000,2000,0,2000,1674,543,126,187,96,10
2020,640000302,110740,9540,9540,9540,0,101200,94000,30000,64000,0,7200,7200,0,0,54200,34000,10000,18000,5400,360,1500,800,480,1484
2020,640000312,419818,9668,9668,9668,0,410150,407000,20500,384500,2000,3150,150,3000,0,150000,150000,150000,0,1760,320,350,180,180,238
2020,640000332,2550,2550,550,550,2000,0,0,0,0,0,0,0,0,0,0,0,0,0,1170,50,100,50,50,1
2020,640000342,15956,5656,5656,5656,0,10300,10000,10000,0,0,300,300,0,0,2300,2300,2300,0,3240,240,160,360,240,161
2020,640000352,15964,14664,7364,7364,7300,1300,0,0,0,0,1300,1300,0,0,2000,2000,0,2000,2720,120,580,240,120,37
2020,640000362,9660,8360,1360,1360,7000,1300,0,0,0,0,1300,1300,0,0,3600,3600,3600,0,1401,120,5,240,96,420
2020,640000372,39600,12600,12600,12600,0,27000,26000,26000,0,0,1000,1000,0,0,13000,13000,13000,0,6100,400,600,700,300,461
2020,640600211,2263,2263,1063,1063,1200,0,0,0,0,0,0,0,0,0,2500,2500,0,0,827,142,130,137,94,25
2020,640600221,19822,302,302,302,0,19520,19400,19400,0,0,120,0,120,0,0,0,0,0,971,228,72,36,20,22
2020,640600241,162102,20502,20502,20502,0,141600,137000,37000,100000,0,4600,4600,0,0,150,150,0,0,5134,545,305,120,500,945
2020,640600251,13142,5442,5442,5442,0,7700,5000,5000,0,0,2700,2700,0,0,0,0,0,0,1952,92,298,273,132,54
2020,640600271,29163,8320,8320,8320,0,20843,20000,15500,4500,0,843,390,453,0,0,0,0,0,1384,174,255,220,96,44
2020,640600281,47914,5014,5014,5014,0,42900,42000,42000,0,0,900,900,0,0,0,0,0,0,4216,216,36,120,144,352
2020,640600301,8934,934,934,934,0,8000,8000,8000,0,0,0,0,0,0,0,0,0,0,1655,170,500,160,75,231
2020,640600321,10200,200,200,200,0,10000,10000,10000,0,0,0,0,0,0,0,0,0,0,886,240,100,10,16,19
2020,640600331,88370,17270,17270,9270,0,71100,70000,70000,0,0,1100,1100,0,0,54000,29000,26000,0,4500,1000,520,490,240,440
2020,640600341,36904,4104,4104,4104,0,32800,30000,30000,0,0,2800,2800,0,0,3000,3000,0,3000,2320,100,400,300,300,165
2020,640600351,1580,1580,80,80,1500,0,0,0,0,0,0,0,0,0,0,0,0,0,726,288,30,10,28,1
2020,640600361,82050,250,250,250,0,81800,80000,0,80000,0,1800,300,1500,0,5000,5000,5000,0,1613,192,400,240,60,96
2020,640600371,69198,21098,21098,21098,0,48100,45000,30000,15000,0,3100,3100,0,0,6400,6400,6400,0,4320,300,820,600,180,2992
2020,640600381,19626,3926,3926,3926,0,15700,15000,15000,0,0,700,700,0,0,11062,11062,9456,1500,3193,267,340,320,240,17
2020,640700201,19681,3562,3562,3562,0,16119,15000,15000,0,0,1119,780,339,0,100,0,0,0,1079,204,216,168,60,84
2020,640700241,68,68,68,68,0,0,0,0,0,0,0,0,0,0,0,0,0,0,540,92,72,24,28,0
2020,640700251,27173,1321,1321,1321,0,25852,25400,14900,10500,0,452,0,452,0,200,0,0,0,1603,132,480,108,72,15
2020,640700261,60608,5818,5818,5818,0,54790,54700,27700,27000,0,90,90,0,0,0,0,0,0,2252,348,485,167,39,69
2020,640700271,32534,3034,3034,3034,0,29500,29500,26500,3000,0,0,0,0,0,0,0,0,0,1079,160,36,30,36,30
2020,640700281,28591,4991,4991,4991,0,23600,22800,22800,0,0,800,800,0,0,4475,4475,2975,1500,3407,312,1600,200,49,62
2020,640700291,30489,24076,4576,4576,19500,6413,5000,0,0,5000,1413,1300,113,0,12000,12000,12000,0,1627,312,48,240,136,74
2020,640700311,30900,2900,2900,2900,0,28000,26000,16000,10000,0,2000,2000,0,0,600,0,0,0,3926,300,300,720,480,147
2020,640700321,130,130,30,30,100,0,0,0,0,0,0,0,0,0,0,0,0,0,520,300,20,12,28,1
2020,640700351,37636,636,636,636,0,37000,37000,13000,24000,0,0,0,0,0,10000,10000,10000,0,750,240,180,60,48,40
2020,640800211,38827,2927,2927,2927,0,35900,34500,34500,0,0,1400,1400,0,0,45536,45536,0,45500,1712,216,36,156,108,104
2020,640800231,6736,6033,3533,3533,2500,703,0,0,0,0,703,590,113,0,42,42,0,0,1929,98,83,207,184,42
2020,640800251,2535,1155,655,655,500,1380,0,0,0,0,1380,1380,0,0,30,30,0,0,1760,500,200,100,85,97
2020,640800271,39640,4700,4700,4700,0,34940,31000,31000,0,0,3940,3390,550,0,6815,6815,6815,0,4204,276,112,617,178,806
2020,640800281,44813,12370,12370,12370,0,32443,32000,32000,0,0,443,230,213,0,0,0,0,0,4686,204,78,288,245,127
2020,640800311,3162,3062,1062,1062,2000,100,0,0,0,0,100,100,0,0,0,0,0,0,2030,485,50,110,105,31
2020,640800321,2517,1941,1941,1941,0,576,0,0,0,0,576,350,226,0,2948,2948,0,2948,1720,120,180,260,110,16
2020,640800331,101700,43900,43900,32900,0,57800,51000,34000,17000,0,6800,6800,0,0,1000,0,0,0,3346,240,50,300,216,229
2020,640800341,29150,5050,5050,5050,0,24100,22000,22000,0,0,2100,2100,0,0,0,0,0,0,5180,300,100,350,300,871
2020,640800381,103470,10070,10070,10070,0,93400,92500,15000,77500,0,900,900,0,0,15205,15205,10205,5000,4550,300,50,300,200,546
2020,640900211,7364,7282,282,282,7000,82,0,0,0,0,82,0,82,0,4500,4500,4500,0,3112,144,24,396,600,9
2020,640900221,13117,11324,9324,6324,2000,1793,0,0,0,0,1793,1500,293,0,960,960,0,760,2103,168,132,342,103,94
2020,640900241,25076,76,76,76,0,25000,25000,25000,0,0,0,0,0,0,0,0,0,0,2558,1230,600,120,72,125
2020,640900251,12797,51,51,51,0,12746,12700,12700,0,0,46,0,46,0,0,0,0,0,390,103,60,60,18,4
2020,640900261,35979,2979,2979,2979,0,33000,33000,33000,0,0,0,0,0,0,6000,6000,5000,1000,637,96,320,12,15,23
2020,640900271,33221,9858,9858,9858,0,23363,23000,23000,0,0,363,250,113,0,11600,11600,10000,1500,3074,186,30,600,269,347
2020,640900281,43177,10956,10956,8956,0,32221,18000,18000,0,0,14221,1800,421,12000,0,0,0,0,2984,370,650,450,144,97
2020,640900301,2750,450,150,150,300,2300,0,0,0,0,2300,2300,0,0,3150,3150,0,0,1760,420,50,250,120,190
2020,640900311,9350,350,350,350,0,9000,9000,9000,0,0,0,0,0,0,1000,1000,1000,0,1790,260,100,80,90,11
2020,640900341,15414,4258,4258,3758,0,11156,10400,4000,6400,0,756,530,226,0,6950,6950,6350,0,1208,228,110,50,85,315
2020,640900371,21497,11377,11377,11377,0,10120,10000,10000,0,0,120,120,0,0,0,0,0,0,1425,72,3,302,36,889
2020,640900381,152270,20700,20700,20700,0,131570,130000,30000,100000,0,1570,1170,400,0,0,0,0,0,2884,557,16,384,156,330
2020,641000202,302,302,242,242,60,0,0,0,0,0,0,0,0,0,713,713,0,700,1246,228,12,24,61,1
2020,641000212,9418,3204,3204,3204,0,6214,6000,6000,0,0,214,190,24,0,4000,0,0,0,2766,280,10,360,228,70
2020,641000222,24002,3879,3879,3879,0,20123,18000,11000,7000,0,2123,2090,33,0,1500,1500,0,1500,3480,180,2000,120,120,71
2020,641000232,7620,6957,457,457,6500,663,0,0,0,0,663,630,33,0,2000,2000,2000,0,1037,64,43,112,42,11
2020,641000242,88768,19968,19968,19968,0,68800,67500,10000,57500,0,1300,400,900,0,0,0,0,0,1009,168,36,60,60,110
2020,641000252,7153,153,153,153,0,7000,7000,4000,3000,0,0,0,0,0,0,0,0,0,880,125,62,65,61,53
2020,641000262,132322,18222,18222,16222,0,114100,112000,40000,72000,0,2100,1100,1000,0,45525,14525,14375,0,3604,360,602,361,204,706
2020,641000272,62079,21109,21109,21109,0,40970,39000,39000,0,0,1970,1630,340,0,5000,5000,5000,0,3751,384,214,372,108,416
2020,641000292,33298,5998,5998,5998,0,27300,27000,27000,0,0,300,0,300,0,13301,13301,10011,240,2434,310,150,150,150,14
2020,641000302,19900,100,100,100,0,19800,19800,7000,12800,0,0,0,0,0,0,0,0,0,790,150,100,30,30,16
2020,641000312,8027,27,27,27,0,8000,8000,8000,0,0,0,0,0,0,2000,2000,2000,0,878,72,0,60,36,12
2020,641000322,22553,2440,2440,2440,0,20113,18500,8500,10000,0,1613,1500,113,0,0,0,0,0,2398,140,880,120,218,92
2020,641000342,200,200,200,200,0,0,0,0,0,0,0,0,0,0,0,0,0,0,772,180,120,20,24,1
2020,641000352,101690,1140,1140,1140,0,100550,100000,10000,90000,0,550,550,0,0,0,0,0,0,2066,324,200,66,96,327
2020,641000362,11000,150,150,150,0,10850,10500,3500,7000,0,350,350,0,0,800,800,800,0,982,30,20,120,72,35
2020,641000372,2046,30,30,30,0,2016,2000,2000,0,0,16,0,16,0,0,0,0,0,439,100,170,0,25,4
2020,641000382,550,550,350,150,200,0,0,0,0,0,0,0,0,0,4000,4000,0,4000,1020,120,100,150,30,1
2020,641000392,1092,1092,1092,1092,0,0,0,0,0,0,0,0,0,0,0,0,0,0,681,240,36,120,36,1
2020,641600201,991,991,891,891,100,0,0,0,0,0,0,0,0,0,15,15,0,0,1698,396,120,190,80,1
2020,641600221,22045,8132,8132,8132,0,13913,13800,13800,0,0,113,0,113,0,0,0,0,0,473,62,55,42,39,45
2020,641600231,18521,1339,1339,1339,0,17182,16600,16600,0,0,582,582,0,0,0,0,0,0,3641,327,61,123,303,148
2020,641600241,27226,4386,4386,4386,0,22840,21500,18500,3000,0,1340,1340,0,0,0,0,0,0,4153,144,61,302,363,495
2020,641600251,58900,12270,12270,12270,0,46630,45830,24000,21830,0,800,400,400,0,3630,630,630,0,2811,365,125,362,184,69
2020,641600291,9013,8931,7531,7531,1400,82,0,0,0,0,82,0,82,0,543,543,500,0,2359,277,361,481,181,1
2020,641600361,16570,3430,3430,3430,0,13140,13000,3000,10000,0,140,0,140,0,0,0,0,0,1896,240,1000,100,46,26
2020,641600391,51044,16444,16444,16444,0,34600,34000,22000,12000,0,600,600,0,0,6000,0,0,0,3326,360,60,180,360,1866
2020,641700201,21046,3613,3613,3613,0,17433,11000,11000,0,0,6433,6400,33,0,5505,5505,3000,0,3080,255,72,381,446,64
2020,641700211,256,256,13,13,243,0,0,0,0,0,0,0,0,0,0,0,0,0,608,102,18,40,6,0
2020,641700231,20063,19751,4751,4751,15000,312,0,0,0,0,312,0,312,0,1800,1800,1800,0,2310,210,200,600,240,1
2020,641700251,8008,8008,3008,3008,5000,0,0,0,0,0,0,0,0,0,0,0,0,0,1284,129,105,61,36,0
2020,641700271,30036,4346,4346,4346,0,25690,25200,4400,20800,0,490,390,100,0,344,344,0,200,2150,125,60,93,104,69
2020,641700281,21995,1495,1495,1495,0,20500,20500,20500,0,0,0,0,0,0,0,0,0,0,680,216,288,12,24,55
2020,641700311,89671,29171,29171,29171,0,60500,55000,55000,0,0,5500,5500,0,0,0,0,0,0,6550,370,240,100,240,2317
2020,641700351,45600,7300,7300,7300,0,38300,38000,32000,6000,0,300,50,250,0,1200,0,0,0,2681,60,2000,96,0,178
2020,641700361,6852,3690,3690,3690,0,3162,2000,2000,0,0,1162,1107,55,0,1570,1570,0,700,2940,230,1050,710,18,31
2020,641700371,21500,8900,8900,8400,0,12600,12600,4300,8300,0,0,0,0,0,500,0,0,0,1635,300,500,200,15,41
2020,641700381,37940,2340,2340,2340,0,35600,35000,35000,0,0,600,600,0,0,0,0,0,0,1020,250,50,120,50,76
2020,641700391,142521,17341,17341,17341,0,125180,120000,43000,77000,0,5180,4500,680,0,5000,5000,5000,0,3461,360,360,420,180,1379
2020,641800201,39369,1555,1555,1555,0,37814,35700,27000,8700,0,2114,1860,254,0,150,150,0,0,6290,300,270,840,300,274
2020,641800211,22767,2367,2367,2367,0,20400,19000,19000,0,0,1400,1400,0,0,5000,5000,5000,0,1462,236,63,231,84,64
2020,641800231,561,561,72,72,489,0,0,0,0,0,0,0,0,0,0,0,0,0,1157,161,114,117,63,0
2020,641800241,16966,3865,3865,3865,0,13101,13000,13000,0,0,101,0,101,0,1756,1756,1756,0,1721,198,201,59,204,37
2020,641800251,17115,3560,3560,3560,0,13555,9500,9500,0,0,4055,2200,1855,0,2300,2300,2300,0,1689,101,300,150,360,135
2020,641800261,3,3,3,3,0,0,0,0,0,0,0,0,0,0,0,0,0,0,667,168,82,14,51,1
2020,641800271,30534,16650,15150,15150,1500,13884,0,0,0,0,13884,1500,384,12000,0,0,0,0,1360,239,52,61,94,37
2020,641800281,17630,30,30,30,0,17600,17600,16300,1300,0,0,0,0,0,0,0,0,0,563,127,160,10,15,16
2020,641800291,2311,2061,1061,1061,1000,250,0,0,0,0,250,250,0,0,1667,1667,0,1667,2755,900,540,108,205,6
2020,641800361,6452,452,452,452,0,6000,6000,3500,2500,0,0,0,0,0,0,0,0,0,806,196,60,10,77,6
2020,641800371,18408,8908,8908,8908,0,9500,7000,7000,0,0,2500,2500,0,0,0,0,0,0,2000,120,20,300,120,394
2020,641800381,20217,150,150,150,0,20067,20000,20000,0,0,67,0,67,0,0,0,0,0,873,360,150,10,60,20
2020,641800391,10986,9786,9586,9586,200,1200,0,0,0,0,1200,850,350,0,0,0,0,0,1750,160,70,380,180,97
2020,641900201,553,553,3,3,550,0,0,0,0,0,0,0,0,0,0,0,0,0,681,252,25,38,34,0
2020,641900211,46095,9465,9465,9465,0,36630,30130,22130,8000,0,6500,3500,3000,0,22860,22860,8860,14000,2287,265,64,426,138,83
2020,641900241,8268,5468,4968,2968,500,2800,0,0,0,0,2800,1500,0,1300,1000,1000,0,1000,4781,534,600,350,500,141
2020,641900281,5066,4496,896,896,3600,570,0,0,0,0,570,500,70,0,0,0,0,0,1882,480,36,276,180,60
2020,641900291,1602,1602,40,40,1562,0,0,0,0,0,0,0,0,0,0,0,0,0,716,168,300,14,15,1
2020,641900301,8798,2868,2868,2868,0,5930,5500,5500,0,0,430,400,30,0,0,0,0,0,1750,250,100,350,100,49
2020,641900321,13696,1146,1146,1146,0,12550,12000,6000,6000,0,550,500,50,0,0,0,0,0,1609,391,15,205,36,62
2020,641900341,570,370,70,70,300,200,0,0,0,0,200,200,0,0,8050,8050,0,1050,2709,516,30,720,380,281
2020,641900351,66200,28000,2000,2000,26000,38200,35000,0,35000,0,3200,3200,0,0,30900,2900,2000,0,3590,240,200,300,300,393
2020,641900371,36220,7920,7920,7920,0,28300,21000,21000,0,0,7300,5800,1500,0,12500,12500,12000,500,3640,300,400,700,240,547
2020,641900381,270,270,270,270,0,0,0,0,0,0,0,0,0,0,0,0,0,0,374,90,110,25,30,1
2020,641900391,35916,3016,3016,3016,0,32900,30000,30000,0,0,2900,400,2500,0,18400,18400,18400,0,3185,360,40,960,400,125
2020,642000212,19462,17593,10593,10593,7000,1869,0,0,0,0,1869,1700,169,0,750,750,0,0,3227,104,636,375,240,272
2020,642000232,15131,1531,1531,1531,0,13600,13000,13000,0,0,600,600,0,0,1000,1000,1000,0,1789,241,301,181,301,91
2020,642000312,505,365,65,65,300,140,0,0,0,0,140,140,0,0,520,520,520,0,2128,204,30,360,384,18
2020,642000322,26329,17884,17884,17884,0,8445,6615,4000,2615,0,1830,500,1330,0,0,0,0,0,1776,140,100,110,125,39
2020,642000332,3694,546,546,546,0,3148,3000,3000,0,0,148,80,68,0,2000,2000,2000,0,839,113,25,120,42,41
2020,642000352,26680,5480,4480,4480,1000,21200,20000,0,20000,0,1200,700,500,0,2000,2000,0,2000,4070,1100,100,400,220,318
2020,642000362,550,300,300,300,0,250,0,0,0,0,250,250,0,0,0,0,0,0,1289,168,150,150,46,3
2020,642000372,3878,3078,110,110,2968,800,0,0,0,0,800,800,0,0,30,30,0,0,1502,384,500,120,44,55
2020,642000382,3374,2874,874,874,2000,500,0,0,0,0,500,500,0,0,4600,4600,0,4000,2177,324,700,220,156,1
2020,642600301,4743,103,103,103,0,4640,4500,4500,0,0,140,0,140,0,0,0,0,0,620,80,100,30,30,6
2020,642600311,206,206,206,206,0,0,0,0,0,0,0,0,0,0,0,0,0,0,275,64,10,6,28,1
2020,642600331,27276,2718,2718,2718,0,24558,22000,9000,13000,0,2558,1055,503,1000,800,800,800,0,2919,561,40,218,184,70
2020,642600341,12290,5500,5500,5500,0,6790,6500,0,6500,0,290,200,90,0,0,0,0,0,817,360,96,45,30,21
2020,642600351,26511,1061,1061,1061,0,25450,24000,24000,0,0,1450,1250,200,0,10160,10160,10160,0,5550,360,180,1200,360,235
2020,642700201,35154,21749,6749,6749,15000,13405,12000,0,0,12000,1405,1250,155,0,11131,11131,5131,6000,2780,310,70,370,110,105
2020,642700211,18037,37,37,37,0,18000,18000,18000,0,0,0,0,0,0,1392,1392,1379,0,992,204,30,28,60,21
2020,642700221,74869,17309,17309,17309,0,57560,57000,57000,0,0,560,210,350,0,72,72,0,0,5129,382,98,206,240,560
2020,642700301,28526,2756,2756,2756,0,25770,22590,8490,14100,0,3180,800,2380,0,2000,2000,2000,0,1155,67,50,220,56,15
2020,642700331,47240,18740,18740,18740,0,28500,27000,15000,12000,0,1500,1500,0,0,0,0,0,0,2326,185,120,245,183,32
2020,642800201,97400,2700,2700,2700,0,94700,91000,41000,50000,0,3700,1200,2500,0,100,100,0,0,1027,120,60,60,103,58
2020,642800211,45010,7240,7240,7240,0,37770,36000,36000,0,0,1770,1050,720,0,0,0,0,0,3653,333,124,340,192,499
2020,642800311,2015,15,15,15,0,2000,2000,2000,0,0,0,0,0,0,0,0,0,0,950,170,120,125,65,3
2020,642800331,18779,479,479,479,0,18300,16800,0,16800,0,1500,1500,0,0,0,0,0,0,885,360,60,100,55,16
2020,642800361,10580,900,900,900,0,9680,9680,3000,6680,0,0,0,0,0,0,0,0,0,550,155,70,36,15,4
2020,642800371,52600,30500,30500,30500,0,22100,21000,13000,8000,0,1100,1100,0,0,0,0,0,0,5240,300,600,720,120,546
2020,642900201,2128,2128,1,1,2127,0,0,0,0,0,0,0,0,0,250,250,0,0,357,84,48,22,24,50
2020,642900211,3908,2305,1505,1505,800,1603,0,0,0,0,1603,1490,113,0,1000,1000,0,0,2511,612,11,241,181,45
2020,642900221,25412,14054,2554,2554,11500,11358,7500,0,0,7500,3858,3700,158,0,13500,13500,0,13500,5976,354,131,205,168,615
2020,642900231,39406,37554,26254,26254,11300,1852,0,0,0,0,1852,1400,452,0,0,0,0,0,3861,331,512,152,163,505
2020,642900241,4395,2311,2311,2311,0,2084,2000,0,2000,0,84,0,84,0,0,0,0,0,1000,66,154,20,29,4
2020,642900301,1700,1300,300,300,1000,400,0,0,0,0,400,400,0,0,0,0,0,0,1293,216,12,360,72,0
2020,642900311,56045,8040,8040,8040,0,48005,48000,18000,30000,0,5,0,5,0,0,0,0,0,1040,80,100,80,60,61
2020,642900321,9650,3150,3150,3150,0,6500,6500,4000,2500,0,0,0,0,0,0,0,0,0,1612,108,840,240,15,15
2020,642900331,16258,3158,3158,3158,0,13100,9900,8500,1400,0,3200,3200,0,0,2950,2950,2900,0,4840,260,400,700,290,336
2020,642900341,9513,13,13,13,0,9500,8000,8000,0,0,1500,1500,0,0,3850,3850,3800,0,2956,360,400,480,180,71
2020,642900371,20301,7445,7445,7445,0,12856,9000,5000,4000,0,3856,2500,1356,0,348,348,0,0,4352,458,250,520,414,227
2020,642900391,325,305,5,5,300,20,0,0,0,0,20,0,20,0,0,0,0,0,505,330,15,9,18,0
2020,643000312,150,150,150,150,0,0,0,0,0,0,0,0,0,0,0,0,0,0,294,40,24,0,0,1
2020,650000202,9950,2950,2950,2950,0,7000,7000,7000,0,0,0,0,0,0,0,0,0,0,898,112,40,20,60,17
2020,650000212,15058,7908,7908,7908,0,7150,7000,7000,0,0,150,0,150,0,60,60,0,0,1146,180,12,24,60,8
2020,650000272,15520,20,20,20,0,15500,15000,15000,0,0,500,500,0,0,0,0,0,0,1204,350,360,60,24,166
2020,650000282,19200,1700,1700,1700,0,17500,17000,17000,0,0,500,400,100,0,36,36,0,0,3710,240,450,420,240,150
2020,650000302,11200,200,200,200,0,11000,11000,11000,0,0,0,0,0,0,0,0,0,0,653,180,260,35,23,9
2020,650000312,24412,6112,6112,5112,0,18300,14000,14000,0,0,4300,4300,0,0,7600,7600,7600,0,2219,500,160,370,230,178
2020,650000322,32617,17517,17517,17517,0,15100,14000,14000,0,0,1100,1100,0,0,8350,8350,7000,1200,4942,250,12,480,264,38
2020,650000332,9960,2960,1960,960,1000,7000,0,0,0,0,7000,2000,0,5000,3700,3700,0,300,2688,1020,240,240,240,20
2020,650000352,2150,1150,150,150,1000,1000,0,0,0,0,1000,1000,0,0,122,122,0,0,1595,386,5,120,120,11
2020,650000372,69046,28706,28706,28706,0,40340,37000,17000,20000,0,3340,3340,0,0,10000,10000,10000,0,5357,372,150,300,360,426
2020,650000382,126120,29120,29120,29120,0,97000,97000,50000,47000,0,0,0,0,0,53500,33500,33000,500,1515,320,50,100,120,100
2020,650600201,16890,944,944,944,0,15946,15000,15000,0,0,946,500,446,0,0,0,0,0,2240,230,360,120,48,31
2020,650600211,314,314,74,74,240,0,0,0,0,0,0,0,0,0,342,342,0,0,598,102,12,28,36,0
2020,650600221,1004,894,330,330,564,110,0,0,0,0,110,110,0,0,1000,1000,0,0,2694,144,1500,180,60,48
2020,650600251,41826,8050,8050,8050,0,33776,30000,30000,0,0,3776,2750,1026,0,6000,6000,6000,0,5134,350,120,660,264,135
2020,650600261,1785,1785,1585,1585,200,0,0,0,0,0,0,0,0,0,3468,3468,1500,0,425,120,60,30,60,7
2020,650600301,26310,210,210,210,0,26100,25000,25000,0,0,1100,1100,0,0,2750,2750,2750,0,1490,240,200,60,156,338
2020,650600311,16110,110,110,110,0,16000,16000,16000,0,0,0,0,0,0,0,0,0,0,1086,240,20,50,36,17
2020,650600331,24510,8140,8140,3140,0,16370,16000,8000,8000,0,370,370,0,0,200,200,0,0,3848,166,1800,324,144,69
2020,650600341,91736,6856,6856,6856,0,84880,80000,80000,0,0,4880,4880,0,0,29500,29500,24500,5000,2950,450,240,800,110,347
2020,650600351,17440,14940,10940,9940,4000,2500,0,0,0,0,2500,500,1000,1000,0,0,0,0,1380,150,80,250,130,7
2020,650600361,7400,400,400,400,0,7000,7000,5000,2000,0,0,0,0,0,0,0,0,0,471,183,35,23,22,3
2020,650600381,65942,30842,30842,30842,0,35100,31900,25000,4000,2900,3200,2900,300,0,0,0,0,0,6686,540,36,960,450,963
2020,650600391,24086,6986,6986,6986,0,17100,14000,14000,0,0,3100,3000,100,0,2260,2260,0,0,3474,360,36,360,216,71
2020,650700221,5545,5445,4945,4945,500,100,0,0,0,0,100,100,0,0,890,890,800,0,2160,250,120,180,180,13
2020,650700231,17272,6372,1372,1372,5000,10900,0,0,0,0,10900,900,0,10000,0,0,0,0,1526,300,120,36,60,10
2020,650700261,21220,470,470,230,0,20750,20000,20000,0,0,750,250,500,0,0,0,0,0,1158,200,10,24,24,52
2020,650700281,31528,1528,1528,1528,0,30000,30000,0,30000,0,0,0,0,0,5000,0,0,0,1015,300,30,60,25,31
2020,650700291,73251,36951,36951,36951,0,36300,35000,30000,5000,0,1300,1100,200,0,2000,0,0,0,1940,120,100,360,120,90
2020,650700321,5830,5830,830,830,5000,0,0,0,0,0,0,0,0,0,80,80,0,0,1085,270,10,30,55,14
2020,650700331,127084,5184,5184,5184,0,121900,114000,14000,100000,0,7900,1900,0,6000,109150,89150,80000,5150,3512,336,80,240,360,324
2020,650700361,10280,280,280,280,0,10000,10000,7000,3000,0,0,0,0,0,0,0,0,0,828,190,100,28,30,7
2020,650700371,33084,18384,18384,11884,0,14700,13000,13000,0,0,1700,1350,350,0,0,0,0,0,2200,200,200,280,120,71
2020,650700381,188,75,75,75,0,113,0,0,0,0,113,0,113,0,0,0,0,0,665,240,65,30,45,1
2020,650700391,144557,60907,60907,60907,0,83650,82000,42000,40000,0,1650,1650,0,0,0,0,0,0,10020,400,20,350,120,1213
2020,650800201,10978,898,98,98,800,10080,10000,0,10000,0,80,0,80,0,8600,600,0,0,719,144,3,60,96,1
2020,650800211,104752,16722,16722,16722,0,88030,88000,30000,58000,0,30,30,0,0,7200,1700,1700,0,2140,360,250,360,120,111
2020,650800221,29310,1180,1180,1180,0,28130,28000,15000,13000,0,130,130,0,0,2500,0,0,0,1654,120,800,60,84,97
2020,650800241,80520,1740,1740,740,0,78780,64000,14000,50000,0,14780,14700,80,0,530,30,0,0,3020,240,480,800,240,514
2020,650800251,4900,100,100,100,0,4800,4800,4800,0,0,0,0,0,0,0,0,0,0,1160,118,120,40,51,11
2020,650800281,33030,9630,9630,9630,0,23400,23000,23000,0,0,400,400,0,0,3604,3604,3604,0,2960,400,10,200,400,63
2020,650800291,19300,1200,1200,1200,0,18100,17500,7500,10000,0,600,600,0,0,2400,2400,2400,0,2594,264,120,360,180,101
2020,650800311,40736,29336,17336,12336,12000,11400,5800,0,0,5800,5600,600,1000,4000,6700,6700,1500,5200,3970,320,200,300,250,321
2020,650800321,15100,3100,3100,3100,0,12000,12000,12000,0,0,0,0,0,0,0,0,0,0,522,160,60,50,22,17
2020,650800331,36518,6218,6218,6218,0,30300,28000,28000,0,0,2300,2300,0,0,4044,4044,4044,0,3116,225,36,120,180,75
2020,650800341,28076,6226,6226,6226,0,21850,21200,18000,3200,0,650,650,0,0,0,0,0,0,1664,224,140,340,110,30
2020,650800361,95870,33220,33220,33220,0,62650,62000,27000,35000,0,650,350,300,0,300,0,0,0,5479,480,1200,360,240,744
2020,650800371,30250,12850,12850,12850,0,17400,16500,16500,0,0,900,900,0,0,0,0,0,0,3915,350,45,370,170,439
2020,650800381,68574,56348,56348,56348,0,12226,11200,7200,4000,0,1026,800,226,0,0,0,0,0,2304,264,300,200,180,321
2020,650800391,36810,4475,4475,4475,0,32335,32000,26000,4000,2000,335,220,115,0,13300,13300,13300,0,3268,248,50,360,240,594
2020,650900231,14460,12760,2560,2560,10200,1700,0,0,0,0,1700,1700,0,0,2400,2400,2400,0,3190,480,200,480,420,117
2020,650900241,21800,8750,8750,8250,0,13050,10000,10000,0,0,3050,50,0,3000,0,0,0,0,1860,196,100,240,144,85
2020,650900251,4490,4490,490,490,4000,0,0,0,0,0,0,0,0,0,0,0,0,0,919,120,300,60,19,1
2020,650900261,10700,700,700,700,0,10000,10000,10000,0,0,0,0,0,0,1000,0,0,0,790,96,50,60,24,159
2020,650900271,1700,1700,1700,1700,0,0,0,0,0,0,0,0,0,0,0,0,0,0,961,264,90,15,20,1
2020,650900281,13724,4024,4024,4024,0,9700,9500,9500,0,0,200,200,0,0,4434,4434,3770,664,2630,180,15,360,360,61
2020,650900291,8720,7420,2420,2420,5000,1300,0,0,0,0,1300,1300,0,0,0,0,0,0,1082,120,20,120,72,100
2020,650900301,20448,19748,2748,2748,17000,700,0,0,0,0,700,700,0,0,8000,8000,8000,0,4220,160,10,30,20,121
2020,650900311,41180,13380,13380,13380,0,27800,25800,18000,7800,0,2000,2000,0,0,9800,9800,8500,1300,3942,234,100,350,288,124
2020,650900321,17176,1496,1496,1496,0,15680,14200,10000,4200,0,1480,1480,0,0,0,0,0,0,3250,300,100,400,200,164
2020,650900331,15804,15014,5014,2014,10000,790,0,0,0,0,790,700,90,0,3000,3000,0,1000,1726,170,20,216,120,38
2020,650900361,7986,7636,1636,1636,6000,350,0,0,0,0,350,350,0,0,6000,6000,6000,0,1720,420,20,240,240,31
2020,650900371,30672,12992,12992,12992,0,17680,16000,16000,0,0,1680,1380,300,0,2200,2200,2000,0,2566,240,100,500,276,363
2020,651000212,9630,7630,630,630,7000,2000,0,0,0,0,2000,1500,500,0,0,0,0,0,3546,216,210,240,240,69
2020,651000222,550,550,350,350,200,0,0,0,0,0,0,0,0,0,4900,4900,0,4900,886,360,2,50,72,27
2020,651000232,12400,12400,7400,7400,5000,0,0,0,0,0,0,0,0,0,0,0,0,0,425,168,20,15,22,5
2020,651000252,92987,22298,22298,22298,0,70689,70000,35000,35000,0,689,350,339,0,0,0,0,0,2480,366,200,180,60,112
2020,651000262,18618,6618,6618,6618,0,12000,12000,12000,0,0,0,0,0,0,0,0,0,0,1394,264,150,90,60,11
2020,651000272,77780,35180,35180,35180,0,42600,42000,42000,0,0,600,600,0,0,1500,1500,0,1500,5000,200,400,360,160,788
2020,651000282,21107,5007,5007,5007,0,16100,16000,16000,0,0,100,100,0,0,0,0,0,0,2816,240,30,72,144,691
2020,651000292,20272,16272,3272,3272,13000,4000,0,0,0,0,4000,4000,0,0,2500,2500,2500,0,3950,360,72,600,228,187
2020,651000302,5014,1414,1014,1014,400,3600,0,0,0,0,3600,3600,0,0,3900,3900,0,0,4440,720,60,600,360,161
2020,651000312,11930,130,130,130,0,11800,11000,11000,0,0,800,800,0,0,0,0,0,0,1435,200,70,100,60,14
2020,651000332,1888,888,688,688,200,1000,0,0,0,0,1000,1000,0,0,0,0,0,0,1334,252,30,156,180,25
2020,651000352,10,10,10,10,0,0,0,0,0,0,0,0,0,0,0,0,0,0,258,50,10,24,24,1
2020,651000362,90,40,40,40,0,50,0,0,0,0,50,0,50,0,0,0,0,0,560,90,40,25,25,1
2020,651000382,15238,1178,1178,1178,0,14060,13310,11000,2310,0,750,750,0,0,8574,8574,6874,1300,1873,236,30,250,250,149
2020,651000392,2020,2020,20,20,2000,0,0,0,0,0,0,0,0,0,130,130,0,0,5520,840,480,600,240,157
2020,651600211,13090,90,90,90,0,13000,13000,13000,0,0,0,0,0,0,0,0,0,0,792,180,84,36,24,0
2020,651600241,28780,2880,2880,2880,0,25900,25000,25000,0,0,900,900,0,0,0,0,0,0,2941,360,700,180,108,83
2020,651600261,17610,2880,2880,2880,0,14730,14500,12000,2500,0,230,230,0,0,0,0,0,0,1555,225,120,120,50,76
2020,651600271,27060,3060,3060,3060,0,24000,21000,21000,0,0,3000,3000,0,0,4800,4800,4800,0,1850,360,40,400,190,147
2020,651600281,50047,5234,5234,5234,0,44813,44000,44000,0,0,813,700,113,0,2500,2500,0,2500,5024,360,80,700,230,380
2020,651600291,1730,1030,580,580,450,700,0,0,0,0,700,700,0,0,270,270,0,0,1718,180,10,360,60,25
2020,651600301,19698,6198,6198,6198,0,13500,11800,5800,6000,0,1700,1700,0,0,5530,5530,4030,0,2330,250,30,400,200,63
2020,651600311,39543,19373,19373,19373,0,20170,17500,16000,1500,0,2670,2670,0,0,0,0,0,0,4225,285,50,380,300,118
2020,651600341,34520,3320,3320,3320,0,31200,31000,13000,18000,0,200,200,0,0,700,700,0,700,1870,200,100,320,110,60
2020,651600351,7605,2455,2455,2455,0,5150,5000,5000,0,0,150,0,150,0,0,0,0,0,1286,120,100,50,156,194
2020,651600361,35,35,35,35,0,0,0,0,0,0,0,0,0,0,0,0,0,0,564,150,100,15,24,1
2020,651600381,3250,3210,10,10,3200,40,0,0,0,0,40,40,0,0,0,0,0,0,1171,180,20,60,36,22
2020,651600391,7044,5994,4294,4294,1700,1050,0,0,0,0,1050,1050,0,0,1700,1700,0,1700,2960,260,600,600,180,50
2020,651700221,8707,4555,1555,1555,3000,4152,4052,0,4052,0,100,100,0,0,200,200,0,0,3450,300,200,490,300,20
2020,651700241,42050,11100,1100,100,10000,30950,30000,0,30000,0,950,950,0,0,24800,6800,5000,1800,4020,1020,20,600,240,75
2020,651700251,16660,8660,8660,8660,0,8000,8000,8000,0,0,0,0,0,0,0,0,0,0,852,180,60,36,0,25
2020,651700261,18000,18000,2000,2000,16000,0,0,0,0,0,0,0,0,0,12000,12000,12000,0,1366,120,40,120,108,16
2020,651700291,54134,19334,19334,8334,0,34800,30000,30000,0,0,4800,4800,0,0,25780,25780,20280,1500,2200,300,60,300,240,551
2020,651700301,30800,2050,2050,2050,0,28750,28500,5000,23500,0,250,0,250,0,0,0,0,0,967,150,70,60,82,16
2020,651700311,19210,8010,8010,8010,0,11200,10000,10000,0,0,1200,1200,0,0,2120,2120,2120,0,1954,264,20,420,240,224
2020,651700331,9421,8971,3471,2971,5500,450,0,0,0,0,450,450,0,0,1200,1200,1200,0,2570,450,40,250,260,198
2020,651700341,3950,1950,950,950,1000,2000,0,0,0,0,2000,500,1500,0,3000,3000,0,3000,1850,350,50,200,250,11
2020,651700351,6224,4254,3254,3254,1000,1970,0,0,0,0,1970,1700,270,0,1244,1244,0,0,1590,270,50,240,140,39
2020,651700361,14472,3972,3972,3972,0,10500,10500,10500,0,0,0,0,0,0,8966,8966,1966,0,1439,144,35,50,49,7
2020,651700371,8670,1670,1670,1670,0,7000,7000,7000,0,0,0,0,0,0,0,0,0,0,765,60,20,55,80,341
2020,651700391,1423,1373,1373,1373,0,50,0,0,0,0,50,50,0,0,2000,2000,0,2000,2532,220,50,260,240,3
2020,651800201,37880,2720,2720,2720,0,35160,35000,25000,10000,0,160,0,160,0,5000,5000,5000,0,969,240,15,24,80,80
2020,651800211,10150,10150,10150,10150,0,0,0,0,0,0,0,0,0,0,0,0,0,0,1637,180,20,30,120,289
2020,651800221,17530,7330,7330,7330,0,10200,8500,8500,0,0,1700,1700,0,0,1200,1200,0,0,4094,300,600,600,144,130
2020,651800241,33755,8855,8855,8855,0,24900,23000,23000,0,0,1900,1900,0,0,12250,12250,11250,1000,2819,444,300,360,180,421
2020,651800261,1335,1335,1235,1235,100,0,0,0,0,0,0,0,0,0,0,0,0,0,1095,300,20,60,24,7
2020,651800291,57300,20500,8500,8500,12000,36800,36000,0,36000,0,800,800,0,0,11000,0,0,0,3220,720,100,450,50,202
2020,651800301,600,550,550,550,0,50,0,0,0,0,50,0,50,0,0,0,0,0,945,100,150,45,50,22
2020,651800311,1310,20,20,20,0,1290,1000,1000,0,0,290,220,70,0,0,0,0,0,740,130,30,50,60,7
2020,651800321,2530,2530,2480,480,50,0,0,0,0,0,0,0,0,0,3500,3500,0,500,2020,360,10,100,240,11
2020,651800331,3751,1001,701,201,300,2750,0,0,0,0,2750,1800,450,500,2227,2227,900,0,2780,400,80,200,400,78
2020,651800341,8220,220,220,220,0,8000,8000,8000,0,0,0,0,0,0,0,0,0,0,1045,180,360,35,84,4
2020,651800351,6210,660,660,660,0,5550,4400,4400,0,0,1150,1150,0,0,3368,3368,2328,0,1510,240,5,300,40,57
2020,651800371,9920,2820,2820,2820,0,7100,7000,3000,4000,0,100,100,0,0,200,0,0,0,1950,300,30,170,250,112
2020,651800391,7200,7200,3000,3000,4200,0,0,0,0,0,0,0,0,0,0,0,0,0,690,240,10,20,20,1
2020,651900201,9860,2360,2360,2360,0,7500,7500,4500,3000,0,0,0,0,0,0,0,0,0,314,84,50,24,26,5
2020,651900211,1880,530,30,30,500,1350,0,0,0,0,1350,1350,0,0,3600,3600,0,0,1538,546,30,252,120,107
2020,651900221,24650,350,350,350,0,24300,22000,22000,0,0,2300,2300,0,0,12384,12384,12384,0,2530,400,100,100,300,84
2020,651900231,2084,1904,1404,1404,500,180,0,0,0,0,180,180,0,0,1900,1900,0,1200,2288,816,50,240,240,11
2020,651900251,7021,21,21,21,0,7000,7000,7000,0,0,0,0,0,0,1368,1368,1368,0,1340,180,10,250,180,11
2020,651900271,17050,2050,2050,2050,0,15000,15000,15000,0,0,0,0,0,0,0,0,0,0,836,200,84,120,60,11
2020,651900291,28920,27420,9420,9420,18000,1500,0,0,0,0,1500,1500,0,0,1000,1000,1000,0,1654,240,60,600,84,50
2020,651900301,31600,2430,2430,2430,0,29170,28000,10000,18000,0,1170,170,1000,0,0,0,0,0,1340,200,200,150,40,38
2020,651900331,50770,4360,4360,4360,0,46410,31210,12000,19210,0,15200,200,15000,0,0,0,0,0,1370,120,200,100,100,54
2020,651900341,59949,14199,14199,14199,0,45750,45000,25000,20000,0,750,750,0,0,5000,0,0,0,1220,244,120,130,106,129
2020,651900361,13600,13400,400,400,13000,200,0,0,0,0,200,200,0,0,15240,15240,10400,0,4130,480,200,550,240,26
2020,651900371,73550,38050,38050,38050,0,35500,16000,11000,5000,0,19500,19100,400,0,0,0,0,0,5898,360,150,360,480,279
2020,651900391,16780,9680,9680,9680,0,7100,7000,7000,0,0,100,100,0,0,7000,7000,3000,0,1219,336,60,96,120,31
2020,652000202,207898,62498,30498,28398,32000,145400,140000,0,140000,0,5400,4000,1400,0,65000,0,0,0,6644,360,24,460,240,178
2020,652000212,20620,16070,6570,6570,9500,4550,2500,0,0,2500,2050,2050,0,0,14967,14967,14932,0,3350,360,120,180,180,63
2020,652000232,105420,17700,17700,17700,0,87720,85000,80000,5000,0,2720,2720,0,0,0,0,0,0,5680,480,60,480,260,500
2020,652000242,42950,16950,16950,16950,0,26000,25000,25000,0,0,1000,1000,0,0,0,0,0,0,2308,360,1000,150,108,59
2020,652000252,6500,5000,4800,4800,200,1500,0,0,0,0,1500,1500,0,0,3000,3000,3000,0,2456,516,120,360,240,76
2020,652000272,69140,28540,3540,3540,25000,40600,40000,0,40000,0,600,600,0,0,32000,7000,7000,0,2380,300,100,300,120,40
2020,652000292,40330,2130,2130,2130,0,38200,37000,37000,0,0,1200,1200,0,0,0,0,0,0,3234,220,24,300,270,890
2020,652000302,50400,400,400,400,0,50000,38000,22000,16000,0,12000,2000,0,10000,27500,27500,27500,0,1160,380,200,60,60,26
2020,652000332,73310,7760,7760,7760,0,65550,63600,8000,55600,0,1950,1200,750,0,9600,9600,3100,500,4097,174,1800,600,84,31
2020,652000342,21960,2240,2240,2240,0,19720,18000,12000,0,6000,1720,1720,0,0,1500,1500,1500,0,3812,360,20,380,386,40
2020,652000352,13666,12566,566,566,12000,1100,0,0,0,0,1100,1100,0,0,8000,8000,8000,0,1846,204,24,144,120,256
2020,652000362,5810,310,310,310,0,5500,5500,4000,1500,0,0,0,0,0,0,0,0,0,508,100,20,10,53,6
2020,652000372,3195,2195,2195,2195,0,1000,900,900,0,0,100,0,100,0,0,0,0,0,1546,280,460,100,36,13
2020,652000382,15800,3300,3300,3300,0,12500,12000,6000,6000,0,500,200,300,0,0,0,0,0,1981,180,30,245,156,33
2020,652000392,17740,4840,4840,4840,0,12900,12000,12000,0,0,900,900,0,0,0,0,0,0,1122,180,100,150,72,61
2020,652600231,18850,18850,500,500,18350,0,0,0,0,0,0,0,0,0,0,0,0,0,1140,240,300,0,60,60
2020,652600251,18203,4903,4903,4903,0,13300,12000,12000,0,0,1300,1300,0,0,9414,9414,7560,0,4586,216,60,500,280,350
2020,652600281,32632,1432,1432,1432,0,31200,30000,0,30000,0,1200,1200,0,0,20000,0,0,0,5142,180,3600,360,80,136
2020,652600291,1093,1093,1093,1093,0,0,0,0,0,0,0,0,0,0,1520,1520,0,1000,978,100,120,110,48,11
2020,652600301,49203,19778,19778,19778,0,29425,17000,12000,0,5000,12425,9300,125,3000,0,0,0,0,1786,156,10,30,110,135
2020,652600311,4440,20,20,20,0,4420,4300,4300,0,0,120,0,120,0,0,0,0,0,836,120,240,20,36,3
2020,652600321,6800,6000,6000,6000,0,800,500,500,0,0,300,0,300,0,0,0,0,0,870,240,60,50,60,5
2020,652600331,84400,35350,35350,32350,0,49050,33000,23000,10000,0,16050,2050,14000,0,10000,10000,10000,0,3680,350,100,600,240,291
2020,652600341,10086,4586,4586,4586,0,5500,5500,5500,0,0,0,0,0,0,2188,2188,2188,0,1782,192,82,216,180,8
2020,652600361,1600,1600,1600,1600,0,0,0,0,0,0,0,0,0,0,0,0,0,0,355,100,60,20,35,2
2020,652600371,5200,600,600,600,0,4600,4600,4600,0,0,0,0,0,0,0,0,0,0,334,90,40,10,24,5
2020,652700201,39820,1020,1020,1020,0,38800,35000,27000,8000,0,3800,3300,500,0,3100,3100,3000,0,5573,320,30,360,240,228
2020,652700241,41316,2816,2816,2816,0,38500,38000,24000,14000,0,500,500,0,0,13690,13690,13690,0,2860,120,50,240,120,513
2020,652700251,205919,8919,8919,8919,0,197000,196000,36000,160000,0,1000,1000,0,0,63000,18000,18000,0,3212,300,12,360,200,319
2020,652700271,47635,5935,5935,5935,0,41700,40000,15000,25000,0,1700,1700,0,0,0,0,0,0,5080,360,120,1200,480,115
2020,652700281,10850,2450,2450,2450,0,8400,8400,7000,1400,0,0,0,0,0,0,0,0,0,1622,408,240,120,144,28
2020,652700291,15114,2434,2434,2434,0,12680,12000,12000,0,0,680,680,0,0,1200,1200,1200,0,4586,360,120,450,360,243
2020,652700301,4160,4110,4110,4110,0,50,0,0,0,0,50,50,0,0,0,0,0,0,1994,156,1090,84,84,5
2020,652700311,126852,4652,4652,4652,0,122200,84000,4000,80000,0,38200,3100,35100,0,28000,28000,25000,0,4750,360,100,600,300,89
2020,652700331,19597,16617,11867,11867,4750,2980,0,0,0,0,2980,2800,180,0,0,0,0,0,2382,432,50,360,134,101
2020,652700341,6950,450,450,450,0,6500,6500,6500,0,0,0,0,0,0,0,0,0,0,360,100,50,30,30,4
2020,652700351,550,550,550,550,0,0,0,0,0,0,0,0,0,0,0,0,0,0,357,120,50,26,36,1
2020,652700361,65190,1200,1200,1200,0,63990,51000,1000,50000,0,12990,690,12300,0,0,0,0,0,2478,1170,200,250,168,144
2020,652700371,3680,70,70,70,0,3610,3600,1000,2600,0,10,0,10,0,0,0,0,0,896,192,282,60,71,3
2020,652800201,35994,7094,7094,7094,0,28900,25700,20000,5700,0,3200,3200,0,0,19653,19653,8853,10800,3680,360,400,500,200,1089
2020,652800211,34504,10004,10004,10004,0,24500,22500,22500,0,0,2000,2000,0,0,3305,3305,3125,0,3195,300,320,230,95,86
2020,652800221,690,590,90,90,500,100,0,0,0,0,100,100,0,0,0,0,0,0,1524,624,24,60,110,13
2020,652800231,188222,5872,5872,5872,0,182350,182000,32000,150000,0,350,150,200,0,70000,0,0,0,2069,300,100,60,72,303
2020,652800261,74020,6120,6120,6120,0,67900,64000,64000,0,0,3900,3900,0,0,19200,19200,19200,0,7980,800,400,700,280,584
2020,652800281,331,331,331,331,0,0,0,0,0,0,0,0,0,0,0,0,0,0,1176,120,90,48,48,2
2020,652800291,76870,46620,46620,46620,0,30250,30000,25000,5000,0,250,250,0,0,0,0,0,0,1686,372,380,240,84,114
2020,652800301,64921,47108,27308,27308,19800,17813,16000,0,16000,0,1813,1550,263,0,21000,20000,20000,0,4727,192,60,600,240,294
2020,652800311,25400,8500,8500,8500,0,16900,14000,8000,6000,0,2900,2300,600,0,0,0,0,0,877,120,10,240,60,18
2020,652800321,18150,1050,1050,1050,0,17100,17100,6600,10500,0,0,0,0,0,0,0,0,0,2706,240,240,150,96,150
2020,652800331,2762,2712,2712,2712,0,50,0,0,0,0,50,50,0,0,3040,3040,1590,450,932,136,85,76,150,6
2020,652800351,26178,1868,1868,1868,0,24310,24300,1300,23000,0,10,0,10,0,0,0,0,0,840,84,460,24,42,20
2020,652800361,3470,1870,1870,1870,0,1600,1600,1600,0,0,0,0,0,0,0,0,0,0,990,180,72,48,84,14
2020,652900201,80410,20910,20910,20910,0,59500,58000,58000,0,0,1500,1500,0,0,19000,19000,19000,0,6100,360,500,400,240,574
2020,652900211,15936,15036,14976,14976,60,900,0,0,0,0,900,900,0,0,50,50,0,0,3640,360,100,600,120,360
2020,652900231,3100,2700,2200,2200,500,400,0,0,0,0,400,400,0,0,0,0,0,0,4032,600,200,600,250,682
2020,652900241,70169,16769,16769,16769,0,53400,52000,52000,0,0,1400,1400,0,0,0,0,0,0,4641,232,312,388,137,564
2020,652900251,13408,13408,408,408,13000,0,0,0,0,0,0,0,0,0,10000,10000,10000,0,2458,250,30,450,168,1
2020,652900271,25690,1390,1390,1390,0,24300,15000,15000,0,0,9300,9300,0,0,4750,4750,4000,0,3734,280,474,750,240,515
2020,652900291,83606,10106,10106,10106,0,73500,70000,70000,0,0,3500,3000,500,0,23000,23000,23000,0,5070,200,300,500,150,158
2020,652900321,6300,300,300,300,0,6000,6000,6000,0,0,0,0,0,0,0,0,0,0,460,140,50,30,20,4
2020,652900331,11940,3210,3210,3210,0,8730,6800,6800,0,0,1930,1500,430,0,5900,5900,2900,2000,2022,120,2,240,180,49
2020,652900341,80,80,80,80,0,0,0,0,0,0,0,0,0,0,0,0,0,0,664,144,40,12,54,1
2020,652900351,21958,4158,4158,4158,0,17800,15000,5000,10000,0,2800,2800,0,0,250,250,0,250,1760,70,120,350,120,89
2020,652900361,9870,1800,1800,1800,0,8070,8000,8000,0,0,70,0,70,0,0,0,0,0,475,120,130,30,20,6
2020,653000202,8410,7810,4810,4810,3000,600,0,0,0,0,600,600,0,0,3800,3800,0,3800,5442,1200,192,296,180,39
2020,653000222,45143,300,300,300,0,44843,44693,37693,7000,0,150,150,0,0,8575,8575,2500,0,3343,273,68,324,300,33
2020,653000232,223,223,223,223,0,0,0,0,0,0,0,0,0,0,0,0,0,0,1507,324,600,24,36,1
2020,660000202,3700,3700,1200,1200,2500,0,0,0,0,0,0,0,0,0,0,0,0,0,606,300,40,30,16,1
2020,660000212,20082,2682,2682,2682,0,17400,17000,17000,0,0,400,400,0,0,12525,12525,10135,0,4852,120,1500,300,480,306
2020,660000222,26578,8578,8578,8578,0,18000,16000,16000,0,0,2000,2000,0,0,0,0,0,0,3384,174,500,360,240,109
2020,660000232,82032,12532,12532,12532,0,69500,62000,42000,20000,0,7500,5500,2000,0,13000,0,0,0,2974,288,100,360,96,1212
2020,660000252,4351,1851,1351,1351,500,2500,0,0,0,0,2500,2500,0,0,300,300,0,300,3104,756,10,600,180,68
2020,660000262,59414,3314,3314,3314,0,56100,55000,55000,0,0,1100,1100,0,0,20496,20496,17496,3000,4824,300,217,300,220,1140
2020,660000272,66880,10450,10450,10450,0,56430,55000,55000,0,0,1430,1200,230,0,2130,2130,2000,100,2630,240,100,300,180,432
2020,660000292,18450,150,150,150,0,18300,17000,17000,0,0,1300,1300,0,0,9900,9900,9900,0,1950,240,150,240,240,33
2020,660000302,9900,700,700,700,0,9200,9000,9000,0,0,200,200,0,0,10,10,0,0,1336,252,120,36,72,34
2020,660000312,5350,350,350,350,0,5000,5000,5000,0,0,0,0,0,0,0,0,0,0,1404,360,144,120,0,7
2020,660000322,7110,110,110,110,0,7000,7000,7000,0,0,0,0,0,0,0,0,0,0,540,60,140,10,30,4
2020,660000332,930,430,330,330,100,500,0,0,0,0,500,500,0,0,1500,1500,0,1500,2490,436,1080,72,96,30
2020,660000342,14940,2940,2940,2940,0,12000,12000,12000,0,0,0,0,0,0,100,0,0,0,1453,140,24,60,108,33
2020,660000352,11226,8776,3776,2476,5000,2450,0,0,0,0,2450,1950,500,0,1100,1100,0,0,5282,1083,10,200,408,29
2020,660000372,32194,1794,1794,1794,0,30400,27000,27000,0,0,3400,3400,0,0,0,0,0,0,2102,354,100,240,168,80
2020,660000382,51746,24046,24046,24046,0,27700,26500,26500,0,0,1200,1200,0,0,0,0,0,0,2559,291,300,120,96,80
2020,660000392,48962,3852,3852,3852,0,45110,45000,30000,15000,0,110,0,110,0,0,0,0,0,1185,119,280,10,60,21
2020,660600201,6368,3368,2318,2318,1050,3000,3000,0,3000,0,0,0,0,0,2500,2500,0,1000,1468,408,50,180,120,69
2020,660600231,22030,30,30,30,0,22000,22000,22000,0,0,0,0,0,0,0,0,0,0,765,250,100,50,20,46
2020,660600241,400,400,20,20,380,0,0,0,0,0,0,0,0,0,500,500,0,500,1828,180,600,240,228,1
2020,660600271,38442,6542,6542,6542,0,31900,30000,30000,0,0,1900,1900,0,0,888,888,888,0,3880,300,500,300,180,811
2020,660600281,18285,17665,1665,1665,16000,620,0,0,0,0,620,450,170,0,0,0,0,0,1540,240,20,240,240,50
2020,660600291,38011,10511,10511,10511,0,27500,27500,20000,7500,0,0,0,0,0,0,0,0,0,1273,120,370,60,36,114
2020,660600331,8045,7945,7945,7945,0,100,0,0,0,0,100,0,100,0,0,0,0,0,1124,312,60,36,120,56
2020,660600341,42801,10521,10521,10521,0,32280,30000,30000,0,0,2280,1480,800,0,9400,9400,9400,0,4012,180,604,240,180,292
2020,660600351,9015,1515,1515,1515,0,7500,7500,7500,0,0,0,0,0,0,0,0,0,0,502,72,120,40,18,7
2020,660600361,12510,510,510,510,0,12000,12000,12000,0,0,0,0,0,0,0,0,0,0,702,108,150,36,36,8
2020,660600371,53620,920,920,920,0,52700,42300,42000,300,0,10400,2600,2500,5300,15772,13572,8440,3800,2070,210,200,120,108,102
2020,660600381,971,971,971,971,0,0,0,0,0,0,0,0,0,0,3584,3584,0,0,690,186,0,24,24,1
2020,660600391,18200,7200,7200,7200,0,11000,11000,11000,0,0,0,0,0,0,0,0,0,0,1320,204,300,36,36,19
2020,660700201,154570,4470,4470,3470,0,150100,137000,80000,57000,0,13100,3600,9500,0,40384,38384,28000,7300,7390,1600,150,600,340,333
2020,660700211,16720,2390,2390,2390,0,14330,14000,14000,0,0,330,150,180,0,11760,11760,11740,0,2229,185,50,180,270,42
2020,660700221,17556,1556,1556,1556,0,16000,16000,16000,0,0,0,0,0,0,0,0,0,0,1940,170,120,50,120,7
2020,660700241,10639,9789,5289,5289,4500,850,0,0,0,0,850,850,0,0,0,0,0,0,1974,120,10,700,135,61
2020,660700261,250,250,150,150,100,0,0,0,0,0,0,0,0,0,0,0,0,0,1013,400,10,50,48,9
2020,660700281,26630,4600,4600,4600,0,22030,22000,22000,0,0,30,0,30,0,0,0,0,0,1308,240,300,24,24,25
2020,660700291,30376,4476,4476,4476,0,25900,22000,22000,0,0,3900,3800,100,0,7000,7000,7000,0,3066,216,30,150,240,265
2020,660700301,97350,26150,26150,26150,0,71200,60000,60000,0,0,11200,3200,8000,0,16800,15000,0,15000,2575,420,1000,445,180,571
2020,660700321,4463,4013,1705,1705,2308,450,0,0,0,0,450,450,0,0,0,0,0,0,1308,312,12,120,120,26
2020,660700331,34400,6900,6900,6900,0,27500,18000,18000,0,0,9500,1500,0,8000,0,0,0,0,2200,240,200,200,60,64
2020,660700341,8612,3512,3512,3512,0,5100,3500,3000,500,0,1600,1600,0,0,0,0,0,0,3152,212,220,480,180,31
2020,660700351,9311,1511,1511,1511,0,7800,7800,7800,0,0,0,0,0,0,1120,1120,1120,0,936,90,230,84,60,9
2020,660700371,26580,1780,1780,1780,0,24800,21000,15000,6000,0,3800,3500,300,0,9100,8900,8900,0,2407,340,5,120,110,82
2020,660700381,49532,10152,10152,10152,0,39380,38000,38000,0,0,1380,1380,0,0,0,0,0,0,3404,336,68,410,360,173
2020,660700391,14612,5612,5612,5612,0,9000,9000,9000,0,0,0,0,0,0,0,0,0,0,937,162,0,1,54,18
2020,660800201,33100,800,800,800,0,32300,32000,13000,19000,0,300,0,300,0,1200,0,0,0,1100,180,120,72,48,98
2020,660800211,38640,3640,3640,3640,0,35000,35000,35000,0,0,0,0,0,0,1000,0,0,0,850,100,20,50,60,32
2020,660800221,12048,10048,2048,2048,8000,2000,0,0,0,0,2000,2000,0,0,0,0,0,0,1720,130,40,200,100,33
2020,660800231,216510,142160,142160,142160,0,74350,65000,65000,0,0,9350,4350,5000,0,0,0,0,0,9464,324,100,600,360,3888
2020,660800241,9176,6176,4176,4176,2000,3000,0,0,0,0,3000,3000,0,0,5390,5390,0,5280,3479,720,120,245,240,496
2020,660800251,99682,9732,9732,9732,0,89950,88000,53000,35000,0,1950,1500,450,0,0,0,0,0,1830,360,100,420,100,197
2020,660800261,20070,70,70,70,0,20000,20000,20000,0,0,0,0,0,0,1500,0,0,0,660,100,120,100,40,20
2020,660800301,16300,5600,5600,5600,0,10700,8000,8000,0,0,2700,2700,0,0,2980,2980,800,180,2174,344,180,448,102,52
2020,660800311,13292,2792,2792,2792,0,10500,10000,10000,0,0,500,500,0,0,0,0,0,0,2054,180,24,240,120,38
2020,660800321,21290,2390,2390,2390,0,18900,18000,18000,0,0,900,750,150,0,3688,3688,3688,0,1823,156,10,240,120,120
2020,660800341,36790,8030,8030,8030,0,28760,27000,27000,0,0,1760,1760,0,0,9020,9020,9000,0,2371,258,200,216,192,118
2020,660800351,3250,250,250,250,0,3000,3000,3000,0,0,0,0,0,0,0,0,0,0,440,150,20,5,5,2
2020,660800361,63942,28842,28842,28842,0,35100,32000,12000,19000,1000,3100,3100,0,0,0,0,0,0,6474,318,2310,480,276,103
2020,660800371,2620,820,820,820,0,1800,0,0,0,0,1800,1800,0,0,0,0,0,0,954,60,100,150,84,23
2020,660800381,19327,327,327,327,0,19000,19000,11000,8000,0,0,0,0,0,0,0,0,0,576,180,240,10,24,29
2020,660800391,31330,5230,5230,5230,0,26100,25500,25000,500,0,600,500,100,0,0,0,0,0,1998,300,250,280,48,92
2020,660900201,60380,3880,3880,2880,0,56500,50000,0,50000,0,6500,3000,3500,0,32240,8240,0,0,2986,325,55,540,216,67
2020,660900231,25640,7690,7690,7690,0,17950,17000,17000,0,0,950,950,0,0,2760,2760,2760,0,2540,360,20,200,480,22
2020,660900241,34506,6006,6006,6006,0,28500,28000,18000,10000,0,500,300,200,0,0,0,0,0,1550,240,150,240,100,53
2020,660900251,20040,40,40,40,0,20000,20000,20000,0,0,0,0,0,0,0,0,0,0,802,180,60,36,36,21
2020,660900261,165,165,15,15,150,0,0,0,0,0,0,0,0,0,0,0,0,0,669,160,224,60,15,1
2020,660900301,20,20,20,20,0,0,0,0,0,0,0,0,0,0,0,0,0,0,660,300,0,0,0,0
2020,660900311,82000,0,0,0,0,82000,82000,12000,70000,0,0,0,0,0,7300,7300,7000,0,1854,240,100,60,144,119
2020,660900321,117648,18848,18848,18848,0,98800,97000,48000,49000,0,1800,1800,0,0,40000,0,0,0,5520,600,400,600,140,605
2020,660900331,17364,964,964,964,0,16400,16000,16000,0,0,400,400,0,0,3010,3010,0,3000,1598,244,360,240,60,52
2020,660900341,51500,22500,22500,22500,0,29000,29000,25000,4000,0,0,0,0,0,0,0,0,0,938,164,450,50,24,18
2020,660900361,38200,200,200,200,0,38000,38000,12000,26000,0,0,0,0,0,0,0,0,0,708,120,60,24,24,3
2020,660900371,59640,23490,23490,16990,0,36150,34000,30000,0,4000,2150,2150,0,0,12150,12150,4000,0,5705,1060,120,300,360,1214
2020,660900381,24688,7008,7008,7008,0,17680,14000,14000,0,0,3680,3680,0,0,457,457,0,0,2887,240,40,620,276,495
2020,660900391,9593,2943,2943,2643,0,6650,6600,6600,0,0,50,0,50,0,2300,2300,1800,0,679,122,330,10,72,11
2020,661000202,67704,16504,16504,16504,0,51200,50000,30000,20000,0,1200,1000,200,0,0,0,0,0,4226,300,100,540,156,470
2020,661000212,31045,2765,2765,2765,0,28280,28000,28000,0,0,280,200,80,0,12000,12000,12000,0,1884,240,50,200,120,227
2020,661000232,655,655,355,5,300,0,0,0,0,0,0,0,0,0,350,350,0,0,967,380,7,60,200,2
2020,661000262,4280,1280,1080,1080,200,3000,0,0,0,0,3000,3000,0,0,1650,1650,0,0,1718,420,10,360,108,83
2020,661000282,14220,4920,4920,4920,0,9300,9000,9000,0,0,300,300,0,0,0,0,0,0,1380,240,120,240,120,36
2020,661000302,72152,12400,12400,12400,0,59752,55000,30000,25000,0,4752,4300,452,0,5400,5400,5400,0,7696,150,50,600,281,2345
2020,661000312,31994,13944,13944,13944,0,18050,17200,7000,7200,3000,850,750,100,0,200,200,0,0,2376,276,60,420,300,297
2020,661000322,58984,9532,9532,9532,0,49452,45000,45000,0,0,4452,4000,452,0,0,0,0,0,6562,1160,240,120,672,141
2020,661000332,123643,19991,8991,8991,11000,103652,100000,0,100000,0,3652,3200,452,0,35000,5000,0,0,7016,288,564,432,348,3118
2020,661000342,27770,22970,8020,8020,14950,4800,3000,0,3000,0,1800,1800,0,0,0,0,0,0,2876,322,10,180,120,48
2020,661000352,29255,28305,13355,13355,14950,950,0,0,0,0,950,950,0,0,0,0,0,0,2660,156,36,480,168,733
2020,661000362,8776,276,276,276,0,8500,8500,6000,2500,0,0,0,0,0,0,0,0,0,998,150,10,60,137,6
2020,661000382,45352,9672,9672,9672,0,35680,35680,6680,29000,0,0,0,0,0,0,0,0,0,1232,66,30,20,36,6
2020,661000392,10876,476,476,476,0,10400,6000,6000,0,0,4400,2200,2200,0,2800,2800,0,600,2454,148,30,960,216,2
2020,661600211,35558,15058,15058,15058,0,20500,17000,17000,0,0,3500,3500,0,0,0,0,0,0,3660,260,60,200,300,944
2020,661600221,13312,4962,4962,4962,0,8350,8000,8000,0,0,350,250,100,0,0,0,0,0,2440,250,100,200,90,51
2020,661600231,130892,15592,15592,12592,0,115300,115000,40000,75000,0,300,300,0,0,45000,0,0,0,6110,600,30,720,300,2093
2020,661600311,2950,2200,200,200,2000,750,0,0,0,0,750,750,0,0,26750,26750,0,2600,4290,1006,33,275,242,56
2020,661600341,43074,25374,25374,25374,0,17700,16500,16500,0,0,1200,900,300,0,0,0,0,0,3346,264,70,480,234,419
2020,661600351,40625,11742,11742,11742,0,28883,21800,21800,0,0,7083,7000,83,0,260,260,0,0,2653,261,20,300,162,173
2020,661600361,38168,10078,10078,10078,0,28090,21000,3500,17500,0,7090,912,5678,500,3000,3000,3000,0,2722,244,336,420,192,587
2020,661600371,400,400,400,400,0,0,0,0,0,0,0,0,0,0,0,0,0,0,689,141,323,15,20,1
2020,661600381,18156,2056,2056,2056,0,16100,16000,8500,7500,0,100,100,0,0,0,0,0,0,1118,84,10,150,84,81
2020,661700201,20100,20100,4100,4100,16000,0,0,0,0,0,0,0,0,0,700,700,0,700,2380,350,45,250,190,335
2020,661700251,43286,23336,23336,23336,0,19950,19000,19000,0,0,950,950,0,0,0,0,0,0,2890,320,240,600,360,141
2020,661700261,1030,730,730,730,0,300,0,0,0,0,300,300,0,0,1580,1580,0,1380,1936,150,76,195,204,85
2020,661700301,26376,13876,13876,13876,0,12500,0,0,0,0,12500,12500,0,0,4000,4000,0,0,3959,264,50,150,360,31
2020,661700311,257710,38860,38860,38860,0,218850,161000,31000,130000,0,57850,1650,51200,5000,37500,36000,24000,7000,5110,410,300,450,240,1723
2020,661700321,21658,3258,3258,3258,0,18400,17000,17000,0,0,1400,1300,100,0,13724,13724,10384,0,2720,300,60,360,300,144
2020,661700331,5332,5332,932,932,4400,0,0,0,0,0,0,0,0,0,3300,3300,1100,0,2657,144,1200,132,66,16
2020,661700371,5158,1090,1090,1090,0,4068,4000,4000,0,0,68,0,68,0,0,0,0,0,508,92,120,12,24,2
2020,661700381,5467,380,380,380,0,5087,4397,600,3797,0,690,0,690,0,0,0,0,0,990,180,50,30,50,40
2020,661700391,32266,266,266,266,0,32000,32000,14000,18000,0,0,0,0,0,0,0,0,0,1254,655,125,101,36,95
2020,661800201,9020,9020,2020,2020,7000,0,0,0,0,0,0,0,0,0,4600,4600,0,4600,1075,70,5,50,100,277
2020,661800221,13746,1746,1746,1746,0,12000,11000,11000,0,0,1000,950,50,0,5680,5680,5660,0,3048,270,180,325,190,57
2020,661800231,2700,2700,2700,2700,0,0,0,0,0,0,0,0,0,0,0,0,0,0,1470,360,20,36,84,1
2020,661800241,2066,1446,446,446,1000,620,0,0,0,0,620,620,0,0,2000,2000,0,0,1484,444,240,240,180,797
2020,661800251,50005,21005,21005,21005,0,29000,25000,25000,0,0,4000,2900,1000,100,0,0,0,0,2128,120,150,180,180,110
2020,661800281,19650,450,450,450,0,19200,19000,14000,5000,0,200,200,0,0,2500,2500,2500,0,3106,300,100,60,216,34
2020,661800301,26770,13644,7644,7644,6000,13126,12500,0,12500,0,626,400,226,0,1800,1800,1800,0,5290,240,36,144,480,133
2020,661800321,6114,5628,5628,5628,0,486,0,0,0,0,486,350,136,0,20,20,0,0,1601,132,25,276,216,25
2020,661800331,2280,1880,380,380,1500,400,0,0,0,0,400,400,0,0,80,80,0,0,1334,160,50,360,300,33
2020,661800351,18097,3487,3487,3487,0,14610,14500,4500,10000,0,110,0,110,0,300,300,300,0,936,120,120,240,60,6
2020,661800361,59341,20960,20960,20960,0,38381,35500,25000,10500,0,2881,2202,679,0,4600,4600,4300,300,3479,335,112,492,301,965
2020,661800391,16586,7586,7586,7586,0,9000,9000,9000,0,0,0,0,0,0,0,0,0,0,740,264,96,12,32,3
2020,661900211,86350,41350,41350,41350,0,45000,45000,0,45000,0,0,0,0,0,0,0,0,0,1880,240,120,45,45,78
2020,661900221,167662,6510,6510,6510,0,161152,160000,80000,80000,0,1152,472,680,0,60000,39000,30000,5000,3148,372,760,240,156,237
2020,661900241,23150,2250,2250,2250,0,20900,20900,16900,4000,0,0,0,0,0,0,0,0,0,890,240,30,120,84,26
2020,661900251,7700,1200,1200,1200,0,6500,6500,6500,0,0,0,0,0,0,5570,5570,5570,0,2100,360,10,180,360,17
2020,661900281,57676,9376,9376,9376,0,48300,46500,32000,14500,0,1800,1800,0,0,20600,20600,17000,3400,5060,400,500,360,300,671
2020,661900321,36944,4454,4454,4454,0,32490,31500,8500,23000,0,990,0,990,0,230,230,0,0,2920,256,1400,120,57,97
2020,661900341,34212,14012,14012,14012,0,20200,18000,18000,0,0,2200,1900,300,0,0,0,0,0,2758,346,120,120,240,38
2020,661900351,3500,200,200,200,0,3300,3300,3300,0,0,0,0,0,0,0,0,0,0,529,70,60,33,64,2
2020,661900361,43730,36300,36300,36300,0,7430,7000,7000,0,0,430,0,430,0,0,0,0,0,1259,133,120,50,66,77
2020,661900381,15286,5886,5886,5886,0,9400,9400,1000,8400,0,0,0,0,0,0,0,0,0,463,110,96,36,29,4
2020,661900391,9250,250,250,250,0,9000,9000,5000,4000,0,0,0,0,0,0,0,0,0,690,60,200,15,20,2
2020,662000312,450,450,450,450,0,0,0,0,0,0,0,0,0,0,0,0,0,0,555,292,0,10,48,1
2020,662000322,20260,5860,5860,5860,0,14400,13200,6000,7200,0,1200,1200,0,0,2000,2000,2000,0,2309,289,270,500,370,573
2020,662000332,33108,6078,6078,6078,0,27030,26000,6000,20000,0,1030,800,230,0,2250,2250,2250,0,1853,196,430,290,60,126
2020,662000352,66420,33920,33920,33920,0,32500,29000,4000,25000,0,3500,3500,0,0,0,0,0,0,3126,486,0,600,144,1961
2020,662000362,9144,8224,8224,8224,0,920,800,800,0,0,120,0,120,0,0,0,0,0,1904,990,360,240,24,7
2020,662000372,12826,5900,5900,5900,0,6926,5000,5000,0,0,1926,1700,226,0,0,0,0,0,1009,98,96,240,42,77
2020,662600301,32361,3942,3942,3942,0,28419,26500,15000,11500,0,1919,1870,49,0,0,0,0,0,3244,156,125,564,180,203
2020,662600331,18944,12444,1544,1544,10900,6500,6000,0,6000,0,500,500,0,0,9950,9450,5450,4000,3300,400,200,300,200,133
2020,662600341,3240,520,520,520,0,2720,2720,1000,1720,0,0,0,0,0,0,0,0,0,468,65,100,25,23,3
2020,662600361,21404,2954,2954,2954,0,18450,17000,17000,0,0,1450,1450,0,0,8200,8200,8200,0,3240,450,50,300,240,81
2020,662700301,27728,6120,6120,6120,0,21608,21250,5000,16250,0,358,150,208,0,0,0,0,0,1295,120,400,150,80,41
2020,662700311,810,10,10,10,0,800,800,800,0,0,0,0,0,0,0,0,0,0,466,90,20,30,36,1
2020,662700321,21976,14706,14706,14706,0,7270,6800,2000,4800,0,470,350,120,0,0,0,0,0,1636,161,249,200,75,14
2020,662700351,13999,1529,1529,1529,0,12470,12000,12000,0,0,470,470,0,0,210,210,0,210,2960,360,180,480,360,45
2020,662700361,98429,17989,17989,17989,0,80440,59600,3600,56000,0,20840,500,20340,0,0,0,0,0,1650,300,60,180,60,23
2020,662800311,5917,2764,2764,2764,0,3153,2490,1290,1200,0,663,550,113,0,1100,1100,800,300,1489,144,98,180,209,35
2020,662800331,1860,1160,1160,1160,0,700,700,700,0,0,0,0,0,0,0,0,0,0,777,230,134,15,48,1
2020,662800341,48632,39632,33632,32882,6000,9000,0,0,0,0,9000,1500,7500,0,0,0,0,0,2774,616,40,240,312,47
2020,662800351,1481,48,48,48,0,1433,1400,1400,0,0,33,0,33,0,0,0,0,0,590,116,60,60,24,3
2020,662900301,1456,256,256,256,0,1200,1200,1200,0,0,0,0,0,0,0,0,0,0,391,120,30,20,36,2
2020,662900311,35600,8400,8400,8400,0,27200,26500,3500,23000,0,700,500,200,0,0,0,0,0,2994,112,1700,340,72,53
2020,662900321,18152,262,262,262,0,17890,17700,17700,0,0,190,0,190,0,0,0,0,0,1173,193,121,45,30,17
2020,662900331,34811,15298,15298,7298,0,19513,17800,17800,0,0,1713,1600,113,0,8120,8120,8000,0,2763,198,51,431,413,68
2020,662900341,28551,6001,6001,6001,0,22550,10000,4000,6000,0,12550,2700,9850,0,0,0,0,0,1650,144,360,400,96,21
2020,662900351,46226,10500,10500,10500,0,35726,32420,1220,31200,0,3306,3080,226,0,1536,1536,0,500,1268,302,180,240,96,85
2020,670000322,26820,8620,8620,8620,0,18200,12000,12000,0,0,6200,6200,0,0,0,0,0,0,4360,150,300,1440,300,727
2020,670000332,61528,5028,5028,5028,0,56500,53000,13000,40000,0,3500,0,3500,0,2500,2500,2500,0,953,147,60,12,48,14
2020,670000342,29500,2350,2350,2350,0,27150,26000,26000,0,0,1150,850,300,0,17000,17000,16000,1000,6260,600,100,500,360,552
2020,670000352,18290,2810,2810,2810,0,15480,15000,15000,0,0,480,400,80,0,600,600,0,600,1568,240,145,400,33,67
2020,670000362,37803,9803,9803,9803,0,28000,28000,15000,13000,0,0,0,0,0,200,200,200,0,3051,440,200,200,341,38
2020,670000372,550,550,50,50,500,0,0,0,0,0,0,0,0,0,0,0,0,0,1820,540,0,50,120,8
2020,670000382,23800,8300,8300,8300,0,15500,15000,15000,0,0,500,500,0,0,0,0,0,0,8830,400,500,480,350,1033
2020,670000392,32100,1000,1000,1000,0,31100,31000,6000,25000,0,100,100,0,0,0,0,0,0,702,142,100,120,60,26
2020,670600321,2232,1382,1382,1382,0,850,0,0,0,0,850,700,150,0,4160,4160,4160,0,2880,240,40,400,120,51
2020,670600331,11772,3672,3672,3672,0,8100,8000,8000,0,0,100,0,100,0,1000,1000,0,700,1074,166,36,24,84,12
2020,670600351,123721,5571,5571,5571,0,118150,95000,25000,70000,0,23150,5650,17500,0,24048,24048,7048,17000,4780,280,170,420,282,150
2020,670600361,58985,4985,4985,4985,0,54000,42000,2000,40000,0,12000,500,11500,0,2628,2628,2628,0,1374,230,80,120,140,49
2020,670600371,2100,100,100,100,0,2000,2000,2000,0,0,0,0,0,0,0,0,0,0,562,138,120,24,35,13
2020,670600381,150,150,150,150,0,0,0,0,0,0,0,0,0,0,0,0,0,0,317,120,36,6,5,1
2020,670600391,8100,4100,4100,4100,0,4000,4000,4000,0,0,0,0,0,0,0,0,0,0,555,100,30,10,15,10
2020,670700301,9902,3402,3402,3402,0,6500,6300,6300,0,0,200,130,70,0,1900,1900,1900,0,927,311,144,162,60,9
2020,670700311,8067,2676,2676,2676,0,5391,5000,5000,0,0,391,230,161,0,0,0,0,0,1673,140,50,450,133,101
2020,670700321,2948,1148,948,948,200,1800,0,0,0,0,1800,1800,0,0,2000,2000,0,0,1332,132,120,390,80,67
2020,670700331,24053,2027,2027,2027,0,22026,21000,12000,9000,0,1026,800,226,0,12570,12570,10400,0,3142,322,240,250,180,381
2020,670700351,47318,16618,16618,16618,0,30700,27000,19000,8000,0,3700,3700,0,0,1280,1280,1280,0,5250,360,60,480,240,769
2020,670700361,6750,1800,1800,1800,0,4950,4000,4000,0,0,950,450,0,500,0,0,0,0,1588,180,120,240,48,55
2020,670700371,33700,7400,7400,5600,0,26300,17000,12000,5000,0,9300,3300,4200,1800,9800,9800,9700,0,2390,240,100,450,200,80
2020,670700381,7727,5879,5879,5879,0,1848,1500,1500,0,0,348,80,268,0,0,0,0,0,1270,240,10,60,74,18
2020,670700391,48,48,48,48,0,0,0,0,0,0,0,0,0,0,2160,2160,0,460,960,150,30,20,20,1
2020,670800301,36808,9680,9680,8680,0,27128,22000,22000,0,0,5128,4450,678,0,13750,13750,9750,4000,5680,440,100,600,240,281
2020,670800311,36525,7125,7125,7125,0,29400,22000,22000,0,0,7400,7000,400,0,0,0,0,0,2617,252,55,300,150,119
2020,670800321,489,489,459,459,30,0,0,0,0,0,0,0,0,0,0,0,0,0,883,410,60,12,96,1
2020,670800331,33120,2720,2720,2720,0,30400,30000,12000,18000,0,400,400,0,0,0,0,0,0,854,85,120,120,84,58
2020,670800341,81661,32061,32061,32061,0,49600,36000,26000,10000,0,13600,3600,10000,0,0,0,0,0,5850,500,500,500,250,370
2020,670800351,50940,1340,1340,1340,0,49600,45000,30000,15000,0,4600,1600,3000,0,26300,26300,21000,2000,2425,162,20,120,252,26
2020,670800361,14840,9020,6020,5020,3000,5820,4000,0,4000,0,1820,320,1500,0,1300,1300,0,1300,4112,300,500,1080,252,54
2020,670800371,6270,1760,1760,1760,0,4510,4500,4500,0,0,10,0,10,0,1164,1164,1164,0,990,184,0,72,48,10
2020,670900301,10049,49,49,49,0,10000,10000,10000,0,0,0,0,0,0,6700,3700,3520,180,910,120,230,30,60,16
2020,670900311,14980,3880,3880,3880,0,11100,9000,4500,4500,0,2100,1500,600,0,0,0,0,0,2740,350,120,400,120,41
2020,670900321,450,450,150,150,300,0,0,0,0,0,0,0,0,0,0,0,0,0,518,40,10,36,15,1
2020,670900331,21500,5500,5500,5500,0,16000,16000,9000,7000,0,0,0,0,0,0,0,0,0,740,161,150,60,60,13
2020,670900341,1930,1530,30,30,1500,400,0,0,0,0,400,400,0,0,450,450,450,0,950,240,30,200,60,7
2020,670900351,23161,8761,8761,4761,0,14400,14000,14000,0,0,400,400,0,0,11926,11926,11000,0,4264,288,70,420,204,174
2020,670900361,10619,9379,7379,7379,2000,1240,1200,0,0,1200,40,40,0,0,0,0,0,0,1174,76,10,120,84,31
2020,670900371,2530,2530,2530,2530,0,0,0,0,0,0,0,0,0,0,0,0,0,0,353,50,20,5,22,1
2020,671000312,10250,750,750,750,0,9500,5000,5000,0,0,4500,4500,0,0,2000,2000,2000,0,1930,160,100,280,240,205
2020,671000322,23560,8310,8310,6310,0,15250,4800,4800,0,0,10450,450,10000,0,1240,1240,1000,0,2300,120,120,600,230,140
2020,671000332,54499,25299,25299,20299,0,29200,28000,5000,23000,0,1200,900,300,0,5000,5000,5000,0,2358,154,1000,240,184,63
2020,671000352,43700,2200,2200,2200,0,41500,41500,6500,35000,0,0,0,0,0,2000,0,0,0,1462,250,240,30,12,97
2020,671000362,21720,4920,4920,4920,0,16800,15000,15000,0,0,1800,1800,0,0,0,0,0,0,3510,240,150,500,240,163
2020,671000372,19068,1568,1568,1568,0,17500,14500,14500,0,0,3000,3000,0,0,4900,4900,4900,0,5270,400,150,300,220,666
2020,671000382,345,345,45,45,300,0,0,0,0,0,0,0,0,0,0,0,0,0,866,474,4,220,78,1
2020,671000392,6530,30,30,30,0,6500,6500,5000,1500,0,0,0,0,0,0,0,0,0,262,102,20,10,20,2
2020,671600301,47325,10005,10005,10005,0,37320,33000,8500,24500,0,4320,1350,2970,0,3500,3500,0,3500,1486,360,24,300,72,59
2020,671600311,22200,9200,9200,9200,0,13000,13000,13000,0,0,0,0,0,0,0,0,0,0,495,50,60,20,15,21
2020,671600321,11700,1700,1700,1700,0,10000,10000,10000,0,0,0,0,0,0,0,0,0,0,920,170,140,10,25,30
2020,671600331,74580,16580,16580,16580,0,58000,55000,55000,0,0,3000,3000,0,0,28000,26500,26500,0,4300,300,180,240,420,201
2020,671600351,22222,11822,11822,11822,0,10400,10000,10000,0,0,400,400,0,0,0,0,0,0,2095,184,0,360,144,547
2020,671700311,29474,12574,12574,12574,0,16900,15000,15000,0,0,1900,1200,700,0,4250,4250,2500,1750,6350,450,500,500,250,353
2020,671700331,8590,1920,1920,1920,0,6670,6000,6000,0,0,670,670,0,0,0,0,0,0,930,108,40,110,72,13
2020,671700371,6875,2195,2195,2195,0,4680,4300,4300,0,0,380,380,0,0,0,0,0,0,2520,760,280,88,38,36
2020,671700381,13200,1200,1200,1200,0,12000,12000,3000,9000,0,0,0,0,0,0,0,0,0,905,50,120,15,30,6
2020,671700391,3022,22,22,22,0,3000,3000,3000,0,0,0,0,0,0,0,0,0,0,877,72,300,50,15,3
2020,671800311,16032,1502,1502,1502,0,14530,14000,4000,10000,0,530,530,0,0,0,0,0,0,1939,125,260,420,38,65
2020,671800321,305,305,305,305,0,0,0,0,0,0,0,0,0,0,0,0,0,0,1182,162,75,92,63,111
2020,671800331,59548,7298,7298,7298,0,52250,49000,23000,26000,0,3250,2250,1000,0,8835,8835,8835,0,2600,300,60,300,240,107
2020,671800361,1840,1840,1840,1840,0,0,0,0,0,0,0,0,0,0,0,0,0,0,451,84,60,12,30,1
2020,671800371,12030,30,30,30,0,12000,12000,12000,0,0,0,0,0,0,0,0,0,0,370,120,80,20,30,9
2020,671800381,94480,530,530,530,0,93950,93000,23000,70000,0,950,950,0,0,5088,5088,5000,0,4850,300,100,450,280,366
2020,671900301,34990,3290,3290,3290,0,31700,28000,28000,0,0,3700,3700,0,0,11300,11300,11300,0,6570,1000,10,800,180,230
2020,671900351,6428,2300,2300,2300,0,4128,4000,4000,0,0,128,0,128,0,0,0,0,0,498,76,24,12,6,12
2020,671900361,101310,500,500,500,0,100810,99000,10000,89000,0,1810,250,1560,0,21000,19000,15000,4000,1860,880,10,50,70,144
2020,671900371,30550,500,500,500,0,30050,30000,6000,24000,0,50,0,50,0,0,0,0,0,1990,100,900,300,40,35
2020,671900381,7520,520,520,520,0,7000,7000,7000,0,0,0,0,0,0,0,0,0,0,999,290,120,8,6,5
2020,671900391,7442,2292,2292,2292,0,5150,5000,5000,0,0,150,150,0,0,1000,1000,1000,0,4112,600,25,580,300,326
2020,672000312,60014,4056,4056,4056,0,55958,53000,28000,25000,0,2958,2800,158,0,530,530,0,530,5816,314,1400,624,282,480
2020,672000322,80881,22310,5310,310,17000,58571,33000,0,33000,0,25571,300,20271,5000,23482,23482,21832,1000,4552,302,70,384,396,71
2020,672000332,14000,4300,4300,2300,0,9700,0,0,0,0,9700,4200,2000,3500,5750,5750,0,1000,4592,192,10,1200,240,4
2020,672000342,3350,350,350,350,0,3000,3000,3000,0,0,0,0,0,0,0,0,0,0,520,100,100,30,20,1
2020,672000352,7840,1320,1320,1320,0,6520,6420,6420,0,0,100,100,0,0,850,850,0,250,1297,180,130,180,120,15
2020,672000362,35304,5774,5774,5774,0,29530,18630,3630,15000,0,10900,1450,9450,0,6700,6700,0,6700,3972,616,100,400,276,107
2020,672000372,55420,4520,4520,4520,0,50900,50000,20000,30000,0,900,900,0,0,32480,32480,25280,7200,3338,300,30,500,288,92
2020,672000382,1180,1180,1180,1180,0,0,0,0,0,0,0,0,0,0,0,0,0,0,1178,180,100,20,168,1
2020,672600311,10810,10,10,10,0,10800,10800,9000,1800,0,0,0,0,0,0,0,0,0,404,150,60,0,24,16
2020,672600321,36826,726,726,726,0,36100,36000,36000,0,0,100,100,0,0,4500,4500,4500,0,1682,264,36,120,240,43
2020,672600331,19151,19116,14616,14616,4500,35,0,0,0,0,35,35,0,0,0,0,0,0,2016,216,180,240,120,84
2020,672600341,4500,1500,1500,1500,0,3000,3000,3000,0,0,0,0,0,0,0,0,0,0,850,200,150,60,20,3
2020,672600351,10300,200,200,200,0,10100,10000,10000,0,0,100,0,100,0,0,0,0,0,564,96,72,12,24,8
2020,672600361,18200,200,200,200,0,18000,18000,18000,0,0,0,0,0,0,0,0,0,0,930,180,180,36,24,15
2020,672600371,3034,34,34,34,0,3000,3000,3000,0,0,0,0,0,0,0,0,0,0,777,100,200,20,52,5
2020,672700301,210,210,10,10,200,0,0,0,0,0,0,0,0,0,0,0,0,0,517,102,0,10,20,0
2020,672700321,70894,6468,6468,6468,0,64426,64000,9000,55000,0,426,200,226,0,12000,11000,11000,0,884,140,36,96,72,87
2020,672700331,36200,100,100,100,0,36100,36000,8000,28000,0,100,0,100,0,1400,1400,400,1000,850,100,50,50,50,35
2020,672700341,21200,1000,1000,1000,0,20200,20000,20000,0,0,200,0,200,0,500,0,0,0,900,100,60,20,80,10
2020,672700351,16700,200,200,200,0,16500,15000,15000,0,0,1500,1500,0,0,5000,5000,5000,0,2235,247,180,420,150,34
2020,672700361,7210,6710,2710,2710,4000,500,0,0,0,0,500,0,500,0,1070,1070,0,1000,369,130,30,5,24,1
2020,672700371,1000,400,100,100,300,600,0,0,0,0,600,600,0,0,0,0,0,0,1128,468,50,120,84,41
2020,672800311,16360,1360,1360,1360,0,15000,15000,0,15000,0,0,0,0,0,0,0,0,0,1002,296,80,30,25,19
2020,672800321,72144,41349,41349,41349,0,30795,28500,13000,15500,0,2295,2100,195,0,2347,2347,1948,399,2550,70,120,400,180,54
2020,672800331,40730,730,730,730,0,40000,40000,6000,34000,0,0,0,0,0,6594,4594,500,4084,2023,97,150,120,84,58
2020,672800341,36892,4272,4272,4272,0,32620,26500,5500,21000,0,6120,320,5800,0,20000,20000,13000,7000,1840,180,300,360,120,62
2020,672800361,12740,6940,6940,6940,0,5800,4000,0,4000,0,1800,1800,0,0,0,0,0,0,3755,5,20,240,240,61
2020,672900311,39700,2000,2000,2000,0,37700,37000,37000,0,0,700,700,0,0,21760,21760,21760,0,1936,360,50,240,96,250
2020,672900321,330,330,30,30,300,0,0,0,0,0,0,0,0,0,0,0,0,0,788,156,10,30,172,0
2020,672900361,8100,100,100,100,0,8000,8000,8000,0,0,0,0,0,0,0,0,0,0,408,70,50,10,38,4
2020,680000302,12332,3662,3662,3662,0,8670,8000,8000,0,0,670,670,0,0,0,0,0,0,3135,270,25,430,290,217
2020,680000322,18300,5900,5900,5900,0,12400,12000,12000,0,0,400,400,0,0,5000,2000,2000,0,3813,360,500,576,195,236
2020,680000332,291,291,11,11,280,0,0,0,0,0,0,0,0,0,0,0,0,0,599,222,12,36,24,1
2020,680000342,31648,12560,12560,12560,0,19088,17000,17000,0,0,2088,1700,388,0,1220,1220,0,0,2278,156,7,240,156,77
2020,680000352,25610,5110,5110,5110,0,20500,19300,19300,0,0,1200,1200,0,0,2500,2500,2500,0,2222,180,211,310,240,77
2020,680000372,1170,1000,1000,1000,0,170,0,0,0,0,170,0,170,0,0,0,0,0,554,100,30,10,34,1
2020,680000392,32940,9430,9430,9430,0,23510,22000,22000,0,0,1510,1360,150,0,2200,2200,2000,0,4797,360,120,460,240,120
2020,680600311,132983,14113,14113,5113,0,118870,118000,12500,105500,0,870,870,0,0,87870,50970,50970,0,3676,552,360,480,120,584
2020,680600321,22416,5516,5516,3516,0,16900,12000,12000,0,0,4900,1400,500,3000,10900,10900,6500,900,2868,180,60,180,180,80
2020,680600331,12013,633,633,633,0,11380,11380,4580,6800,0,0,0,0,0,0,0,0,0,1045,170,150,20,50,10
2020,680600341,2966,2786,2786,2786,0,180,0,0,0,0,180,180,0,0,430,430,0,100,2145,250,300,250,180,27
2020,680600351,44331,8531,8531,8531,0,35800,35000,30000,5000,0,800,800,0,0,0,0,0,0,2440,200,50,420,120,782
2020,680600361,23536,4420,4420,4420,0,19116,17000,17000,0,0,2116,2000,116,0,9799,9799,9707,0,3371,360,12,264,240,64
2020,680600381,18708,2908,2908,2908,0,15800,15800,8000,7800,0,0,0,0,0,4728,4728,4688,0,4076,340,100,20,336,24
2020,680700321,17685,8185,8185,7185,0,9500,8500,8500,0,0,1000,0,800,200,0,0,0,0,1103,336,20,20,28,24
2020,680700331,33983,11553,11553,11553,0,22430,22000,22000,0,0,430,350,80,0,12300,12300,12280,0,2345,228,70,264,252,95
2020,680700341,36136,10366,10366,10366,0,25770,25000,10000,0,15000,770,770,0,0,0,0,0,0,3765,760,120,360,120,447
2020,680700371,5656,4506,4506,4506,0,1150,0,0,0,0,1150,1100,50,0,16254,16254,0,0,2110,270,240,280,420,34
2020,680700381,2400,800,400,100,400,1600,0,0,0,0,1600,100,1500,0,0,0,0,0,1812,636,10,240,120,52
2020,680800311,47883,9975,9975,9975,0,37908,31300,28000,3300,0,6608,3900,2708,0,14816,14816,14800,0,2413,74,950,610,168,88
2020,680800331,130,130,30,30,100,0,0,0,0,0,0,0,0,0,40,40,0,0,825,455,22,2,0,0
2020,680800351,43221,7271,7271,7271,0,35950,35000,20000,15000,0,950,800,150,0,5000,5000,5000,0,3188,300,50,360,240,182
2020,680800361,78846,35296,35296,35296,0,43550,41000,22000,9000,10000,2550,2400,150,0,15050,15050,0,15000,4647,240,180,420,120,773
2020,680800371,48359,14759,14759,14339,0,33600,31000,22000,9000,0,2600,1200,100,1300,6970,6970,0,0,5460,340,240,840,360,78
2020,680900301,10216,216,216,216,0,10000,10000,10000,0,0,0,0,0,0,0,0,0,0,1385,170,12,140,108,7
2020,680900311,14945,2945,2945,2945,0,12000,12000,12000,0,0,0,0,0,0,0,0,0,0,1549,150,600,140,29,17
2020,680900321,22240,14340,14340,12340,0,7900,4500,4500,0,0,3400,600,800,2000,0,0,0,0,2630,220,670,280,240,103
2020,680900331,82775,845,845,845,0,81930,81430,11000,70430,0,500,500,0,0,34000,0,0,0,1382,190,50,40,85,205
2020,680900341,54,54,54,54,0,0,0,0,0,0,0,0,0,0,0,0,0,0,549,100,72,36,24,1
2020,680900351,7720,4120,3120,3120,1000,3600,0,0,0,0,3600,600,0,3000,0,0,0,0,3998,744,50,150,204,58
2020,680900361,95766,30926,30926,30926,0,64840,62500,21500,41000,0,2340,2140,200,0,2010,10,0,0,4970,350,100,750,320,1068
2020,680900371,24348,348,348,348,0,24000,24000,14000,10000,0,0,0,0,0,0,0,0,0,842,192,250,20,15,44
2020,680900391,40300,1000,1000,1000,0,39300,33000,13000,20000,0,6300,3300,3000,0,5200,5200,0,5200,1500,192,36,240,72,146
2020,681000312,170050,7450,7450,6950,0,162600,161000,31000,130000,0,1600,1200,400,0,24300,23300,23300,0,5270,680,240,400,200,484
2020,681000322,82800,21100,100,100,21000,61700,61700,0,55000,6700,0,0,0,0,42000,6000,0,6000,2200,200,200,100,100,336
2020,681000332,14133,5733,5733,5733,0,8400,8000,8000,0,0,400,400,0,0,5000,5000,0,0,5736,156,1000,1060,1320,304
2020,681000342,5507,5507,2507,2507,3000,0,0,0,0,0,0,0,0,0,1690,1690,0,0,831,96,20,80,85,12
2020,681000352,2795,2075,1575,1575,500,720,0,0,0,0,720,720,0,0,0,0,0,0,2420,540,50,194,360,34
2020,681000362,3820,2020,1020,1020,1000,1800,0,0,0,0,1800,1800,0,0,350,350,0,0,3320,456,15,236,210,146
2020,681000372,1300,1150,150,150,1000,150,0,0,0,0,150,50,100,0,6300,6300,0,0,2676,204,100,350,350,14
2020,681000382,2386,2086,86,86,2000,300,0,0,0,0,300,300,0,0,6000,6000,0,5000,1749,720,23,200,60,255
2020,681000392,39121,962,962,962,0,38159,35700,35000,700,0,2459,2459,0,0,200,0,0,0,2378,680,100,180,210,139
2020,681600301,35782,6582,6582,6582,0,29200,16000,16000,0,0,13200,1200,12000,0,22000,22000,22000,0,3354,280,190,260,280,43
2020,681600311,16431,8911,8911,8911,0,7520,7200,7200,0,0,320,320,0,0,4762,4762,4762,0,3035,250,300,160,135,54
2020,681600361,6495,6495,495,495,6000,0,0,0,0,0,0,0,0,0,6000,6000,6000,0,2718,600,20,290,300,2
2020,681600371,73246,15946,15946,15946,0,57300,53000,30000,23000,0,4300,4300,0,0,0,0,0,0,2930,350,260,300,220,1145
2020,681600391,7780,7400,7400,7400,0,380,0,0,0,0,380,380,0,0,40,40,0,0,1656,340,10,120,216,230
2020,681700301,34055,860,860,860,0,33195,32000,32000,0,0,1195,1000,195,0,18250,18250,18250,0,2986,300,60,360,180,113
2020,681700311,13599,1850,1850,1850,0,11749,9000,9000,0,0,2749,2700,49,0,7400,7400,4540,0,2427,240,120,240,216,172
2020,681700321,7040,40,40,40,0,7000,7000,7000,0,0,0,0,0,0,0,0,0,0,513,126,34,15,26,8
2020,681700331,18590,7490,7490,7490,0,11100,11000,7000,4000,0,100,0,100,0,0,0,0,0,3082,1845,450,24,44,7
2020,681700341,34691,2778,2778,2778,0,31913,27000,27000,0,0,4913,1300,1113,2500,0,0,0,0,2552,498,116,276,120,118
2020,681700361,69012,11312,11312,11312,0,57700,55000,36000,19000,0,2700,2300,400,0,35766,20766,19591,0,4046,283,605,440,215,397
2020,681800301,141272,5392,5392,4292,0,135880,132000,5000,127000,0,3880,1080,2800,0,44000,44000,44000,0,5366,266,60,480,324,56
2020,681800311,12380,2180,2180,2180,0,10200,10000,10000,0,0,200,0,200,0,0,0,0,0,1512,240,60,80,132,29
2020,681800321,45914,3414,3414,3414,0,42500,42000,29000,13000,0,500,400,100,0,25800,25800,19800,6000,1990,230,60,250,180,376
2020,681800341,480,330,80,80,250,150,0,0,0,0,150,150,0,0,0,0,0,0,1257,360,0,250,72,11
2020,681800361,33217,9330,9330,9330,0,23887,23500,23500,0,0,387,148,239,0,0,0,0,0,3999,204,240,300,120,313
2020,681800371,46407,5857,5857,5857,0,40550,37800,13000,24800,0,2750,2550,200,0,11400,11400,11400,0,2220,280,120,240,240,210
2020,681800391,47150,31550,7550,7550,24000,15600,15000,0,15000,0,600,600,0,0,300,300,0,0,3760,300,20,100,180,539
2020,681900301,114800,18600,2600,1100,16000,96200,94000,0,94000,0,2200,2200,0,0,89000,54000,52000,2000,4734,216,120,480,240,256
2020,681900321,3404,3404,3404,3104,0,0,0,0,0,0,0,0,0,0,0,0,0,0,661,88,200,10,34,21
2020,681900351,20133,19653,6653,6653,13000,480,0,0,0,0,480,480,0,0,0,0,0,0,1436,120,10,120,96,376
2020,681900361,4542,4542,1042,442,3500,0,0,0,0,0,0,0,0,0,0,0,0,0,1272,200,180,120,72,23
2020,681900381,14865,1342,1342,1342,0,13523,13000,13000,0,0,523,420,103,0,2140,2140,2050,0,2952,180,30,310,250,110
2020,682000302,91319,7829,7829,7829,0,83490,79200,47000,25000,7200,4290,290,0,4000,50900,38900,29000,9900,4706,420,1500,720,216,1510
2020,682000312,63980,2190,2190,2190,0,61790,59000,15000,44000,0,2790,2700,90,0,9150,3150,0,0,2397,125,120,180,72,133
2020,682000322,12000,1000,1000,1000,0,11000,11000,11000,0,0,0,0,0,0,0,0,0,0,755,192,240,50,24,9
2020,682000332,51530,12130,12130,12130,0,39400,38000,38000,0,0,1400,1400,0,0,0,0,0,0,3750,456,12,120,300,621
2020,682000342,78920,2120,2120,2120,0,76800,75000,45000,30000,0,1800,1800,0,0,0,0,0,0,3164,456,240,60,216,1260
2020,682000352,10800,650,650,650,0,10150,10000,7000,3000,0,150,150,0,0,2375,1875,1875,0,1459,704,296,120,72,38
2020,682000362,25176,6490,6490,6490,0,18686,11000,11000,0,0,7686,6573,113,1000,11171,11171,8251,2920,6665,303,240,623,640,141
2020,682000372,5700,100,100,100,0,5600,5200,5200,0,0,400,400,0,0,1400,1400,1400,0,1173,125,40,250,108,59
2020,682000392,46423,100,100,100,0,46323,46200,6200,40000,0,123,0,123,0,0,0,0,0,727,161,50,40,33,10
2020,682600301,15040,1540,1540,1540,0,13500,13500,13500,0,0,0,0,0,0,0,0,0,0,810,180,12,30,48,383
2020,682600311,71356,36956,36956,14956,0,34400,34000,21000,13000,0,400,400,0,0,12225,12225,10525,1700,2420,400,50,150,120,482
2020,682600331,7560,560,560,560,0,7000,7000,7000,0,0,0,0,0,0,0,0,0,0,1412,108,240,120,36,17
2020,682600361,36353,8540,8540,8540,0,27813,25000,13000,12000,0,2813,2700,113,0,20,20,0,0,3115,111,20,250,240,72
2020,682600381,25003,4190,4190,4190,0,20813,20100,8400,11700,0,713,600,113,0,100,100,0,0,3180,300,84,428,230,97
2020,682700301,81300,8000,8000,8000,0,73300,47000,12000,35000,0,26300,20000,6300,0,50000,50000,0,50000,4790,240,700,600,360,3177
2020,682700321,39057,17375,17375,17375,0,21682,20000,20000,0,0,1682,0,1682,0,0,0,0,0,4344,360,200,120,192,1030
2020,682700331,98152,8400,8400,8400,0,89752,88500,31500,57000,0,1252,1170,82,0,23000,0,0,0,2514,316,100,320,108,329
2020,682700351,1010,1010,1010,1010,0,0,0,0,0,0,0,0,0,0,0,0,0,0,529,150,30,23,16,1
2020,682700361,6000,6000,1000,1000,5000,0,0,0,0,0,0,0,0,0,0,0,0,0,726,144,10,12,36,5
2020,682700381,63650,6150,6150,6150,0,57500,57500,40000,17500,0,0,0,0,0,7517,5017,5000,0,5213,91,700,250,110,104
2020,682800301,12226,3426,3426,3026,0,8800,8600,8600,0,0,200,0,200,0,7744,7744,7744,0,3000,300,50,50,180,13
2020,682800331,59212,32460,32460,32460,0,26752,25200,25200,0,0,1552,1100,452,0,0,0,0,0,2769,250,180,360,96,487
2020,682800341,72815,14025,14025,14025,0,58790,50071,20050,30021,0,8719,719,0,8000,70,70,0,0,3113,240,360,393,180,53
2020,682800351,3535,35,35,35,0,3500,3500,2500,1000,0,0,0,0,0,0,0,0,0,693,64,30,25,24,2
2020,682800371,15592,442,442,442,0,15150,15150,5000,10150,0,0,0,0,0,0,0,0,0,1244,94,150,40,36,29
2020,682800391,4650,2950,2950,2950,0,1700,1700,1700,0,0,0,0,0,0,0,0,0,0,485,80,70,30,50,4
2020,682900301,9027,8027,2027,2027,6000,1000,0,0,0,0,1000,1000,0,0,1670,1670,1500,0,2777,274,100,200,240,109
2020,682900321,40790,37890,32890,32890,5000,2900,0,0,0,0,2900,2900,0,0,4500,4500,4500,0,4000,360,200,280,180,1530
2020,682900331,46589,20200,20200,20200,0,26389,25000,25000,0,0,1389,89,1300,0,0,0,0,0,2790,324,140,144,120,188
2020,682900351,14074,4174,4174,4174,0,9900,9000,5000,4000,0,900,900,0,0,0,0,0,0,2659,950,200,480,102,55
2020,682900361,13126,1126,1126,1126,0,12000,12000,0,12000,0,0,0,0,0,1500,0,0,0,996,324,90,60,36,11
2020,682900381,6166,166,166,166,0,6000,6000,6000,0,0,0,0,0,0,200,200,0,200,664,120,60,20,24,4
2020,683000312,1246,1246,1246,1246,0,0,0,0,0,0,0,0,0,0,0,0,0,0,420,80,50,30,15,1
2020,683600301,1685,885,885,885,0,800,0,0,0,0,800,600,200,0,0,0,0,0,656,80,30,90,156,41
2020,683600311,4189,189,189,189,0,4000,4000,4000,0,0,0,0,0,0,0,0,0,0,1699,90,820,50,29,3
2020,683700301,44368,7468,7468,6968,0,36900,27400,25000,2400,0,9500,1500,8000,0,39000,39000,25000,14000,3051,476,60,300,280,610
2020,683700311,23220,16740,16740,16740,0,6480,6200,1200,5000,0,280,280,0,0,0,0,0,0,1922,140,400,100,112,42
2020,683800301,31030,2330,2330,2330,0,28700,28700,9000,19700,0,0,0,0,0,0,0,0,0,696,160,80,48,50,22
2020,683900301,7550,550,550,550,0,7000,6500,3500,3000,0,500,0,500,0,0,0,0,0,586,140,70,25,36,6
2020,690000222,8083,1783,1783,1783,0,6300,6300,6300,0,0,0,0,0,0,16700,16700,6900,4800,1832,156,300,180,180,50
2020,690000232,20600,20100,5800,5800,14300,500,0,0,0,0,500,500,0,0,60,60,0,0,2044,240,60,180,108,140
2020,690000252,22200,500,500,500,0,21700,20000,20000,0,0,1700,1700,0,0,0,0,0,0,894,84,120,180,60,75
2020,690000262,10458,10058,4858,4858,5200,400,0,0,0,0,400,400,0,0,0,0,0,0,1269,240,50,310,84,35
2020,690000272,6368,3818,2318,1318,1500,2550,0,0,0,0,2550,550,1000,1000,400,400,0,400,2564,600,120,540,300,137
2020,690000282,23212,15012,3012,3012,12000,8200,6500,0,0,6500,1700,1600,100,0,0,0,0,0,2255,240,3,30,180,106
2020,690000292,56261,31661,20361,20361,11300,24600,24000,0,24000,0,600,600,0,0,500,0,0,0,2353,679,174,348,122,1020
2020,690000302,20650,150,150,150,0,20500,20000,20000,0,0,500,0,500,0,0,0,0,0,1080,120,50,70,120,92
2020,690000312,497,497,497,497,0,0,0,0,0,0,0,0,0,0,0,0,0,0,1025,572,10,2,60,1
2020,690000332,41283,223,223,223,0,41060,40000,20000,20000,0,1060,500,60,500,0,0,0,0,1217,72,360,72,48,25
2020,690000342,41936,7986,7986,7986,0,33950,32400,30000,2400,0,1550,1550,0,0,0,0,0,0,4314,208,50,840,516,430
2020,690000352,52040,12640,12640,12640,0,39400,39000,25000,14000,0,400,400,0,0,4000,3800,3800,0,2756,200,120,30,84,39
2020,690000362,61536,4036,4036,4036,0,57500,52000,52000,0,0,5500,5500,0,0,6000,5000,5000,0,4326,130,120,240,156,760
2020,690000382,116080,15780,15780,15780,0,100300,100000,100000,0,0,300,300,0,0,2500,0,0,0,3470,1880,50,150,50,373
2020,690000392,7120,5020,4020,4020,1000,2100,0,0,0,0,2100,2100,0,0,0,0,0,0,2798,336,144,396,180,248
2020,690600221,45270,2870,2870,2870,0,42400,39000,17000,22000,0,3400,3400,0,0,3233,3233,0,0,2680,240,50,180,210,250
2020,690600231,1300,1300,1300,1300,0,0,0,0,0,0,0,0,0,0,0,0,0,0,2028,360,600,240,108,0
2020,690600301,3380,3280,2280,1980,1000,100,0,0,0,0,100,100,0,0,0,0,0,0,2630,876,10,240,144,38
2020,690600321,37182,4882,4882,4882,0,32300,30000,10000,20000,0,2300,2050,250,0,0,0,0,0,2640,488,300,382,20,193
2020,690600361,25370,10870,10870,10870,0,14500,13000,13000,0,0,1500,1500,0,0,0,0,0,0,1874,120,180,120,144,78
2020,690600381,56278,10278,10278,9278,0,46000,32000,32000,0,0,14000,4000,8000,2000,5800,5800,5800,0,2388,180,60,240,300,83
2020,690600391,8793,8493,8493,8493,0,300,0,0,0,0,300,300,0,0,200,200,0,0,2020,120,50,100,300,9
2020,690700201,60047,4977,4977,4977,0,55070,55000,20000,35000,0,70,0,70,0,0,0,0,0,996,240,240,10,72,51
2020,690700211,164350,1000,1000,1000,0,163350,163000,0,163000,0,350,350,0,0,76978,71978,71978,0,1370,300,60,240,120,185
2020,690700221,24844,2494,2494,2494,0,22350,22000,22000,0,0,350,350,0,0,280,280,0,0,2560,520,70,150,100,97
2020,690700231,2058,758,148,148,610,1300,0,0,0,0,1300,1300,0,0,900,900,0,0,2016,456,10,360,120,31
2020,690700301,5010,10,10,10,0,5000,5000,5000,0,0,0,0,0,0,0,0,0,0,835,200,100,40,30,3
2020,690700341,11660,10260,10260,10260,0,1400,0,0,0,0,1400,1400,0,0,0,0,0,0,3696,276,10,240,240,141
2020,690700351,420,270,170,170,100,150,0,0,0,0,150,150,0,0,600,600,0,0,4861,740,800,360,336,24
2020,690700361,21410,7060,7060,7060,0,14350,14000,14000,0,0,350,350,0,0,4650,4650,4000,600,4280,180,800,500,250,66
2020,690700371,55500,5500,5500,5500,0,50000,50000,30000,20000,0,0,0,0,0,1200,0,0,0,2865,180,1100,50,15,114
2020,690700391,41370,3490,3490,3490,0,37880,37000,20000,17000,0,880,780,100,0,0,0,0,0,2480,100,100,300,100,169
2020,690800231,47500,15600,15600,15600,0,31900,31500,11500,20000,0,400,100,300,0,0,0,0,0,1480,250,300,300,50,60
2020,690800241,35610,3510,3510,3510,0,32100,28500,14500,14000,0,3600,3600,0,0,10650,10650,7500,0,3920,400,120,240,380,164
2020,690800301,3660,3460,3460,3460,0,200,0,0,0,0,200,0,200,0,0,0,0,0,632,78,240,10,24,24
2020,690800311,166850,11850,11850,11850,0,155000,152000,60000,92000,0,3000,300,2700,0,0,0,0,0,3246,588,40,180,96,206
2020,690800321,6888,6888,4488,4488,2400,0,0,0,0,0,0,0,0,0,2900,2900,0,2000,2667,764,180,144,10,1
2020,690800331,1620,1620,1320,1320,300,0,0,0,0,0,0,0,0,0,0,0,0,0,2446,840,10,120,144,5
2020,690800341,91134,15034,15034,15034,0,76100,74000,24000,50000,0,2100,2000,100,0,0,0,0,0,3136,276,120,300,240,462
2020,690800351,37197,2050,2050,2050,0,35147,35000,35000,0,0,147,0,147,0,0,0,0,0,1605,360,460,0,20,118
2020,690800371,26015,21065,3565,3565,17500,4950,0,0,0,0,4950,800,4150,0,900,900,0,900,2210,240,50,600,200,124
2020,690800381,9215,8915,215,215,8700,300,0,0,0,0,300,300,0,0,1700,1700,1700,0,1570,250,20,270,180,16
2020,690800391,192280,14180,14180,14180,0,178100,175000,0,175000,0,3100,3100,0,0,60000,60000,60000,0,3120,300,120,360,300,1371
2020,690900211,100159,159,159,159,0,100000,100000,0,100000,0,0,0,0,0,40000,40000,40000,0,842,240,60,24,24,59
2020,690900221,5553,553,553,553,0,5000,5000,5000,0,0,0,0,0,0,0,0,0,0,538,216,60,24,36,4
2020,690900251,30,30,30,30,0,0,0,0,0,0,0,0,0,0,0,0,0,0,447,120,24,36,12,1
2020,690900291,52991,6991,6991,6991,0,46000,45000,45000,0,0,1000,1000,0,0,5500,5500,5500,0,5450,500,200,300,300,326
2020,690900301,37381,22381,22381,22381,0,15000,15000,15000,0,0,0,0,0,0,0,0,0,0,2093,120,50,150,204,78
2020,690900311,33170,5870,5870,5870,0,27300,25000,25000,0,0,2300,2300,0,0,13000,13000,13000,0,3456,168,60,600,180,371
2020,690900321,546400,24400,24400,24400,0,522000,505000,25000,480000,0,17000,2000,15000,0,40000,25000,20000,0,4840,360,500,600,240,20492
2020,690900331,37192,20692,1692,1692,19000,16500,15000,0,15000,0,1500,1500,0,0,12100,12100,12000,0,5166,96,50,360,480,58
2020,690900341,20070,4920,4920,4920,0,15150,15000,15000,0,0,150,150,0,0,0,0,0,0,1565,100,0,180,60,30
2020,690900361,10593,10593,7893,7893,2700,0,0,0,0,0,0,0,0,0,5000,5000,5000,0,2301,312,60,72,96,1
2020,690900371,2676,2676,876,876,1800,0,0,0,0,0,0,0,0,0,2800,2800,1400,0,2256,180,12,96,216,6
2020,690900381,199751,7351,7351,7351,0,192400,192000,52000,140000,0,400,400,0,0,300,300,300,0,5480,360,800,240,240,207
2020,691000202,69709,19070,6570,6570,12500,50639,30600,0,30600,0,20039,4100,15939,0,31932,31932,18000,0,3614,660,100,840,300,153
2020,691000302,2100,2100,2100,2100,0,0,0,0,0,0,0,0,0,0,0,0,0,0,414,36,12,0,24,3
2020,691000312,186020,20,20,20,0,186000,183800,32000,151800,0,2200,2200,0,0,0,0,0,0,2861,100,200,240,100,230
2020,691000322,254,254,4,4,250,0,0,0,0,0,0,0,0,0,2000,2000,0,0,730,66,50,36,96,1
2020,691000352,51308,20808,12508,12508,8300,30500,30000,0,30000,0,500,500,0,0,0,0,0,0,2823,363,60,240,240,161
2020,691600321,59670,8840,8840,8840,0,50830,50000,50000,0,0,830,600,230,0,0,0,0,0,1800,200,300,180,120,144
2020,691600331,10,10,10,10,0,0,0,0,0,0,0,0,0,0,0,0,0,0,579,180,60,10,24,1
2020,691600341,1130,1130,730,730,400,0,0,0,0,0,0,0,0,0,0,0,0,0,960,0,0,60,60,1
2020,691700301,369798,10998,10998,10998,0,358800,355000,25000,330000,0,3800,3300,500,0,500,500,0,500,5484,180,100,1200,336,215
2020,691700311,39700,600,600,600,0,39100,28000,8000,20000,0,11100,600,0,10500,0,0,0,0,1928,54,180,120,168,26
2020,691700331,431400,10000,10000,10000,0,421400,280000,10000,270000,0,141400,1400,140000,0,197000,197000,170000,7000,4250,510,200,500,200,492
2020,691700351,9290,8690,690,690,8000,600,0,0,0,0,600,600,0,0,5400,5400,5400,0,1334,120,24,180,360,12
2020,691800221,13420,420,420,420,0,13000,13000,13000,0,0,0,0,0,0,0,0,0,0,732,240,80,15,42,17
2020,691800241,6010,10,10,10,0,6000,6000,6000,0,0,0,0,0,0,0,0,0,0,459,120,10,29,40,7
2020,691800311,26994,3510,3510,3510,0,23484,20000,20000,0,0,3484,3000,484,0,1510,1510,1510,0,3360,360,120,600,120,194
2020,691800331,18664,535,535,535,0,18129,16000,0,16000,0,2129,1000,1129,0,0,0,0,0,1060,107,34,150,48,127
2020,691900211,56242,1742,1742,1742,0,54500,50000,50000,0,0,4500,4500,0,0,21700,21700,15500,4000,2830,300,60,480,180,665
2020,691900231,14878,11698,9698,9698,2000,3180,0,0,0,0,3180,3000,180,0,1900,1900,0,0,3359,843,180,220,300,293
2020,691900301,619856,26356,26356,26356,0,593500,560000,300000,260000,0,33500,2500,31000,0,282050,282050,250000,32000,5150,250,1000,50,150,1679
2020,691900321,150,150,150,150,0,0,0,0,0,0,0,0,0,0,0,0,0,0,667,120,100,5,12,1
2020,691900341,56640,33340,8340,8340,25000,23300,20000,0,20000,0,3300,2800,500,0,0,0,0,0,2104,240,24,360,180,220
2020,692800211,3280,400,400,400,0,2880,2500,2500,0,0,380,200,180,0,2620,2620,2120,500,693,120,72,190,60,17
2020,692800251,16220,3720,3720,3720,0,12500,12500,12500,0,0,0,0,0,0,100,0,0,0,1915,75,1590,55,60,6
2020,692800261,1886,1660,1660,1660,0,226,0,0,0,0,226,0,226,0,0,0,0,0,485,160,41,120,24,1
2020,692800291,39170,170,170,170,0,39000,39000,9000,30000,0,0,0,0,0,0,0,0,0,478,164,16,12,12,26
2020,693800201,2541,2541,2541,2541,0,0,0,0,0,0,0,0,0,0,729,729,679,0,345,72,5,36,12,1
2020,693800271,56774,4574,4574,4574,0,52200,45000,40000,5000,0,7200,2800,4400,0,6000,6000,6000,0,5080,360,80,400,210,512
2020,693800291,31768,22000,4000,4000,18000,9768,0,0,0,0,9768,9200,568,0,3209,3209,0,0,4824,360,120,480,84,108
2020,694800211,45730,1930,1930,1930,0,43800,41000,41000,0,0,2800,2600,200,0,0,0,0,0,1536,360,100,240,100,239
2020,694800221,40876,23976,3976,3976,20000,16900,16000,0,0,16000,900,900,0,0,2505,2505,0,2400,2500,350,100,280,120,334
2020,694800231,250290,32910,32910,32910,0,217380,214000,40000,160000,14000,3380,3380,0,0,88000,4000,0,4000,6010,540,200,440,300,912
2020,694800291,133978,32308,32308,10808,0,101670,100000,40000,60000,0,1670,1670,0,0,0,0,0,0,11804,1500,1750,800,420,1980
2020,695800231,74562,15910,15910,15910,0,58652,56000,40000,16000,0,2652,2200,452,0,0,0,0,0,5524,420,600,900,384,116
2020,710000112,47800,43800,3800,3800,40000,4000,0,0,0,0,4000,4000,0,0,10000,10000,10000,0,4095,235,500,400,100,923
2020,710000122,107310,10310,10310,10310,0,97000,95000,95000,0,0,2000,2000,0,0,16800,16800,9700,7100,5760,244,811,555,226,1778
2020,710000142,4190,690,90,90,600,3500,3500,0,3500,0,0,0,0,0,200,0,0,0,2228,480,80,180,120,84
2020,710000152,18376,18376,9376,9376,9000,0,0,0,0,0,0,0,0,0,0,0,0,0,1126,120,120,10,36,22
2020,710000162,391350,1050,1050,1050,0,390300,390000,140000,250000,0,300,300,0,0,50000,10000,10000,0,3180,240,100,250,140,886
2020,710000172,139000,6000,6000,6000,0,133000,125000,125000,0,0,8000,8000,0,0,0,0,0,0,3900,400,50,300,100,6208
2020,710000192,30744,1404,1404,1404,0,29340,28740,28000,740,0,600,600,0,0,13450,13450,12500,898,4013,660,960,384,432,137
2020,710000202,5,5,5,5,0,0,0,0,0,0,0,0,0,0,0,0,0,0,2046,432,60,24,60,1
2020,710000212,13756,756,756,756,0,13000,13000,13000,0,0,0,0,0,0,0,0,0,0,612,90,16,36,40,20
2020,710000232,35728,9044,9044,9044,0,26684,25100,23500,1600,0,1584,1500,84,0,0,0,0,0,1992,144,60,108,130,340
2020,710000242,10,10,10,10,0,0,0,0,0,0,0,0,0,0,0,0,0,0,486,60,72,24,30,1
2020,710000252,49308,11608,11608,8108,0,37700,36000,36000,0,0,1700,1700,0,0,26040,26040,24000,2000,5678,420,520,160,300,371
2020,710000262,66890,190,190,190,0,66700,66000,38000,28000,0,700,0,700,0,3595,3595,500,0,1238,265,25,60,84,42
2020,710000272,33316,1916,1916,1916,0,31400,30000,20000,10000,0,1400,1400,0,0,2900,2900,2000,0,2802,240,60,720,180,404
2020,710000282,42510,2210,2210,2210,0,40300,37000,30000,7000,0,3300,3300,0,0,4000,4000,0,4000,3165,360,200,300,220,144
2020,710000292,9505,505,505,505,0,9000,9000,9000,0,0,0,0,0,0,0,0,0,0,964,120,300,24,60,8
2020,710000302,52960,3920,3920,3920,0,49040,45000,45000,0,0,4040,4040,0,0,12000,12000,0,12000,3848,480,20,516,192,1065
2020,710000312,24933,23933,1033,1033,22900,1000,0,0,0,0,1000,1000,0,0,2000,2000,0,0,2797,216,50,720,252,103
2020,710000322,22570,70,70,70,0,22500,22500,22500,0,0,0,0,0,0,2000,0,0,0,963,110,240,12,70,19
2020,710000332,545,545,345,345,200,0,0,0,0,0,0,0,0,0,0,0,0,0,1690,300,70,120,150,20
2020,710000342,21214,20614,3614,3614,17000,600,0,0,0,0,600,600,0,0,4960,4960,4960,0,3440,300,80,130,180,51
2020,710000382,14585,14135,2135,2135,12000,450,0,0,0,0,450,450,0,0,11900,11900,9600,0,2722,120,18,480,360,274
2020,710600131,3530,3330,330,330,3000,200,0,0,0,0,200,200,0,0,2000,2000,0,2000,2632,252,1080,240,60,52
2020,710600141,38540,7840,7840,7840,0,30700,30000,30000,0,0,700,700,0,0,50,50,0,0,2365,75,30,400,230,186
2020,710600191,1302,1302,302,302,1000,0,0,0,0,0,0,0,0,0,0,0,0,0,858,348,30,60,40,35
2020,710600221,56264,22964,22964,18964,0,33300,33000,13000,20000,0,300,0,300,0,17400,14000,14000,0,5038,180,40,1240,288,403
2020,710600251,11034,34,34,34,0,11000,11000,11000,0,0,0,0,0,0,0,0,0,0,1020,180,50,60,42,12
2020,710600261,63190,1950,1950,1950,0,61240,60000,60000,0,0,1240,1100,140,0,13838,13838,13000,0,2363,252,60,228,324,69
2020,710600271,7428,7428,428,428,7000,0,0,0,0,0,0,0,0,0,7910,7910,0,7120,2350,300,20,180,240,9
2020,710600341,56142,29242,29242,27242,0,26900,26000,26000,0,0,900,900,0,0,0,0,0,0,2478,210,450,120,78,50
2020,710600371,36329,11329,6329,1829,5000,25000,25000,0,25000,0,0,0,0,0,7282,7282,5200,2082,1615,215,30,216,230,39
2020,710600381,103030,30,30,30,0,103000,103000,58000,45000,0,0,0,0,0,26900,26600,26600,0,1376,300,220,10,36,588
2020,710600391,22610,22610,16610,16610,6000,0,0,0,0,0,0,0,0,0,0,0,0,0,1362,182,10,12,78,233
2020,710601101,26746,4446,4446,4446,0,22300,22300,22300,0,0,0,0,0,0,0,0,0,0,1166,360,120,50,48,30
2020,710601111,14008,12708,4708,4708,8000,1300,0,0,0,0,1300,1300,0,0,9780,9780,7000,2000,1804,320,40,480,144,31
2020,710700111,725,725,725,725,0,0,0,0,0,0,0,0,0,0,0,0,0,0,824,240,100,12,12,6
2020,710700131,24769,24169,19449,19449,4720,600,0,0,0,0,600,600,0,0,1000,1000,1000,0,3932,402,150,240,240,193
2020,710700151,97928,97528,63028,63028,34500,400,0,0,0,0,400,300,100,0,0,0,0,0,5760,360,360,120,240,19231
2020,710700161,30,30,30,30,0,0,0,0,0,0,0,0,0,0,0,0,0,0,560,340,60,0,30,0
2020,710700171,8634,8334,1334,1334,7000,300,0,0,0,0,300,300,0,0,700,700,0,0,3740,150,30,660,230,86
2020,710700181,36715,35515,5515,5515,30000,1200,0,0,0,0,1200,1200,0,0,0,0,0,0,3980,230,150,250,170,107
2020,710700191,77800,12600,12600,12600,0,65200,65000,45000,20000,0,200,200,0,0,0,0,0,0,2145,180,15,300,120,130
2020,710700201,10791,420,420,420,0,10371,9000,9000,0,0,1371,550,821,0,0,0,0,0,1906,200,55,300,192,95
2020,710700211,8638,6138,6138,6138,0,2500,2500,2500,0,0,0,0,0,0,2400,1600,0,1000,682,202,48,36,36,3
2020,710700221,17045,5490,5490,5490,0,11555,5000,5000,0,0,6555,380,175,6000,2030,30,0,0,1950,516,26,372,68,10
2020,710700241,11238,6613,6613,6613,0,4625,4500,4500,0,0,125,80,45,0,0,0,0,0,1090,78,24,240,85,12
2020,710700251,110970,20940,940,940,20000,90030,60000,0,60000,0,30030,30,30000,0,35000,30000,30000,0,4748,420,50,300,288,4432
2020,710700261,4015,4015,15,15,4000,0,0,0,0,0,0,0,0,0,0,0,0,0,611,103,80,20,36,1
2020,710700271,63235,10210,10210,10210,0,53025,53000,45000,8000,0,25,0,25,0,700,0,0,0,1762,120,300,20,72,35
2020,710700281,32410,10110,10110,10110,0,22300,21000,21000,0,0,1300,300,1000,0,0,0,0,0,3394,360,20,240,240,884
2020,710700341,69670,17770,17770,17770,0,51900,47000,47000,0,0,4900,4900,0,0,7890,7890,7890,0,7750,400,500,1200,250,1663
2020,710700351,3138,3138,1638,1638,1500,0,0,0,0,0,0,0,0,0,0,0,0,0,2548,788,150,172,150,8
2020,710700371,38200,5200,5200,3200,0,33000,22000,22000,0,0,11000,1000,0,10000,27437,27437,22685,3752,656,180,25,120,84,28
2020,710700391,26210,9240,2240,2240,7000,16970,16800,0,0,16800,170,170,0,0,16850,16850,0,16800,4366,840,20,360,336,60
2020,710701101,241,241,141,141,100,0,0,0,0,0,0,0,0,0,0,0,0,0,1809,330,6,52,175,1
2020,710701151,35620,35620,16620,16620,19000,0,0,0,0,0,0,0,0,0,0,0,0,0,1870,240,280,100,120,36
2020,710800101,156500,3800,3800,3800,0,152700,151000,100000,51000,0,1700,1700,0,0,30300,28300,28300,0,1200,400,10,270,70,232
2020,710800151,108452,1452,1452,1452,0,107000,107000,85000,22000,0,0,0,0,0,21000,0,0,0,1090,250,20,20,60,77
2020,710800161,171000,1000,1000,1000,0,170000,170000,170000,0,0,0,0,0,0,2000,0,0,0,2790,240,120,120,110,420
2020,710800201,3705,2405,2005,1705,400,1300,0,0,0,0,1300,800,0,500,0,0,0,0,3330,324,12,360,240,70
2020,710800211,11450,7920,7420,7420,500,3530,2500,0,2500,0,1030,300,730,0,0,0,0,0,3364,720,10,240,84,87
2020,710800221,3,3,3,3,0,0,0,0,0,0,0,0,0,0,0,0,0,0,581,130,0,36,15,0
2020,710800231,10610,5010,5010,5010,0,5600,5600,5600,0,0,0,0,0,0,0,0,0,0,772,60,100,36,116,4
2020,710800241,380,310,310,110,0,70,0,0,0,0,70,0,50,20,0,0,0,0,1106,150,480,36,0,3
2020,710800251,4600,4600,600,600,4000,0,0,0,0,0,0,0,0,0,0,0,0,0,2554,504,2,288,48,54
2020,710800271,46970,2670,2670,2670,0,44300,43000,28000,15000,0,1300,1000,300,0,13000,13000,10000,0,1220,110,100,200,150,70
2020,710800281,53988,772,772,772,0,53216,52000,27000,25000,0,1216,1200,16,0,28280,9280,6280,0,1860,120,100,80,150,179
2020,710800301,137390,45290,45290,45290,0,92100,92000,65000,27000,0,100,100,0,0,30000,30000,30000,0,6773,400,300,600,73,2152
2020,710800341,2962,2562,62,62,2500,400,0,0,0,0,400,300,0,100,5700,5700,500,0,2254,300,20,84,300,37
2020,710800351,4224,4224,4224,4224,0,0,0,0,0,0,0,0,0,0,500,500,0,0,933,381,0,60,54,1
2020,710800381,12730,12650,150,150,12500,80,0,0,0,0,80,80,0,0,10480,10480,7480,2000,1996,136,360,240,330,265
2020,710800391,10575,10375,1375,1375,9000,200,0,0,0,0,200,200,0,0,2000,2000,2000,0,4601,240,50,820,419,23
2020,710900111,7422,5622,2622,2122,3000,1800,0,0,0,0,1800,1800,0,0,920,920,0,820,1100,500,30,50,100,51
2020,710900121,53926,26926,26926,26926,0,27000,27000,27000,0,0,0,0,0,0,0,0,0,0,1800,100,300,100,200,167
2020,710900151,76238,37238,37238,37238,0,39000,38000,0,38000,0,1000,1000,0,0,24000,0,0,0,3740,720,120,500,200,1071
2020,710900161,119200,9200,9200,9200,0,110000,110000,80000,30000,0,0,0,0,0,100,100,0,0,4880,450,1400,50,150,513
2020,710900171,32002,29272,4272,4272,25000,2730,0,0,0,0,2730,2500,230,0,0,0,0,0,5003,300,50,360,192,429
2020,710900191,1100,100,100,100,0,1000,0,0,0,0,1000,1000,0,0,300,300,0,0,550,120,30,60,60,6
2020,710900211,5693,444,444,444,0,5249,5000,0,5000,0,249,200,49,0,0,0,0,0,2757,107,420,56,175,55
2020,710900221,92920,20735,20735,20735,0,72185,70000,53000,17000,0,2185,2000,185,0,34020,29020,29020,0,3851,300,300,672,240,245
2020,710900231,117610,10610,10610,10610,0,107000,100000,60000,40000,0,7000,5000,2000,0,0,0,0,0,4170,840,60,180,144,190
2020,710900251,20327,5237,5237,5237,0,15090,15000,15000,0,0,90,0,90,0,2800,2800,0,0,4344,204,50,120,170,126
2020,710900261,5360,5260,5260,5260,0,100,0,0,0,0,100,100,0,0,0,0,0,0,3848,240,24,520,360,186
2020,710900301,107000,10650,10650,10650,0,96350,95500,55500,40000,0,850,350,500,0,10500,0,0,0,3370,400,400,550,300,185
2020,710900311,20090,90,90,90,0,20000,20000,20000,0,0,0,0,0,0,500,0,0,0,870,180,400,10,70,25
2020,710900331,2315,2315,1815,1815,500,0,0,0,0,0,0,0,0,0,3480,3480,0,600,1254,434,50,72,228,0
2020,710900371,41570,70,70,70,0,41500,40000,40000,0,0,1500,1500,0,0,10540,10540,9800,0,4626,304,60,380,192,233
2020,710900381,61748,11348,11348,11348,0,50400,50000,40000,10000,0,400,400,0,0,0,0,0,0,2290,204,200,190,96,79
2020,710900391,33420,31820,1820,1820,30000,1600,0,0,0,0,1600,1600,0,0,24000,24000,20000,4000,4300,216,300,144,360,160
2020,711000112,4000,3000,200,200,2800,1000,0,0,0,0,1000,1000,0,0,0,0,0,0,673,288,0,15,36,0
2020,711000152,35200,200,200,200,0,35000,35000,35000,0,0,0,0,0,0,21000,21000,21000,0,2340,240,120,120,150,1
2020,711000162,43870,570,570,570,0,43300,43000,43000,0,0,300,300,0,0,0,0,0,0,1892,300,360,240,60,117
2020,711000172,38850,2200,2200,2200,0,36650,27000,27000,0,0,9650,1500,150,8000,0,0,0,0,4040,1040,1200,610,120,45
2020,711000192,18690,7090,90,90,7000,11600,11400,0,0,11400,200,200,0,0,2000,2000,2000,0,3142,600,120,360,312,16
2020,711000202,10246,9746,1746,1746,8000,500,0,0,0,0,500,0,500,0,0,0,0,0,1850,180,60,15,95,66
2020,711000212,19250,19250,8250,8250,11000,0,0,0,0,0,0,0,0,0,68,68,0,0,1730,120,500,60,70,17
2020,711000222,214850,10650,10650,10650,0,204200,201000,31000,170000,0,3200,3000,200,0,26000,20000,15000,5000,3500,400,900,400,200,1183
2020,711000242,78,78,78,78,0,0,0,0,0,0,0,0,0,0,0,0,0,0,557,50,60,15,42,0
2020,711000252,21050,8050,8050,8050,0,13000,13000,13000,0,0,0,0,0,0,500,0,0,0,880,72,120,12,36,30
2020,711000262,25300,3800,3800,3800,0,21500,21000,6000,15000,0,500,200,300,0,15240,2240,1940,300,2036,100,6,300,120,103
2020,711000302,3243,2943,1943,1943,1000,300,0,0,0,0,300,300,0,0,1000,1000,0,0,3240,732,150,403,280,37
2020,711000312,3918,3838,838,838,3000,80,0,0,0,0,80,80,0,0,0,0,0,0,1152,550,50,300,72,15
2020,711000322,4756,4756,3756,3756,1000,0,0,0,0,0,0,0,0,0,11000,11000,0,0,2418,948,100,200,180,149
2020,711000332,35119,20019,19,19,20000,15100,15000,0,15000,0,100,100,0,0,15904,12904,11064,0,3096,240,560,264,252,212
2020,711000352,15212,11712,6712,6212,5000,3500,0,0,0,0,3500,1500,0,2000,500,500,0,500,1844,260,70,150,124,9
2020,711000362,8940,8240,6240,2240,2000,700,0,0,0,0,700,400,300,0,1800,1800,800,0,2943,480,50,600,193,32
2020,711000372,166490,2240,2240,2240,0,164250,162000,90000,72000,0,2250,1750,500,0,70000,0,0,0,2762,240,320,120,120,972
2020,711000382,78347,34297,1297,1297,33000,44050,42000,0,42000,0,2050,1500,550,0,27089,7089,6950,0,3460,172,46,338,231,371
2020,711000392,53594,1564,1564,564,0,52030,51000,51000,0,0,1030,0,230,800,33212,33212,25002,6777,2669,264,15,480,192,132
2020,711600121,20980,14490,490,490,14000,6490,4500,0,0,4500,1990,1990,0,0,8800,8800,8800,0,2360,400,100,300,200,37
2020,711600131,64460,16260,16260,16260,0,48200,45000,40000,5000,0,3200,3000,200,0,1500,1500,0,0,5425,180,100,600,300,1083
2020,711600141,3400,1220,220,220,1000,2180,0,0,0,0,2180,2000,180,0,690,690,0,0,3276,442,900,240,60,74
2020,711600161,350,350,150,150,200,0,0,0,0,0,0,0,0,0,0,0,0,0,1183,336,400,15,12,2
2020,711600181,200350,50,50,50,0,200300,200000,200000,0,0,300,0,300,0,82000,62000,60000,2000,2748,540,120,30,108,515
2020,711600191,96652,23070,23070,23070,0,73582,71000,69000,2000,0,2582,2582,0,0,170,170,0,0,2418,324,100,300,108,244
2020,711600201,7615,4615,4615,4615,0,3000,3000,3000,0,0,0,0,0,0,0,0,0,0,2518,80,765,60,118,7
2020,711600211,55440,11140,11140,11140,0,44300,44000,39000,5000,0,300,300,0,0,28000,28000,20000,8000,4550,200,100,300,250,1103
2020,711600221,27550,350,350,350,0,27200,25000,18000,7000,0,2200,2200,0,0,4000,0,0,0,3170,200,280,520,240,215
2020,711600241,22132,9180,9180,9180,0,12952,11000,11000,0,0,1952,1500,452,0,10847,10847,4847,5000,2288,108,60,300,240,80
2020,711600251,20090,90,90,90,0,20000,20000,20000,0,0,0,0,0,0,0,0,0,0,870,120,70,36,24,16
2020,711600261,32340,14290,14290,10290,0,18050,17500,17500,0,0,550,550,0,0,3500,3500,0,0,2710,300,400,120,120,436
2020,711600281,22774,7774,7774,7774,0,15000,15000,15000,0,0,0,0,0,0,0,0,0,0,4744,300,350,480,240,77
2020,711600321,49984,1984,1984,1984,0,48000,48000,48000,0,0,0,0,0,0,18100,18100,15000,3000,4989,360,50,25,320,1052
2020,711700111,8075,7955,7455,7455,500,120,0,0,0,0,120,120,0,0,0,0,0,0,1650,480,100,120,120,16
2020,711700121,5902,4602,1102,1102,3500,1300,0,0,0,0,1300,1300,0,0,900,900,0,0,2740,500,120,300,300,33
2020,711700131,65565,90,90,90,0,65475,65000,65000,0,0,475,400,75,0,4000,4000,4000,0,3610,350,245,744,126,383
2020,711700181,13226,5126,5126,5126,0,8100,8000,0,8000,0,100,0,100,0,0,0,0,0,1652,240,60,120,132,3
2020,711700201,19056,3496,3496,3496,0,15560,15400,15400,0,0,160,160,0,0,9300,9300,8600,0,3492,312,25,490,320,52
2020,711700211,57620,2320,2320,2320,0,55300,55000,20000,35000,0,300,0,300,0,8300,0,0,0,2064,180,1000,34,40,102
2020,711700221,56238,27288,27288,27288,0,28950,28000,28000,0,0,950,950,0,0,0,0,0,0,2056,140,500,220,96,106
2020,711700231,1563,1563,63,63,1500,0,0,0,0,0,0,0,0,0,0,0,0,0,895,306,111,12,50,1
2020,711700251,33250,3850,3850,3850,0,29400,29000,29000,0,0,400,400,0,0,20350,20350,19100,1100,3314,300,354,240,120,69
2020,711700281,42944,24944,22944,21944,2000,18000,18000,0,18000,0,0,0,0,0,14000,0,0,0,2460,960,50,250,180,45
2020,711700291,36690,9090,9090,9090,0,27600,24000,24000,0,0,3600,3600,0,0,2000,2000,0,0,2693,158,25,355,120,71
2020,711700311,21625,2725,2725,2725,0,18900,17200,15000,0,2200,1700,1700,0,0,1620,1620,1500,0,1844,120,240,360,144,45
2020,711700321,14240,14240,240,240,14000,0,0,0,0,0,0,0,0,0,10000,10000,10000,0,1353,96,20,20,66,40
2020,711700351,16914,4764,4264,4264,500,12150,10600,0,10600,0,1550,1400,150,0,9200,8900,6500,2400,3690,1020,100,300,120,127
2020,711700391,6478,6478,2958,2958,3520,0,0,0,0,0,0,0,0,0,1400,1400,1400,0,953,234,14,96,72,6
2020,711800121,50600,600,600,600,0,50000,50000,50000,0,0,0,0,0,0,1350,0,0,0,1092,220,100,12,15,38
2020,711800141,1260,960,960,960,0,300,0,0,0,0,300,300,0,0,2500,2500,0,1500,5900,300,100,800,300,339
2020,711800171,66696,64496,21496,6496,43000,2200,0,0,0,0,2200,2000,200,0,15000,15000,0,15000,4724,240,400,720,480,715
2020,711800201,35820,3020,3020,3020,0,32800,29000,29000,0,0,3800,3800,0,0,7600,7600,7600,0,5660,360,200,600,250,210
2020,711800211,73944,9844,9844,9844,0,64100,58000,58000,0,0,6100,6000,100,0,27960,27960,27460,0,2535,230,60,240,180,204
2020,711800221,113232,40582,8582,8582,32000,72650,69000,0,35000,34000,3650,3000,650,0,10012,10012,10000,0,4204,254,215,350,132,593
2020,711800271,16160,160,160,160,0,16000,16000,16000,0,0,0,0,0,0,0,0,0,0,2278,220,8,150,300,23
2020,711800301,80942,50642,12642,12642,38000,30300,30000,0,30000,0,300,300,0,0,0,0,0,0,4040,300,200,200,220,110
2020,711800311,79700,3700,3700,3700,0,76000,76000,76000,0,0,0,0,0,0,19000,19000,18000,1000,4900,500,200,500,250,258
2020,711800331,5130,5130,130,130,5000,0,0,0,0,0,0,0,0,0,0,0,0,0,1960,660,500,20,50,1
2020,711800351,67790,65493,33493,33493,32000,2297,0,0,0,0,2297,1957,340,0,1534,1534,0,1500,7690,750,190,450,250,1751
2020,711800371,44665,32065,22065,22065,10000,12600,10000,0,10000,0,2600,2600,0,0,1000,0,0,0,1980,280,290,300,180,249
2020,711800381,62107,10627,10627,4627,0,51480,45000,45000,0,0,6480,2600,1880,2000,24680,14680,10000,3000,5340,600,320,450,330,731
2020,711900101,1876,1876,1576,1576,300,0,0,0,0,0,0,0,0,0,0,0,0,0,1090,400,30,90,70,4
2020,711900111,5200,5200,5200,5200,0,0,0,0,0,0,0,0,0,0,0,0,0,0,2982,870,500,240,72,985
2020,711900121,895590,400000,400000,400000,0,495590,448000,23000,425000,0,47590,7590,40000,0,0,0,0,0,10380,720,260,700,200,6604
2020,711900131,113690,95240,56240,56240,39000,18450,18000,0,0,18000,450,450,0,0,20170,20170,0,20000,6410,1120,400,250,240,3087
2020,711900141,30380,1380,1380,1380,0,29000,26000,26000,0,0,3000,3000,0,0,6000,6000,6000,0,4945,400,240,100,350,38
2020,711900151,3315,3315,2815,2815,500,0,0,0,0,0,0,0,0,0,0,0,0,0,2491,600,12,240,180,14
2020,711900161,14080,14080,4080,4080,10000,0,0,0,0,0,0,0,0,0,10,10,0,0,1135,115,20,100,90,123
2020,711900191,76230,1730,1730,1730,0,74500,65000,65000,0,0,9500,3000,0,6500,11000,11000,8000,0,4368,276,252,1320,240,459
2020,711900201,1060,1060,60,60,1000,0,0,0,0,0,0,0,0,0,1300,1300,0,0,1945,520,25,80,180,17
2020,711900221,29212,8186,8186,8186,0,21026,19000,19000,0,0,2026,1800,226,0,2900,1300,0,1300,2066,96,80,240,180,78
2020,711900231,21560,6660,6660,4660,0,14900,12000,12000,0,0,2900,1900,1000,0,0,0,0,0,1488,126,20,310,62,37
2020,711900241,1520,520,200,200,320,1000,0,0,0,0,1000,0,1000,0,0,0,0,0,641,96,5,36,24,0
2020,711900251,7675,7514,614,614,6900,161,0,0,0,0,161,0,161,0,0,0,0,0,2086,240,36,240,180,1
2020,711900261,29184,5184,5184,4684,0,24000,10000,10000,0,0,14000,12500,0,1500,2956,2956,2356,600,3780,500,30,200,400,149
2020,711900271,29590,18790,7690,5690,11100,10800,0,0,0,0,10800,800,0,10000,8120,8120,8000,0,1845,160,50,65,180,15
2020,711900301,65498,5168,5168,5168,0,60330,59000,30000,29000,0,1330,1030,300,0,32500,13000,10000,3000,3180,240,360,360,360,352
2020,711900311,60272,47272,38272,38272,9000,13000,13000,0,0,13000,0,0,0,0,13000,13000,0,13000,1404,120,60,120,84,87
2020,711900321,12972,12272,3272,3272,9000,700,0,0,0,0,700,700,0,0,5000,5000,5000,0,1128,120,120,100,48,24
2020,711900341,60513,33173,5173,5173,28000,27340,27000,0,0,27000,340,340,0,0,7292,7292,7000,0,1080,160,104,200,80,51
2020,711900361,117810,26810,26810,26810,0,91000,90000,90000,0,0,1000,1000,0,0,0,0,0,0,4080,600,120,480,360,671
2020,711900371,4746,4746,3246,3246,1500,0,0,0,0,0,0,0,0,0,300,300,0,0,2018,450,100,240,120,32
2020,711900381,7155,4955,4955,4955,0,2200,0,0,0,0,2200,2200,0,0,0,0,0,0,4580,360,80,600,360,62
2020,711900391,62510,15658,15658,15658,0,46852,46000,46000,0,0,852,400,452,0,18700,18700,3700,7500,5860,480,120,120,120,5164
2020,712000102,62541,41,41,41,0,62500,62500,62500,0,0,0,0,0,0,24500,0,0,0,1454,600,60,12,22,25
2020,712000112,87998,5920,5920,5920,0,82078,80000,80000,0,0,2078,1400,678,0,0,0,0,0,3720,400,1100,150,70,119
2020,712000132,3560,2560,60,60,2500,1000,0,0,0,0,1000,1000,0,0,1000,1000,0,0,1964,384,30,120,120,7
2020,712000142,138260,20960,20960,20960,0,117300,106000,56000,50000,0,11300,11300,0,0,18760,11260,10000,0,7472,528,600,480,402,5027
2020,712000152,5,5,5,5,0,0,0,0,0,0,0,0,0,0,0,0,0,0,652,72,10,40,60,1
2020,712000172,2414,2414,2414,2414,0,0,0,0,0,0,0,0,0,0,0,0,0,0,1370,200,500,10,40,27
2020,712000182,68651,37426,32426,31926,5000,31225,25000,0,25000,0,6225,728,5497,0,22000,0,0,0,2662,420,10,100,192,275
2020,712000192,146855,23755,23755,23755,0,123100,121900,75000,20000,26900,1200,200,1000,0,70000,67000,40000,27000,5770,300,1250,200,120,648
2020,712000202,27810,2310,2310,2310,0,25500,22000,22000,0,0,3500,0,3500,0,0,0,0,0,2009,250,150,150,72,72
2020,712000212,2220,2220,2220,2220,0,0,0,0,0,0,0,0,0,0,0,0,0,0,649,60,36,20,33,1
2020,712000242,20250,250,250,250,0,20000,20000,0,20000,0,0,0,0,0,500,0,0,0,940,150,240,10,30,8
2020,712000252,2200,2200,200,200,2000,0,0,0,0,0,0,0,0,0,0,0,0,0,3875,480,25,180,180,6
2020,712000262,23886,6450,6450,6450,0,17436,17000,17000,0,0,436,50,386,0,8200,8200,8200,0,3432,240,400,300,252,69
2020,712000272,15381,14160,2660,2660,11500,1221,0,0,0,0,1221,1221,0,0,0,0,0,0,4310,180,300,300,230,298
2020,712000282,30140,13140,13140,13140,0,17000,14000,14000,0,0,3000,3000,0,0,10500,10500,9500,0,2310,240,120,300,120,146
2020,712000292,41848,7248,7248,7248,0,34600,34000,24000,10000,0,600,500,100,0,4000,4000,4000,0,4380,180,120,360,360,75
2020,712000312,58803,13490,13490,9490,0,45313,40000,30000,10000,0,5313,2700,2113,500,8280,1280,500,0,2635,560,60,360,300,519
2020,712000322,7740,7740,4740,4740,3000,0,0,0,0,0,0,0,0,0,0,0,0,0,3182,840,30,60,72,45
2020,712000342,46000,350,350,350,0,45650,45000,45000,0,0,650,650,0,0,0,0,0,0,4300,240,1000,480,240,185
2020,712000352,82220,8720,8720,8720,0,73500,70000,70000,0,0,3500,3500,0,0,0,0,0,0,6120,600,50,400,400,351
2020,712000382,700,700,200,200,500,0,0,0,0,0,0,0,0,0,0,0,0,0,1752,600,36,120,240,21
2020,712600101,151300,800,800,800,0,150500,150000,60000,90000,0,500,500,0,0,70000,0,0,0,3490,500,50,480,270,468
2020,712600151,30110,11110,11110,11110,0,19000,18000,18000,0,0,1000,900,100,0,3840,3840,3200,0,2400,150,150,180,204,110
2020,712600161,27250,2250,2250,2250,0,25000,25000,25000,0,0,0,0,0,0,0,0,0,0,984,168,120,20,36,29
2020,712600171,32400,5700,5700,5700,0,26700,26100,21000,0,5100,600,600,0,0,0,0,0,0,1374,80,300,150,84,105
2020,712600181,160,160,160,160,0,0,0,0,0,0,0,0,0,0,300,300,0,0,932,0,0,240,72,0
2020,712600201,31960,910,910,910,0,31050,31000,31000,0,0,50,0,50,0,100,100,0,0,2625,300,40,50,48,362
2020,712600211,12100,100,100,100,0,12000,12000,12000,0,0,0,0,0,0,500,0,0,0,1442,150,990,12,42,17
2020,712600221,6010,10,10,10,0,6000,6000,6000,0,0,0,0,0,0,0,0,0,0,365,110,90,10,15,8
2020,712600231,65554,20354,20354,15354,0,45200,45000,45000,0,0,200,0,200,0,6720,6720,5600,0,4750,240,600,240,360,116
2020,712600251,5295,5295,295,295,5000,0,0,0,0,0,0,0,0,0,0,0,0,0,1207,179,125,60,78,24
2020,712600281,17065,16665,13665,11665,3000,400,0,0,0,0,400,300,100,0,0,0,0,0,1902,660,200,100,60,38
2020,712600321,1531,1531,1031,1031,500,0,0,0,0,0,0,0,0,0,1400,1400,1400,0,1544,420,10,144,180,4
2020,712600331,16558,15258,1258,1258,14000,1300,0,0,0,0,1300,1300,0,0,14000,14000,14000,0,5096,747,530,430,360,240
2020,712600341,20100,3100,3100,3100,0,17000,17000,17000,0,0,0,0,0,0,0,0,0,0,2740,450,120,360,300,487
2020,712600351,57386,11386,11386,11386,0,46000,45000,25000,20000,0,1000,1000,0,0,12080,12080,12080,0,2976,350,50,360,216,308
2020,712600361,5799,5799,3799,3799,2000,0,0,0,0,0,0,0,0,0,0,0,0,0,2830,900,60,120,240,13
2020,712600381,5982,5332,1332,332,4000,650,0,0,0,0,650,0,500,150,1000,1000,0,1000,2310,540,10,120,180,1
2020,712600391,55400,2600,2600,2600,0,52800,50000,20000,30000,0,2800,2800,0,0,34014,34014,28414,2800,5270,600,650,500,240,88
2020,712700101,59851,59851,39851,39851,20000,0,0,0,0,0,0,0,0,0,0,0,0,0,4920,200,400,120,350,1002
2020,712700121,130,130,10,10,120,0,0,0,0,0,0,0,0,0,2500,2500,0,0,699,300,23,96,30,0
2020,712700151,106128,21928,21928,19928,0,84200,75000,65000,10000,0,9200,3900,5300,0,11390,11390,7690,3700,3584,240,100,200,144,581
2020,712700181,18330,2530,2530,2530,0,15800,15000,15000,0,0,800,800,0,0,6380,6380,2380,4000,4154,168,56,360,340,406
2020,712700191,64544,30044,20044,15044,10000,34500,34000,0,34000,0,500,500,0,0,19500,16000,16000,0,5930,180,140,500,360,213
2020,712700201,18010,1560,1560,1560,0,16450,16000,16000,0,0,450,300,150,0,713,713,0,500,2100,220,260,300,120,36
2020,712700211,71605,27105,27105,27105,0,44500,43000,40000,3000,0,1500,500,1000,0,2000,2000,2000,0,3750,300,70,500,240,81
2020,712700221,60515,28115,3115,3115,25000,32400,32000,0,32000,0,400,400,0,0,517,517,0,297,6500,260,250,800,340,2119
2020,712700231,17586,14786,8286,8286,6500,2800,0,0,0,0,2800,2300,500,0,900,900,0,0,4678,180,24,360,324,200
2020,712700251,37510,2110,2110,2110,0,35400,31000,31000,0,0,4400,4400,0,0,0,0,0,0,4175,450,120,720,205,1995
2020,712700261,120170,56470,56470,56470,0,63700,62000,32000,30000,0,1700,1700,0,0,0,0,0,0,6850,320,50,1250,360,866
2020,712700281,22600,2600,2600,2600,0,20000,17000,17000,0,0,3000,3000,0,0,0,0,0,0,2016,180,36,360,180,169
2020,712700311,25300,1700,1700,1700,0,23600,23300,23300,0,0,300,300,0,0,0,0,0,0,1230,70,30,120,60,46
2020,712700321,34312,8312,8312,8312,0,26000,26000,26000,0,0,0,0,0,0,0,0,0,0,2160,324,36,300,288,277
2020,712700331,28040,2890,2890,2890,0,25150,25000,25000,0,0,150,150,0,0,8940,8940,8940,0,1911,271,200,240,240,159
2020,712700351,57910,14660,14660,14660,0,43250,43000,35000,8000,0,250,0,250,0,8000,0,0,0,1740,200,100,70,120,94
2020,712800111,54482,4382,4382,4382,0,50100,50000,38000,12000,0,100,100,0,0,25480,25480,25480,0,3220,200,150,120,240,189
2020,712800151,14005,14005,2505,2505,11500,0,0,0,0,0,0,0,0,0,5600,5600,5600,0,1860,132,20,36,240,133
2020,712800171,510,510,10,10,500,0,0,0,0,0,0,0,0,0,0,0,0,0,1060,380,300,100,20,0
2020,712800191,48650,5550,5550,5550,0,43100,43000,43000,0,0,100,100,0,0,38557,38557,21107,16000,2948,210,150,438,150,375
2020,712800201,12790,12540,1540,1540,11000,250,0,0,0,0,250,250,0,0,7000,7000,7000,0,1780,165,30,350,185,41
2020,712800221,23113,518,518,518,0,22595,20800,20800,0,0,1795,900,895,0,11800,11800,10200,1600,2388,216,120,240,192,99
2020,712800241,38690,10590,10590,9090,0,28100,28000,18000,10000,0,100,0,100,0,2560,60,0,0,2356,144,126,336,240,77
2020,712800251,32174,4174,4174,4174,0,28000,28000,10000,18000,0,0,0,0,0,2000,0,0,0,2336,144,150,144,138,319
2020,712800281,108540,50440,50440,50440,0,58100,56500,30000,2500,24000,1600,1600,0,0,0,0,0,0,6114,240,800,1200,284,136
2020,712800301,50544,10144,10144,10144,0,40400,40000,40000,0,0,400,400,0,0,19000,12500,12500,0,3134,640,350,480,144,77
2020,712800311,1180,1180,180,180,1000,0,0,0,0,0,0,0,0,0,3000,3000,0,0,1041,660,30,10,60,3
2020,712800321,49809,6509,6509,6509,0,43300,43000,43000,0,0,300,300,0,0,1380,1380,0,1350,4200,450,50,300,350,323
2020,712800351,32160,4160,4160,4160,0,28000,28000,28000,0,0,0,0,0,0,10000,10000,10000,0,1512,240,120,60,72,34
2020,712800371,68864,2864,2864,2864,0,66000,66000,16000,50000,0,0,0,0,0,9850,9850,9850,0,1410,120,150,120,50,56
2020,712900101,135805,19675,19675,19675,0,116130,106000,52000,54000,0,10130,1000,1130,8000,15000,10000,10000,0,2956,240,60,540,100,193
2020,712900131,109308,31695,31695,31695,0,77613,71500,68000,3500,0,6113,6000,113,0,3899,3899,3730,169,4856,236,1000,600,200,459
2020,712900151,68520,3120,3120,3120,0,65400,65000,65000,0,0,400,0,400,0,20000,20000,20000,0,2340,360,180,140,180,102
2020,712900161,65500,500,500,500,0,65000,65000,65000,0,0,0,0,0,0,9216,9216,9216,0,926,360,50,10,36,66
2020,712900191,1406,1180,680,680,500,226,0,0,0,0,226,0,226,0,3200,3200,0,0,3854,660,60,800,240,48
2020,712900211,52202,3202,3202,3202,0,49000,49000,49000,0,0,0,0,0,0,5000,0,0,0,3500,200,100,300,280,35
2020,712900221,46780,8460,8460,8460,0,38320,37000,37000,0,0,1320,600,720,0,14840,14840,2790,12000,4280,240,240,360,240,462
2020,712900241,16506,606,606,606,0,15900,15000,15000,0,0,900,900,0,0,0,0,0,0,2844,136,1730,100,60,33
2020,712900261,10758,458,458,458,0,10300,10000,10000,0,0,300,200,100,0,480,480,480,0,1690,240,30,180,240,16
2020,712900271,18344,344,344,344,0,18000,18000,18000,0,0,0,0,0,0,40,40,0,0,1020,180,240,50,30,50
2020,712900301,85076,5559,5559,5559,0,79517,72000,72000,0,0,7517,7517,0,0,33514,33514,28000,5514,6350,400,50,500,400,917
2020,712900311,44248,18428,18428,18428,0,25820,24700,23000,1700,0,1120,1120,0,0,5400,5400,5400,0,4330,360,80,400,280,180
2020,712900321,19794,2794,2794,2794,0,17000,17000,17000,0,0,0,0,0,0,0,0,0,0,1110,160,10,70,50,53
2020,712900331,49630,4030,4030,4030,0,45600,42000,42000,0,0,3600,3600,0,0,0,0,0,0,3350,320,240,360,500,304
2020,712900341,40609,2459,2459,2459,0,38150,38000,38000,0,0,150,150,0,0,7661,7661,5706,1955,4800,150,50,400,180,410
2020,712900361,550,550,50,50,500,0,0,0,0,0,0,0,0,0,0,0,0,0,662,200,25,20,17,0
2020,712900371,250,250,250,250,0,0,0,0,0,0,0,0,0,0,0,0,0,0,596,120,50,48,23,1
2020,712900381,71703,8703,8703,8703,0,63000,60000,60000,0,0,3000,3000,0,0,0,0,0,0,3170,400,50,300,240,1829
2020,712900391,62550,750,750,750,0,61800,60000,60000,0,0,1800,1800,0,0,5500,5500,5500,0,4410,360,50,100,400,365
2020,713000112,78184,32434,32434,32434,0,45750,45000,45000,0,0,750,400,350,0,0,0,0,0,3370,250,50,300,240,847
2020,713000122,40678,5678,5678,5678,0,35000,35000,35000,0,0,0,0,0,0,0,0,0,0,4220,360,600,190,270,213
2020,713000132,31960,960,960,960,0,31000,31000,31000,0,0,0,0,0,0,0,0,0,0,2650,180,150,50,120,62
2020,713000152,2446,2246,246,246,2000,200,0,0,0,0,200,200,0,0,2000,2000,0,2000,2355,340,40,600,120,0
2020,713000162,118200,17700,17700,17700,0,100500,100000,100000,0,0,500,500,0,0,19000,0,0,0,4430,840,120,420,120,334
2020,713000172,4714,3014,1014,1014,2000,1700,0,0,0,0,1700,1700,0,0,0,0,0,0,3000,960,40,250,100,42
2020,713000182,79540,17580,17580,17580,0,61960,60000,60000,0,0,1960,1960,0,0,0,0,0,0,3936,368,150,565,209,187
2020,713000192,17340,2340,2340,2340,0,15000,15000,15000,0,0,0,0,0,0,20,20,0,0,2560,216,720,60,264,11
2020,713000202,25073,3411,3411,3411,0,21662,21300,21300,0,0,362,0,362,0,0,0,0,0,1840,144,144,240,42,48
2020,713000222,18010,10,10,10,0,18000,18000,18000,0,0,0,0,0,0,0,0,0,0,832,120,60,84,48,38
2020,713000242,2640,2140,1840,1840,300,500,0,0,0,0,500,500,0,0,0,0,0,0,1970,396,20,120,84,27
2020,713000262,2120,2120,120,120,2000,0,0,0,0,0,0,0,0,0,3168,3168,0,2168,2389,879,60,240,30,11
2020,713000302,2155,2055,55,55,2000,100,0,0,0,0,100,100,0,0,2350,2350,1800,250,2065,485,30,360,200,14
2020,713000322,17580,580,580,580,0,17000,17000,17000,0,0,0,0,0,0,0,0,0,0,500,115,22,24,36,12
2020,713000342,37850,200,200,200,0,37650,37500,7500,30000,0,150,150,0,0,0,0,0,0,1906,980,18,200,78,31
2020,713000352,21999,3699,3699,3699,0,18300,18000,18000,0,0,300,300,0,0,200,200,200,0,5354,264,120,300,420,158
2020,713000362,74650,13950,13950,13950,0,60700,35000,35000,0,0,25700,2700,23000,0,31500,31500,31000,0,7438,840,20,1040,600,158
2020,713000372,33176,8902,8902,8902,0,24274,23000,23000,0,0,1274,980,294,0,1879,1879,1753,0,2146,324,180,240,240,282
2020,713600111,217457,23717,23717,23717,0,193740,191440,40000,151440,0,2300,1300,1000,0,3160,3160,0,3160,4506,480,394,290,190,659
2020,713600121,35600,4000,4000,4000,0,31600,30000,30000,0,0,1600,1600,0,0,0,0,0,0,2164,240,36,30,114,322
2020,713600131,11890,2490,2490,2490,0,9400,9000,9000,0,0,400,400,0,0,0,0,0,0,1335,120,80,160,95,28
2020,713600141,20120,20120,4620,4620,15500,0,0,0,0,0,0,0,0,0,0,0,0,0,1736,156,30,230,150,298
2020,713600151,1015,1015,15,15,1000,0,0,0,0,0,0,0,0,0,14200,14200,0,7700,3134,700,80,160,360,1
2020,713600171,30634,30384,7384,7384,23000,250,0,0,0,0,250,250,0,0,0,0,0,0,2924,140,20,336,168,212
2020,713600201,47120,9900,9900,9900,0,37220,37000,37000,0,0,220,100,120,0,3000,0,0,0,2160,120,100,620,140,116
2020,713600221,244,244,4,4,240,0,0,0,0,0,0,0,0,0,0,0,0,0,653,108,48,36,36,0
2020,713600241,108040,27440,27440,27440,0,80600,80000,30000,50000,0,600,300,300,0,2050,1550,1500,0,5556,426,500,450,780,558
2020,713600251,54432,7232,7232,7232,0,47200,45000,45000,0,0,2200,2200,0,0,17600,17600,17600,0,2750,300,200,300,240,1188
2020,713600261,71100,1100,1100,1100,0,70000,70000,70000,0,0,0,0,0,0,0,0,0,0,870,80,50,60,50,110
2020,713600301,19083,4533,4533,4533,0,14550,14200,14200,0,0,350,350,0,0,3100,3100,3000,0,3648,249,130,300,480,34
2020,713600321,13610,13610,7110,7110,6500,0,0,0,0,0,0,0,0,0,160,160,0,0,2270,120,30,240,180,6
2020,713600351,510,510,10,10,500,0,0,0,0,0,0,0,0,0,0,0,0,0,789,430,60,15,20,2
2020,713600371,4900,3000,0,0,3000,1900,0,0,0,0,1900,1900,0,0,11370,11370,0,5370,5280,1080,360,480,300,47
2020,713600381,26512,8512,8512,8512,0,18000,18000,18000,0,0,0,0,0,0,7281,7281,7281,0,2100,240,200,240,160,85
2020,713600391,210,210,10,10,200,0,0,0,0,0,0,0,0,0,0,0,0,0,690,300,15,10,30,1
2020,713700111,119066,32366,32366,32366,0,86700,85000,85000,0,0,1700,1000,700,0,0,0,0,0,3870,240,200,120,180,289
2020,713700131,892,892,392,392,500,0,0,0,0,0,0,0,0,0,0,0,0,0,2601,445,50,36,450,1
2020,713700141,39878,13798,13798,13798,0,26080,26000,26000,0,0,80,80,0,0,1280,1280,1280,0,1690,180,30,150,180,168
2020,713700151,35282,34401,5401,5401,29000,881,0,0,0,0,881,542,339,0,16581,16581,16500,0,2999,279,70,360,240,296
2020,713700171,3940,3860,860,860,3000,80,0,0,0,0,80,80,0,0,0,0,0,0,1686,360,120,120,240,40
2020,713700181,46200,11200,200,200,11000,35000,35000,0,35000,0,0,0,0,0,23000,0,0,0,760,120,120,36,24,43
2020,713700191,34197,33497,33497,3497,0,700,0,0,0,0,700,700,0,0,100,100,0,0,5080,420,60,720,240,695
2020,713700201,26179,25329,1329,1089,24000,850,0,0,0,0,850,850,0,0,10000,10000,0,10000,2917,300,30,65,132,328
2020,713700211,37095,5895,5895,5895,0,31200,27000,27000,0,0,4200,4000,200,0,900,900,0,900,5084,240,24,600,360,104
2020,713700221,37094,5044,5044,1044,0,32050,30000,30000,0,0,2050,450,1600,0,21040,21040,19840,1000,2682,156,200,200,276,102
2020,713700231,24414,13414,4414,4414,9000,11000,11000,0,11000,0,0,0,0,0,3500,3000,3000,0,1444,420,120,20,36,17
2020,713700241,11352,11002,5002,5002,6000,350,0,0,0,0,350,350,0,0,0,0,0,0,1689,600,60,35,144,32
2020,713700261,20310,310,310,310,0,20000,20000,20000,0,0,0,0,0,0,700,0,0,0,900,80,150,50,60,60
2020,713700321,39178,6878,6878,6878,0,32300,29000,14000,8000,7000,3300,3300,0,0,500,500,500,0,4426,656,60,800,300,532
2020,713700331,5368,5368,3368,3368,2000,0,0,0,0,0,0,0,0,0,0,0,0,0,1900,750,20,28,72,3
2020,713700351,11120,120,120,120,0,11000,11000,11000,0,0,0,0,0,0,2100,2100,2100,0,2746,156,125,80,40,12
2020,713700361,18000,16970,12170,12170,4800,1030,0,0,0,0,1030,1030,0,0,4150,4150,600,1700,4906,160,180,150,276,48
2020,713700381,3756,2756,1756,1756,1000,1000,0,0,0,0,1000,0,1000,0,0,0,0,0,1315,816,10,15,84,7
2020,713700391,4008,3608,3308,3308,300,400,0,0,0,0,400,400,0,0,0,0,0,0,2470,600,1000,144,96,68
2020,713800111,800,800,800,800,0,0,0,0,0,0,0,0,0,0,0,0,0,0,1140,150,120,110,140,24
2020,713800121,4738,4738,1738,1738,3000,0,0,0,0,0,0,0,0,0,14,14,0,0,891,100,18,100,90,0
2020,713800131,4480,4480,1180,1180,3300,0,0,0,0,0,0,0,0,0,0,0,0,0,724,144,60,10,50,3
2020,713800151,35700,100,100,100,0,35600,35000,35000,0,0,600,600,0,0,10870,10870,9500,1330,1458,360,40,120,108,51
2020,713800171,16950,16950,1950,1950,15000,0,0,0,0,0,0,0,0,0,20,20,0,0,1914,200,30,100,240,4
2020,713800191,10830,10030,2030,2030,8000,800,0,0,0,0,800,0,800,0,0,0,0,0,1590,60,40,500,140,95
2020,713800211,10392,10380,3380,3380,7000,12,0,0,0,0,12,0,12,0,7130,7130,7000,0,1777,474,15,108,131,1
2020,713800221,94592,20092,20092,20092,0,74500,71000,63000,0,8000,3500,3000,500,0,15200,15200,0,15000,7220,600,120,150,420,2065
2020,713800231,39992,8042,8042,8042,0,31950,30000,30000,0,0,1950,1800,150,0,0,0,0,0,3360,400,450,360,170,63
2020,713800301,133700,81196,81196,77796,0,52504,52000,52000,0,0,504,30,474,0,0,0,0,0,1772,284,150,120,42,115
2020,713800311,87100,48300,28300,28300,20000,38800,35000,0,35000,0,3800,3800,0,0,1500,0,0,0,3300,200,300,120,80,903
2020,713800321,9498,9448,2948,2948,6500,50,0,0,0,0,50,50,0,0,0,0,0,0,1867,180,60,420,144,174
2020,713800331,2236,2145,1145,1145,1000,91,0,0,0,0,91,0,91,0,0,0,0,0,1765,684,32,50,120,1
2020,713800341,34000,2000,2000,2000,0,32000,17000,17000,0,0,15000,10000,4000,1000,13700,13700,11000,0,3444,360,20,480,420,203
2020,713800361,39600,2100,2100,1100,0,37500,31500,31500,0,0,6000,0,0,6000,17679,17679,14384,3295,2339,366,120,180,192,75
2020,713800381,3750,3750,750,750,3000,0,0,0,0,0,0,0,0,0,0,0,0,0,3046,492,30,60,180,4
2020,713800391,46151,10016,10016,9016,0,36135,31000,31000,0,0,5135,3000,135,2000,17156,17156,13186,2000,4571,225,150,480,456,547
2020,713900101,22588,438,438,438,0,22150,22000,22000,0,0,150,150,0,0,13250,13250,13250,0,2650,200,30,450,280,302
2020,713900111,88852,8252,8252,8252,0,80600,80000,80000,0,0,600,600,0,0,30000,30000,27000,3000,3696,216,100,360,220,560
2020,713900121,110420,2420,2420,2420,0,108000,105000,35000,70000,0,3000,3000,0,0,20000,0,0,0,3870,420,100,400,150,1192
2020,713900131,15530,15230,1230,1230,14000,300,0,0,0,0,300,300,0,0,0,0,0,0,2294,310,50,180,120,24
2020,713900151,5200,5200,700,700,4500,0,0,0,0,0,0,0,0,0,0,0,0,0,1974,144,50,200,200,42
2020,713900161,93804,23804,10804,10804,13000,70000,70000,0,70000,0,0,0,0,0,3000,0,0,0,2576,150,20,72,84,286
2020,713900171,45164,9764,9764,9764,0,35400,35000,35000,0,0,400,400,0,0,250,250,0,0,2100,180,50,150,360,87
2020,713900201,3008,3008,1208,1208,1800,0,0,0,0,0,0,0,0,0,38,38,0,0,2310,500,20,360,120,1
2020,713900211,99823,13100,13100,13100,0,86723,85000,85000,0,0,1723,1610,113,0,0,0,0,0,4048,560,115,216,132,164
2020,713900221,7715,5385,5385,2385,0,2330,0,0,0,0,2330,1000,1330,0,0,0,0,0,7050,864,10,340,312,313
2020,713900231,87610,22610,22610,22110,0,65000,58000,38000,20000,0,7000,7000,0,0,0,0,0,0,3280,326,200,540,144,480
2020,713900251,3386,3386,386,386,3000,0,0,0,0,0,0,0,0,0,200,200,200,0,583,204,24,30,35,1
2020,713900261,35530,7530,7530,7530,0,28000,26000,26000,0,0,2000,2000,0,0,14000,14000,13000,1000,6010,350,200,600,520,617
2020,713900301,292,292,92,92,200,0,0,0,0,0,0,0,0,0,0,0,0,0,638,107,20,10,27,1
2020,713900321,4442,4442,4442,4442,0,0,0,0,0,0,0,0,0,0,1550,1550,1400,0,9964,144,8000,240,480,13
2020,713900331,5730,4920,2920,2920,2000,810,0,0,0,0,810,810,0,0,2590,2590,890,0,1833,660,50,165,108,33
2020,713900341,120,120,20,20,100,0,0,0,0,0,0,0,0,0,800,800,0,0,1212,396,0,60,72,1
2020,713900371,14564,13364,9364,9364,4000,1200,0,0,0,0,1200,1200,0,0,50,50,0,0,2695,96,800,360,180,20
2020,713900381,3624,2634,2134,1734,500,990,0,0,0,0,990,950,40,0,5655,5655,0,4005,5146,840,40,180,396,316
2020,713900391,42380,40880,5880,5880,35000,1500,0,0,0,0,1500,1500,0,0,0,0,0,0,2520,360,120,240,240,78
2020,714000102,19900,500,500,500,0,19400,19400,19400,0,0,0,0,0,0,3850,3850,3850,0,1471,104,60,108,96,20
2020,714000112,92990,44490,12490,3590,32000,48500,46000,0,46000,0,2500,1000,1500,0,39500,15500,9000,6500,4350,1050,180,240,240,418
2020,714000122,206940,5740,5740,5740,0,201200,200000,200000,0,0,1200,1200,0,0,0,0,0,0,1946,360,40,360,180,903
2020,714000152,207820,51820,51820,38820,0,156000,150000,150000,0,0,6000,6000,0,0,33950,33950,33000,0,6350,600,200,150,300,1181
2020,714000172,346966,9410,9410,2910,0,337556,335000,35000,300000,0,2556,556,0,2000,49100,43100,35300,7800,2706,1056,200,300,150,1358
2020,714000182,40010,5010,2010,2010,3000,35000,35000,0,35000,0,0,0,0,0,35,35,0,0,1306,600,130,50,24,1
2020,714000192,12880,12880,2880,2880,10000,0,0,0,0,0,0,0,0,0,10134,10134,10000,0,1120,50,5,75,62,1
2020,714000312,8340,2840,2840,2840,0,5500,5500,5500,0,0,0,0,0,0,0,0,0,0,980,120,20,0,60,16
2020,714000322,6121,5221,1221,721,4000,900,0,0,0,0,900,900,0,0,950,950,0,900,3768,1176,60,552,156,27
2020,714000332,5100,3720,2720,1220,1000,1380,0,0,0,0,1380,580,300,500,0,0,0,0,3117,962,50,120,240,25
2020,714000342,422,422,122,122,300,0,0,0,0,0,0,0,0,0,5400,5400,0,400,2678,564,17,300,78,86
2020,714000352,22750,21994,3994,3994,18000,756,0,0,0,0,756,556,200,0,8203,8203,8000,0,4723,242,107,361,365,56
2020,714000362,72102,41602,18602,11552,23000,30500,28500,0,28500,0,2000,2000,0,0,2000,0,0,0,4210,190,10,600,250,1216
2020,714000372,1052,1052,52,52,1000,0,0,0,0,0,0,0,0,0,2120,2120,0,2120,2213,905,54,121,72,27
2020,714000392,56446,1246,1246,1246,0,55200,55000,30000,25000,0,200,200,0,0,19000,0,0,0,3407,284,75,151,245,113
2020,714600101,99020,13420,13420,13420,0,85600,85000,85000,0,0,600,600,0,0,0,0,0,0,6570,420,100,250,180,2641
2020,714600111,59340,4340,4340,4340,0,55000,55000,55000,0,0,0,0,0,0,0,0,0,0,2626,282,120,370,204,901
2020,714600141,20120,120,120,120,0,20000,20000,20000,0,0,0,0,0,0,3500,3500,3500,0,1125,210,120,60,65,33
2020,714600151,49500,1500,1500,1500,0,48000,48000,48000,0,0,0,0,0,0,3000,0,0,0,949,471,120,36,34,283
2020,714600181,473180,1080,1080,1080,0,472100,472000,300000,172000,0,100,100,0,0,16000,0,0,0,2040,320,200,100,120,1928
2020,714600191,180511,111111,39111,39111,72000,69400,63000,0,63000,0,6400,6400,0,0,0,0,0,0,4170,400,50,240,140,2433
2020,714600331,27120,5120,5120,5120,0,22000,22000,22000,0,0,0,0,0,0,0,0,0,0,3346,300,350,20,54,36
2020,714600371,118280,28280,28280,8280,0,90000,80000,80000,0,0,10000,0,10000,0,72950,72950,63800,0,4670,350,50,350,300,104
2020,714600381,40325,4154,4154,4154,0,36171,36000,26000,10000,0,171,0,171,0,0,0,0,0,895,120,0,100,105,259
2020,714600391,5500,1500,1500,1500,0,4000,4000,4000,0,0,0,0,0,0,0,0,0,0,510,160,120,0,80,6
2020,714700111,5920,5420,1120,1120,4300,500,0,0,0,0,500,500,0,0,0,0,0,0,1310,130,300,200,30,5
2020,714700151,63080,11030,11030,11030,0,52050,52000,52000,0,0,50,0,50,0,0,0,0,0,1115,240,60,70,72,45
2020,714700181,132283,213,213,213,0,132070,131000,131000,0,0,1070,1070,0,0,54500,14500,4500,0,1850,120,720,160,276,151
2020,714700311,98571,4431,4431,4431,0,94140,93000,23000,70000,0,1140,140,1000,0,0,0,0,0,3402,216,1005,144,123,150
2020,714700341,160175,49175,39175,36175,10000,111000,98000,0,98000,0,13000,2800,200,10000,34000,30000,30000,0,4700,1500,300,500,400,315
2020,714700371,191048,91948,41948,31948,50000,99100,78000,0,78000,0,21100,9200,11900,0,19500,0,0,0,8240,960,300,700,180,1925
2020,714700391,13107,1380,1380,1380,0,11727,11000,11000,0,0,727,600,127,0,4996,4996,4896,0,1800,170,42,480,204,36
2020,714800101,72410,7360,7360,7360,0,65050,65000,65000,0,0,50,50,0,0,12950,12950,11600,1350,2550,360,350,150,300,920
2020,714800131,15715,15200,5700,5700,9500,515,0,0,0,0,515,15,500,0,0,0,0,0,2455,288,37,240,180,150
2020,714800141,380,380,230,230,150,0,0,0,0,0,0,0,0,0,0,0,0,0,920,138,15,0,42,0
2020,714800151,238,170,20,20,150,68,0,0,0,0,68,0,68,0,0,0,0,0,692,102,60,10,10,0
2020,714800161,12248,12248,2248,2248,10000,0,0,0,0,0,0,0,0,0,0,0,0,0,2670,660,30,264,96,1
2020,714800171,18343,18343,12459,12459,5884,0,0,0,0,0,0,0,0,0,0,0,0,0,1165,127,125,149,71,27
2020,714800181,2683,2560,260,260,2300,123,0,0,0,0,123,100,23,0,4684,4684,384,1300,1930,440,100,50,120,0
2020,714800301,38442,6642,6642,6642,0,31800,31000,31000,0,0,800,800,0,0,0,0,0,0,2538,264,500,410,204,168
2020,714800311,70744,12044,12044,12044,0,58700,58000,50000,0,8000,700,700,0,0,12700,12700,12700,0,3889,410,158,450,270,257
2020,714800321,5106,4546,546,546,4000,560,0,0,0,0,560,500,60,0,0,0,0,0,3000,313,360,180,280,232
2020,714800341,27372,372,372,372,0,27000,23000,23000,0,0,4000,2000,1000,1000,8910,8910,8700,0,1832,276,200,240,48,108
2020,714900111,26760,10960,5960,5960,5000,15800,15000,0,15000,0,800,800,0,0,3200,1200,0,1200,2750,660,50,600,300,67
2020,714900121,109545,23845,23845,23845,0,85700,85000,85000,0,0,700,700,0,0,0,0,0,0,6060,420,200,250,250,3337
2020,714900161,6150,6150,150,150,6000,0,0,0,0,0,0,0,0,0,0,0,0,0,620,50,60,0,18,1
2020,714900191,24720,21120,1120,1120,20000,3600,0,0,0,0,3600,3600,0,0,13700,13700,9000,1000,2164,180,120,180,144,364
2020,714900311,90550,29050,29050,29050,0,61500,60000,60000,0,0,1500,1500,0,0,0,0,0,0,1981,288,36,156,65,175
2020,714900341,38300,1800,1800,1800,0,36500,32500,21500,11000,0,4000,4000,0,0,19585,18585,18500,0,6000,250,1800,600,250,180
2020,714900361,370120,20,20,20,0,370100,368000,68000,300000,0,2100,0,2100,0,10000,0,0,0,1800,276,300,180,50,241
2020,714900371,31611,3111,3111,3111,0,28500,28500,28500,0,0,0,0,0,0,5626,5626,5626,0,2793,308,250,600,183,33
2020,714900381,33800,700,700,700,0,33100,31000,25000,6000,0,2100,300,1800,0,300,0,0,0,1794,360,120,120,144,72
2020,714900391,15888,112,112,112,0,15776,14000,9000,5000,0,1776,1376,400,0,300,0,0,0,3940,300,1200,780,240,101
2020,715000102,17460,16960,1960,1960,15000,500,0,0,0,0,500,500,0,0,80,80,0,0,3237,761,400,444,180,51
2020,715000122,146277,33277,33277,33277,0,113000,108000,33000,75000,0,5000,5000,0,0,62750,62000,60000,2000,3064,300,12,480,96,1275
2020,715000132,233400,53200,10200,10200,43000,180200,180000,0,180000,0,200,200,0,0,115500,39000,39000,0,2700,420,100,100,120,852
2020,715000142,89323,4323,4323,4323,0,85000,85000,70000,15000,0,0,0,0,0,1670,170,0,0,2191,420,50,10,68,124
2020,715000152,780,330,130,130,200,450,0,0,0,0,450,450,0,0,0,0,0,0,555,108,300,10,30,11
2020,715000162,174980,25980,25980,23980,0,149000,140000,140000,0,0,9000,3500,5500,0,7350,7350,6000,0,4911,480,20,324,186,477
2020,715000172,2336,2336,1336,1336,1000,0,0,0,0,0,0,0,0,0,0,0,0,0,385,80,10,50,60,3
2020,715000192,786,536,36,36,500,250,0,0,0,0,250,250,0,0,0,0,0,0,2487,624,500,216,227,62
2020,715000302,33088,10938,10938,10938,0,22150,22000,22000,0,0,150,150,0,0,2000,2000,2000,0,3110,212,150,360,144,189
2020,715000312,20920,19120,1120,1120,18000,1800,0,0,0,0,1800,1800,0,0,15000,15000,15000,0,3550,300,50,960,360,191
2020,715000322,4165,4165,2165,2165,2000,0,0,0,0,0,0,0,0,0,0,0,0,0,3876,270,250,336,344,85
2020,715000342,29900,25600,1600,1600,24000,4300,3500,0,0,3500,800,800,0,0,18100,18100,18100,0,3630,360,50,120,240,96
2020,715000352,22588,4878,4878,3878,0,17710,14500,14500,0,0,3210,3210,0,0,10300,10300,8800,0,3378,324,70,240,144,161
2020,715000362,19050,1050,1050,1050,0,18000,18000,18000,0,0,0,0,0,0,0,0,0,0,707,190,120,15,42,16
2020,715000372,25698,25048,20548,20548,4500,650,0,0,0,0,650,650,0,0,0,0,0,0,2729,84,400,480,40,67
2020,715000392,8480,8480,480,480,8000,0,0,0,0,0,0,0,0,0,10450,10450,6400,4050,566,66,10,81,120,206
2020,715600111,89000,1500,1500,1500,0,87500,85000,85000,0,0,2500,2500,0,0,1100,1100,0,0,1919,420,15,200,144,140
2020,715600141,793,748,748,748,0,45,0,0,0,0,45,0,45,0,140,140,140,0,285,63,12,10,20,1
2020,715600151,97887,16487,6487,3487,10000,81400,0,0,0,0,81400,400,81000,0,22100,22100,20000,0,5159,240,5,480,240,61
2020,715600161,40200,37806,13806,13806,24000,2394,0,0,0,0,2394,1700,694,0,1000,1000,1000,0,3806,102,60,240,444,1093
2020,715600181,2306,2306,37,37,2269,0,0,0,0,0,0,0,0,0,0,0,0,0,392,107,200,0,37,1
2020,715600191,9840,9540,6990,6990,2550,300,0,0,0,0,300,300,0,0,450,450,0,0,5220,240,2800,300,230,97
2020,715600301,98453,5453,5453,4453,0,93000,87000,32000,55000,0,6000,6000,0,0,46524,23524,21324,2200,7020,360,1200,200,360,2669
2020,715600361,3903,3003,2403,2403,600,900,0,0,0,0,900,900,0,0,0,0,0,0,2523,518,15,325,86,45
2020,715600371,21010,20110,13110,6110,7000,900,0,0,0,0,900,600,300,0,15000,15000,5000,0,2533,243,25,484,244,265
2020,715600381,42358,9288,9288,9288,0,33070,33000,33000,0,0,70,70,0,0,11350,11350,11350,0,3209,305,320,260,264,227
2020,715600391,88755,18505,18505,18505,0,70250,70000,70000,0,0,250,250,0,0,0,0,0,0,3498,600,240,120,198,175
2020,715700121,61849,48650,23650,23650,25000,13199,12999,0,12999,0,200,200,0,0,0,0,0,0,4336,180,200,200,200,98
2020,715700141,76600,13100,13100,13100,0,63500,62200,62200,0,0,1300,1300,0,0,0,0,0,0,3320,120,660,180,140,578
2020,715700171,48360,3060,3060,3060,0,45300,45000,45000,0,0,300,300,0,0,20000,20000,17000,3000,3581,1284,60,240,173,167
2020,715700181,233800,32300,32300,32300,0,201500,200000,150000,50000,0,1500,1500,0,0,20000,0,0,0,3610,360,20,300,280,4153
2020,715700191,3700,3700,200,200,3500,0,0,0,0,0,0,0,0,0,0,0,0,0,603,125,84,20,24,1
2020,715700321,73845,7145,7145,7145,0,66700,60000,60000,0,0,6700,6500,200,0,33372,33372,27000,0,6100,290,100,420,288,1768
2020,715700341,62305,34155,34155,31055,0,28150,28000,28000,0,0,150,150,0,0,0,0,0,0,1936,240,410,150,156,524
2020,715700361,12545,50,50,50,0,12495,12495,10800,1695,0,0,0,0,0,3500,0,0,0,390,120,40,20,20,18
2020,715700391,183110,28310,13310,10810,15000,154800,153000,0,153000,0,1800,1800,0,0,92500,61000,61000,0,3680,150,40,300,120,299
2020,715800101,62098,2098,2098,2098,0,60000,60000,60000,0,0,0,0,0,0,1000,1000,0,0,2490,420,900,60,120,91
2020,715800111,89204,8754,8754,8754,0,80450,73000,60000,0,13000,7450,450,0,7000,0,0,0,0,2280,420,150,840,90,82
2020,715800121,2306,2306,306,306,2000,0,0,0,0,0,0,0,0,0,3300,3300,2000,600,1163,287,12,240,144,1
2020,715800141,72030,4030,4030,4030,0,68000,68000,68000,0,0,0,0,0,0,2200,0,0,0,778,120,120,110,38,221
2020,715800161,152424,7724,7724,7724,0,144700,140000,120000,20000,0,4700,1700,3000,0,20186,186,0,0,2296,396,550,300,240,765
2020,715800171,24760,1860,1860,1860,0,22900,22000,22000,0,0,900,900,0,0,4300,4300,0,4000,3570,300,10,480,180,217
2020,715800301,200595,6195,6195,6195,0,194400,190000,80000,110000,0,4400,1000,3400,0,16800,13800,12500,1300,4220,500,300,300,120,289
2020,715800321,33420,620,620,620,0,32800,32000,24000,8000,0,800,800,0,0,1870,1870,1870,0,2194,400,50,150,70,86
2020,715800341,200,200,200,200,0,0,0,0,0,0,0,0,0,0,0,0,0,0,614,156,240,36,36,1
2020,715800361,3364,2064,1864,1864,200,1300,0,0,0,0,1300,1300,0,0,300,300,0,0,2900,500,240,600,120,52
2020,715800381,27910,4660,4660,4660,0,23250,23000,23000,0,0,250,250,0,0,0,0,0,0,1473,220,200,256,84,48
2020,715900101,73990,13990,13990,13990,0,60000,60000,60000,0,0,0,0,0,0,19000,19000,19000,0,3096,188,128,264,132,44
2020,715900131,154023,20355,8355,8355,12000,133668,132000,0,132000,0,1668,1600,68,0,53078,29578,15000,14578,2543,149,224,202,68,639
2020,715900141,68900,5300,5300,5300,0,63600,63600,63600,0,0,0,0,0,0,34300,0,0,0,1226,324,240,36,96,77
2020,715900151,10900,10800,1200,1200,9600,100,0,0,0,0,100,100,0,0,7000,7000,6000,0,1895,120,240,630,60,66
2020,715900171,2800,2800,50,50,2750,0,0,0,0,0,0,0,0,0,0,0,0,0,708,120,400,10,48,1
2020,715900181,28240,3240,3240,3240,0,25000,25000,25000,0,0,0,0,0,0,2960,2960,2960,0,2806,216,150,110,150,48
2020,715900311,38918,11318,11318,11318,0,27600,26000,26000,0,0,1600,1200,400,0,10150,10150,10150,0,3040,500,420,240,360,239
2020,715900341,30000,1000,1000,1000,0,29000,29000,29000,0,0,0,0,0,0,17000,13000,13000,0,2340,180,240,480,120,56
2020,715900351,53,53,53,53,0,0,0,0,0,0,0,0,0,0,0,0,0,0,1390,240,800,60,48,1
2020,715900361,19973,1940,1940,1940,0,18033,18000,18000,0,0,33,0,33,0,0,0,0,0,872,180,12,6,18,23
2020,715900371,8280,8280,280,280,8000,0,0,0,0,0,0,0,0,0,0,0,0,0,1270,200,30,100,120,1
2020,715900381,50700,15700,15700,15700,0,35000,35000,35000,0,0,0,0,0,0,0,0,0,0,1385,250,5,300,120,607
2020,716000102,65630,1200,1200,1200,0,64430,63000,63000,0,0,1430,1430,0,0,22500,0,0,0,1344,300,36,180,152,130
2020,716000112,1160,1010,10,10,1000,150,0,0,0,0,150,150,0,0,0,0,0,0,2146,360,200,240,156,21
2020,716000122,41830,830,830,830,0,41000,41000,20000,21000,0,0,0,0,0,3700,700,0,500,2244,120,1200,144,120,113
2020,716000142,21504,21504,3504,3504,18000,0,0,0,0,0,0,0,0,0,3000,3000,0,0,2000,240,30,120,100,771
2020,716000152,15210,13210,3210,3210,10000,2000,0,0,0,0,2000,2000,0,0,0,0,0,0,5940,600,1000,240,480,620
2020,716000162,28310,28310,310,310,28000,0,0,0,0,0,0,0,0,0,17400,17400,9400,8000,1037,240,10,120,72,216
2020,716000172,11010,11010,1510,1510,9500,0,0,0,0,0,0,0,0,0,1000,1000,0,1000,1370,120,10,30,120,21
2020,716000312,5500,5500,3000,3000,2500,0,0,0,0,0,0,0,0,0,0,0,0,0,559,138,40,36,60,2
2020,716000322,49884,39184,8184,3184,31000,10700,0,0,0,0,10700,700,10000,0,30000,30000,0,30000,7725,360,5,600,300,2624
2020,716000332,129310,5310,5310,5310,0,124000,124000,44000,80000,0,0,0,0,0,0,0,0,0,3889,324,1000,300,360,149
2020,716000342,103815,17565,17565,17565,0,86250,85250,56000,29250,0,1000,1000,0,0,8900,8900,8900,0,5130,360,200,400,250,161
2020,716000352,159100,37400,37400,37400,0,121700,120500,51000,69500,0,1200,1200,0,0,37200,5700,0,5700,9760,650,450,370,250,16177
2020,716000362,169500,1500,1500,1500,0,168000,167000,75000,92000,0,1000,1000,0,0,4000,0,0,0,2010,360,10,120,120,146
2020,716600111,17867,17477,5477,5477,12000,390,0,0,0,0,390,310,80,0,6130,6130,6000,0,3248,440,240,190,288,46
2020,716600121,67530,1030,1030,1030,0,66500,66500,66000,500,0,0,0,0,0,1000,0,0,0,953,138,96,10,73,44
2020,716600131,20376,376,376,376,0,20000,20000,20000,0,0,0,0,0,0,5880,5880,5880,0,2404,114,360,168,222,60
2020,716600141,30714,3414,3414,3414,0,27300,26000,26000,0,0,1300,1300,0,0,5000,5000,3500,0,1762,196,36,36,96,118
2020,716600151,78210,15210,15210,15210,0,63000,63000,60000,3000,0,0,0,0,0,0,0,0,0,3580,240,50,120,120,2026
2020,716600161,52400,20400,400,400,20000,32000,30000,0,30000,0,2000,2000,0,0,5500,2500,0,2500,3418,580,12,180,56,243
2020,716600171,110444,20444,20444,20444,0,90000,90000,90000,0,0,0,0,0,0,0,0,0,0,2144,300,150,50,144,101
2020,716600191,386350,11350,11350,11350,0,375000,375000,75000,300000,0,0,0,0,0,159250,124250,124250,0,5820,360,100,200,360,1299
2020,716600311,184124,14124,14124,14124,0,170000,120000,120000,0,0,50000,7500,12500,30000,45000,40000,40000,0,6010,360,240,360,400,1109
2020,716600321,79415,2715,2715,2715,0,76700,70000,40000,30000,0,6700,6000,700,0,20000,2000,0,0,3423,287,95,154,125,102
2020,716600331,87707,5357,5357,5357,0,82350,81000,41000,40000,0,1350,1350,0,0,18800,18800,18800,0,3411,512,114,410,245,716
2020,716600361,83109,1439,1439,1439,0,81670,81000,36000,45000,0,670,670,0,0,150,150,0,150,1644,300,30,180,288,221
2020,716600391,37210,7110,7110,7110,0,30100,28000,28000,0,0,2100,2100,0,0,13340,13340,13200,0,5950,300,70,700,300,355
2020,716700101,3354,3354,354,354,3000,0,0,0,0,0,0,0,0,0,2150,2150,1600,0,628,94,120,10,24,0
2020,716700111,4755,4655,155,155,4500,100,0,0,0,0,100,0,100,0,200,200,200,0,1162,75,10,144,43,0
2020,716700171,21778,16528,4528,4528,12000,5250,4950,0,4950,0,300,300,0,0,4800,4800,3000,1800,4952,960,12,360,180,1275
2020,716700311,109989,28389,28389,23389,0,81600,80000,80000,0,0,1600,1600,0,0,3000,3000,3000,0,4630,300,10,480,240,911
2020,716700331,49300,16000,16000,16000,0,33300,32000,32000,0,0,1300,1300,0,0,0,0,0,0,4150,420,150,500,440,342
2020,716700341,42648,2448,2448,2448,0,40200,40000,40000,0,0,200,200,0,0,22700,22700,21200,1000,3350,600,300,400,300,1985
2020,716700391,19380,13580,7580,6580,6000,5800,5000,0,5000,0,800,800,0,0,4000,4000,4000,0,2188,1080,20,288,120,335
2020,716800121,2550,2500,1500,1500,1000,50,0,0,0,0,50,50,0,0,0,0,0,0,5139,1320,36,400,323,62
2020,716800131,93937,1577,1577,1577,0,92360,92000,92000,0,0,360,360,0,0,10150,10150,10000,0,3900,200,100,150,180,978
2020,716800141,17496,17496,13996,13996,3500,0,0,0,0,0,0,0,0,0,0,0,0,0,1259,332,10,60,72,62
2020,716800151,460,460,260,260,200,0,0,0,0,0,0,0,0,0,0,0,0,0,3256,180,50,180,96,8
2020,716800161,10330,10330,2330,2330,8000,0,0,0,0,0,0,0,0,0,30,30,0,0,1440,240,36,84,60,2
2020,716800181,10490,6990,2490,2490,4500,3500,0,0,0,0,3500,3500,0,0,1850,1850,0,0,3160,660,40,240,180,291
2020,716800191,35610,2610,2610,2610,0,33000,33000,33000,0,0,0,0,0,0,0,0,0,0,2075,240,10,100,100,37
2020,716800311,918,918,18,18,900,0,0,0,0,0,0,0,0,0,100,100,0,100,648,180,36,12,12,1
2020,716800351,48440,2440,2440,2440,0,46000,46000,36000,10000,0,0,0,0,0,28800,28800,28800,0,1742,388,224,144,120,22
2020,716800361,23730,22330,2330,2310,20000,1400,0,0,0,0,1400,1400,0,0,21500,21500,16000,500,6141,300,150,190,540,982
2020,716800381,770,770,570,570,200,0,0,0,0,0,0,0,0,0,0,0,0,0,1424,480,60,96,84,15
2020,716900101,14313,14313,813,813,13500,0,0,0,0,0,0,0,0,0,950,950,0,200,2217,157,100,240,240,2
2020,716900121,470,470,300,300,170,0,0,0,0,0,0,0,0,0,0,0,0,0,974,144,30,170,107,6
2020,716900131,59608,6558,6558,6558,0,53050,53000,43000,10000,0,50,0,50,0,5000,4500,4500,0,1641,240,120,288,264,156
2020,716900151,13596,12796,2796,1196,10000,800,0,0,0,0,800,800,0,0,9680,9680,8000,1680,2860,180,30,360,180,133
2020,716900191,104250,28700,28700,28700,0,75550,75000,75000,0,0,550,550,0,0,0,0,0,0,3624,360,360,480,144,721
2020,716900301,26330,25500,2500,2500,23000,830,0,0,0,0,830,830,0,0,0,0,0,0,2395,250,10,95,140,33
2020,716900311,7460,6260,3260,260,3000,1200,0,0,0,0,1200,1200,0,0,2420,2420,1800,0,2857,252,1500,300,240,37
2020,716900341,2750,2500,500,500,2000,250,0,0,0,0,250,250,0,0,200,200,0,0,1057,360,5,240,72,26
2020,716900351,43680,3300,3300,3300,0,40380,40380,40380,0,0,0,0,0,0,10890,10890,10000,890,2406,360,124,516,156,755
2020,716900361,301560,360,360,360,0,301200,300000,50000,250000,0,1200,1200,0,0,247140,142640,142000,0,4314,1520,340,480,324,1227
2020,716900391,23604,6344,6344,6344,0,17260,15100,15100,0,0,2160,2160,0,0,9094,9094,9094,0,3363,360,360,420,168,108
2020,717000132,111515,20515,10515,10515,10000,91000,90000,0,90000,0,1000,1000,0,0,33400,28400,27000,0,15200,3600,100,900,500,2407
2020,717000142,60675,10525,10525,10525,0,50150,50000,50000,0,0,150,150,0,0,1400,1400,1400,0,3420,180,300,240,180,70
2020,717000152,71810,8825,8825,8825,0,62985,60000,60000,0,0,2985,2985,0,0,0,0,0,0,3038,192,100,240,156,969
2020,717000162,152230,650,650,650,0,151580,151500,150000,1500,0,80,80,0,0,80000,20000,0,0,1405,150,300,300,40,207
2020,717000182,66000,1000,1000,1000,0,65000,65000,65000,0,0,0,0,0,0,14000,14000,14000,0,2404,240,50,84,100,145
2020,717000192,21520,10520,10520,10520,0,11000,11000,11000,0,0,0,0,0,0,0,0,0,0,746,50,12,60,48,33
2020,717000312,44160,14160,14160,14160,0,30000,30000,30000,0,0,0,0,0,0,1633,1633,0,1040,6035,360,200,120,432,601
2020,717000332,6762,112,112,112,0,6650,6500,6500,0,0,150,150,0,0,300,300,0,300,1598,192,180,120,47,22
2020,717000342,37963,6343,6343,6343,0,31620,30500,30500,0,0,1120,1120,0,0,4000,4000,0,4000,1763,228,45,260,120,382
2020,717000352,44610,9460,9460,9460,0,35150,30500,30500,0,0,4650,4500,150,0,6000,6000,5000,1000,2421,220,30,240,216,920
2020,717000362,131328,81128,81128,81128,0,50200,49000,31000,18000,0,1200,1200,0,0,0,0,0,0,3210,240,50,150,120,1171
2020,717000372,49480,29000,2000,2000,27000,20480,20000,0,0,20000,480,480,0,0,4000,4000,0,4000,3498,360,60,240,240,1170
2020,717000382,17100,17100,1100,1100,16000,0,0,0,0,0,0,0,0,0,0,0,0,0,964,200,360,36,48,61
2020,717600101,92440,32440,20440,20440,12000,60000,60000,0,60000,0,0,0,0,0,18800,18800,18500,0,2940,180,10,180,300,166
2020,717600111,17372,6072,1072,1072,5000,11300,9000,0,9000,0,2300,800,0,1500,5150,150,0,0,825,50,12,30,48,15
2020,717600161,117150,7000,7000,7000,0,110150,110000,110000,0,0,150,150,0,0,0,0,0,0,2820,420,400,120,120,471
2020,717600181,2580,2460,1280,1280,1180,120,0,0,0,0,120,120,0,0,0,0,0,0,1350,300,30,60,120,11
2020,717600191,4118,4018,2518,2518,1500,100,0,0,0,0,100,0,100,0,1612,1612,0,1362,2754,372,1000,50,240,4
2020,717600311,18623,18623,9623,9623,9000,0,0,0,0,0,0,0,0,0,0,0,0,0,2110,120,60,240,120,340
2020,717600351,28060,1760,1760,1760,0,26300,24000,24000,0,0,2300,2300,0,0,16210,16210,16000,0,4394,144,200,300,150,121
2020,717600361,130605,15335,15335,15335,0,115270,96000,6000,90000,0,19270,5570,13700,0,18000,18000,10000,8000,3514,314,60,860,480,758
2020,717600391,20332,19132,2132,2132,17000,1200,0,0,0,0,1200,1200,0,0,15700,15700,13600,2100,4202,312,200,460,290,56
2020,717700101,171250,800,800,800,0,170450,170000,50000,120000,0,450,450,0,0,50000,10000,10000,0,11050,910,20,590,230,598
2020,717700111,1088,1088,88,88,1000,0,0,0,0,0,0,0,0,0,70,70,0,0,2404,612,10,216,204,3
2020,717700141,2310,2310,2310,2310,0,0,0,0,0,0,0,0,0,0,0,0,0,0,721,168,180,36,72,4
2020,717700151,14022,22,22,22,0,14000,14000,14000,0,0,0,0,0,0,4340,4340,4320,0,1245,159,120,120,72,4
2020,717700171,64620,63720,20720,20720,43000,900,0,0,0,0,900,900,0,0,4000,4000,0,4000,4380,300,200,230,150,2456
2020,717700181,20070,70,70,70,0,20000,20000,20000,0,0,0,0,0,0,0,0,0,0,1270,100,400,80,60,34
2020,717700341,42176,2176,2176,2176,0,40000,40000,10000,30000,0,0,0,0,0,0,0,0,0,3310,390,150,400,220,429
2020,717700351,82784,17419,17419,17419,0,65365,64000,30000,34000,0,1365,1365,0,0,1100,0,0,0,5940,600,600,400,300,1720
2020,717700361,34260,2760,2760,2760,0,31500,30000,30000,0,0,1500,1500,0,0,12100,12100,12100,0,2760,500,60,400,50,335
2020,717700371,25295,5625,5625,5625,0,19670,14500,14500,0,0,5170,5170,0,0,2882,2882,1972,0,3376,216,100,880,320,518
2020,717700381,33843,6581,6581,6581,0,27262,26000,26000,0,0,1262,1000,262,0,1768,1768,1768,0,2831,240,60,180,108,103
2020,717800131,276760,98060,5060,5060,93000,178700,175000,0,175000,0,3700,3500,200,0,160088,44088,38000,5000,10660,400,130,200,130,6946
2020,717800141,590600,130400,30400,30400,100000,460200,460000,0,460000,0,200,200,0,0,58000,0,0,0,6310,600,20,240,150,3389
2020,717800161,18500,16500,2500,2500,14000,2000,2000,0,0,2000,0,0,0,0,5600,5600,5600,0,4208,1308,200,120,180,46
2020,717800181,530,530,30,30,500,0,0,0,0,0,0,0,0,0,0,0,0,0,735,492,30,0,18,2
2020,717800311,81940,29940,29940,29940,0,52000,51000,31000,20000,0,1000,1000,0,0,12700,12700,9700,0,8220,400,150,500,270,448
2020,717800321,73401,14661,14661,14661,0,58740,54000,35000,19000,0,4740,4740,0,0,23400,23000,23000,0,5600,276,50,900,180,201
2020,717800331,20766,6366,6366,6366,0,14400,14100,12000,2100,0,300,300,0,0,300,0,0,0,1348,120,50,250,108,57
2020,717800351,37207,17207,17207,14857,0,20000,17000,17000,0,0,3000,3000,0,0,0,0,0,0,3837,200,350,400,240,80
2020,717800361,27101,6001,6001,6001,0,21100,19400,17000,2400,0,1700,1700,0,0,0,0,0,0,2820,292,280,440,164,52
2020,717800371,29500,500,500,500,0,29000,29000,25000,4000,0,0,0,0,0,0,0,0,0,1197,191,500,60,36,17
2020,717800381,13178,10160,9160,8160,1000,3018,0,0,0,0,3018,950,68,2000,0,0,0,0,3731,676,200,104,276,35
2020,717800391,70860,14004,14004,13004,0,56856,53000,27000,26000,0,3856,3856,0,0,32150,12150,10000,1500,3440,500,500,300,100,487
2020,717900121,13074,13074,9074,9074,4000,0,0,0,0,0,0,0,0,0,1300,1300,0,0,1731,600,370,96,60,2
2020,717900131,7160,7160,1160,1160,6000,0,0,0,0,0,0,0,0,0,600,600,0,600,2316,600,120,96,180,3
2020,717900181,137372,13372,13372,13372,0,124000,120000,120000,0,0,4000,4000,0,0,500,500,0,0,2740,240,100,350,100,551
2020,717900301,24382,3972,3972,3972,0,20410,17000,17000,0,0,3410,3410,0,0,14900,14900,12000,1700,3196,316,100,480,132,95
2020,717900311,23750,22260,13760,13760,8500,1490,0,0,0,0,1490,1490,0,0,0,0,0,0,1882,132,30,420,180,1043
2020,717900321,4499,4389,2589,2089,1800,110,0,0,0,0,110,40,70,0,1440,1440,1440,0,1208,468,6,120,48,6
2020,717900331,42620,4920,4920,4920,0,37700,35000,35000,0,0,2700,2700,0,0,23951,23951,21044,2457,4250,360,120,600,480,162
2020,717900351,123040,3740,3740,3740,0,119300,118000,75000,43000,0,1300,600,500,200,54200,39200,39200,0,4342,246,95,640,336,345
2020,717900381,20495,3995,3995,1995,0,16500,16000,16000,0,0,500,500,0,0,5400,5400,5000,200,2220,270,90,250,230,401
2020,717900391,49480,1780,1780,1780,0,47700,45000,20000,25000,0,2700,2700,0,0,4600,2300,0,2300,2150,360,50,250,120,216
2020,718000102,18020,20,20,20,0,18000,18000,18000,0,0,0,0,0,0,2000,2000,1000,0,1080,120,120,120,120,20
2020,718000112,15680,10680,680,680,10000,5000,5000,0,5000,0,0,0,0,0,8000,8000,8000,0,1810,60,20,110,80,60
2020,718000142,2300,2300,1300,1300,1000,0,0,0,0,0,0,0,0,0,0,0,0,0,2138,1200,20,240,108,1
2020,718000152,38300,38000,1000,1000,37000,300,0,0,0,0,300,300,0,0,25000,25000,22000,3000,4170,160,120,360,240,309
2020,718000162,102500,3000,3000,3000,0,99500,99000,59000,40000,0,500,500,0,0,20000,0,0,0,4400,150,150,200,180,217
2020,718000192,92377,6877,6877,6877,0,85500,85000,80000,5000,0,500,500,0,0,1148,1148,0,960,7390,480,450,450,240,1516
2020,718000302,1808,1708,108,108,1600,100,0,0,0,0,100,100,0,0,1290,1290,1290,0,1432,390,40,100,140,26
2020,718000322,54404,10104,10104,10104,0,44300,43000,18000,25000,0,1300,1300,0,0,0,0,0,0,2802,276,36,420,120,168
2020,718000332,100390,10260,10260,10260,0,90130,88000,8000,80000,0,2130,1780,350,0,29600,29600,19600,10000,2800,180,300,360,144,387
2020,718600131,557640,236240,236240,236240,0,321400,313000,250000,63000,0,8400,400,8000,0,0,0,0,0,5840,600,300,350,250,2452
2020,718600171,687650,290150,290150,280150,0,397500,377000,287000,90000,0,20500,8500,12000,0,75000,70000,70000,0,7500,600,300,450,250,1941
2020,718600181,384500,2000,2000,2000,0,382500,380000,180000,200000,0,2500,2500,0,0,85770,35770,35000,750,3400,300,720,720,120,2904
2020,718600301,54736,34766,34766,34766,0,19970,17000,9000,8000,0,2970,2970,0,0,0,0,0,0,3400,300,120,240,240,178
2020,718600311,22515,4515,15,15,4500,18000,18000,0,18000,0,0,0,0,0,0,0,0,0,1016,144,116,60,36,8
2020,718600321,12455,2735,2735,2735,0,9720,8000,8000,0,0,1720,1720,0,0,3605,3605,2005,1600,1736,180,200,240,96,146
2020,718600341,19720,1500,1500,1500,0,18220,18220,16500,1720,0,0,0,0,0,1000,0,0,0,760,120,320,10,20,26
2020,718700101,920,920,420,420,500,0,0,0,0,0,0,0,0,0,50,50,0,0,1576,552,30,120,60,110
2020,718700121,197800,7300,7300,7300,0,190500,190000,190000,0,0,500,0,500,0,0,0,0,0,4104,360,120,120,84,342
2020,718700171,13219,10369,6369,6369,4000,2850,0,0,0,0,2850,850,0,2000,1700,1700,0,900,1106,36,100,200,120,138
2020,718700311,30650,12600,12600,12600,0,18050,18000,18000,0,0,50,50,0,0,0,0,0,0,1159,180,36,120,40,59
2020,718700321,26679,5366,5366,5366,0,21313,20000,20000,0,0,1313,1200,113,0,100,100,0,0,3306,192,96,984,144,63
2020,718700331,65750,1750,1750,1750,0,64000,64000,15000,49000,0,0,0,0,0,25030,25030,20000,5000,1495,180,120,55,110,74
2020,718700341,42322,16972,16472,16472,500,25350,25000,0,25000,0,350,350,0,0,0,0,0,0,1760,420,48,240,120,1698
2020,718700391,42200,7500,4500,4500,3000,34700,33000,0,0,33000,1700,1700,0,0,16000,16000,15000,0,3810,480,50,1000,280,151
2020,718800121,174906,41906,41906,41906,0,133000,130000,130000,0,0,3000,3000,0,0,0,0,0,0,3600,320,250,260,88,658
2020,718800151,204660,29160,29160,27660,0,175500,170000,160000,10000,0,5500,5500,0,0,57400,57400,55000,1500,3900,800,500,1000,400,720
2020,718800181,11860,11000,2000,2000,9000,860,0,0,0,0,860,860,0,0,0,0,0,0,1498,240,100,100,150,1225
2020,718800301,32636,6536,6536,4536,0,26100,20000,20000,0,0,6100,2100,4000,0,3940,3940,0,3500,3220,300,30,800,290,227
2020,718800311,55450,800,800,800,0,54650,54600,12000,42600,0,50,0,50,0,0,0,0,0,1204,180,30,20,84,33
2020,718900131,183,183,30,30,153,0,0,0,0,0,0,0,0,0,600,600,0,600,1154,108,80,72,84,1
2020,718900301,123538,16668,16668,16668,0,106870,95150,39150,56000,0,11720,2720,9000,0,0,0,0,0,1502,120,150,260,72,244
2020,718900321,90525,5625,5625,5625,0,84900,75000,20000,55000,0,9900,400,9500,0,0,0,0,0,2614,250,30,350,84,72
2020,719000102,86970,6700,6700,6700,0,80270,80000,80000,0,0,270,270,0,0,0,0,0,0,2542,360,200,200,120,1015
2020,719000112,6005,6005,5,5,6000,0,0,0,0,0,0,0,0,0,1300,1300,0,0,694,360,10,12,72,1
2020,719000142,46850,45800,17800,12800,28000,1050,0,0,0,0,1050,900,150,0,16900,16900,16900,0,2520,180,50,360,96,31
2020,719000152,35060,15,15,15,0,35045,35000,35000,0,0,45,0,45,0,11600,11600,11600,0,1106,72,20,10,96,54
2020,719000162,69070,42670,5670,5670,37000,26400,25000,0,25000,0,1400,1400,0,0,21000,0,0,0,4290,360,150,240,240,118
2020,719000192,9600,8650,2650,2650,6000,950,0,0,0,0,950,950,0,0,0,0,0,0,2289,72,482,124,96,91
2020,719600161,95740,8140,8140,5640,0,87600,85000,85000,0,0,2600,2600,0,0,1000,1000,0,1000,3180,360,240,360,240,448
2020,719600171,169080,55880,11880,11880,44000,113200,110000,0,110000,0,3200,3200,0,0,67800,43800,0,43800,2322,420,300,480,150,241
2020,719600191,37630,11330,11330,11330,0,26300,26000,26000,0,0,300,300,0,0,0,0,0,0,3573,205,600,200,200,302
2020,719700101,11000,9500,1500,1500,8000,1500,0,0,0,0,1500,1500,0,0,1544,1544,0,500,2640,144,296,48,84,51
2020,719700121,6266,6266,3266,3266,3000,0,0,0,0,0,0,0,0,0,4320,4320,400,2300,1765,1120,10,50,120,1
2020,719700161,105736,30436,30436,30436,0,75300,75000,75000,0,0,300,300,0,0,0,0,0,0,2481,252,50,180,120,86
2020,719800101,69401,66101,7101,7101,59000,3300,0,0,0,0,3300,3300,0,0,6000,6000,6000,0,6930,600,50,390,180,3687
2020,719800111,91480,2780,2780,2780,0,88700,85000,75000,10000,0,3700,3700,0,0,0,0,0,0,2291,300,1000,300,210,274
2020,719800121,40300,300,300,300,0,40000,40000,40000,0,0,0,0,0,0,15000,15000,12000,3000,756,180,2,36,43,85
2020,719800131,50,50,50,50,0,0,0,0,0,0,0,0,0,0,0,0,0,0,1390,720,10,20,60,1
2020,719800141,17940,17640,1140,1140,16500,300,0,0,0,0,300,300,0,0,2500,2500,2500,0,1440,120,0,200,60,601
2020,719800161,16000,4900,1900,1900,3000,11100,0,0,0,0,11100,3100,0,8000,0,0,0,0,3160,1200,50,50,240,36
2020,719800181,155,155,5,5,150,0,0,0,0,0,0,0,0,0,0,0,0,0,352,50,0,10,48,1
2020,719800191,100240,240,240,240,0,100000,100000,100000,0,0,0,0,0,0,24600,0,0,0,1696,188,300,192,156,81
2020,719900101,210,210,10,10,200,0,0,0,0,0,0,0,0,0,2700,2700,0,2700,1434,480,30,60,84,7
2020,719900141,4420,1920,920,920,1000,2500,0,0,0,0,2500,2500,0,0,2200,2200,1000,0,2494,1080,360,360,144,10
2020,719900161,5265,5265,915,915,4350,0,0,0,0,0,0,0,0,0,3250,3250,3250,0,2880,216,40,300,300,4
2020,719900171,9428,9428,100,100,9328,0,0,0,0,0,0,0,0,0,180,180,0,0,400,120,12,24,24,1
2020,719900191,124805,3105,3105,3105,0,121700,120000,120000,0,0,1700,1700,0,0,76500,49000,49000,0,3750,130,20,450,280,161
2020,720000202,18350,3250,3250,3250,0,15100,15000,15000,0,0,100,0,100,0,12200,12200,11900,0,1800,168,264,20,70,1
2020,720000212,80,80,80,80,0,0,0,0,0,0,0,0,0,0,0,0,0,0,1410,140,50,10,30,1
2020,720000232,1039,1039,39,39,1000,0,0,0,0,0,0,0,0,0,0,0,0,0,476,60,200,10,16,1
2020,720000242,36506,7780,7780,7780,0,28726,28000,28000,0,0,726,500,226,0,18830,18830,18700,0,2195,300,300,250,200,42
2020,720000252,410,410,230,230,180,0,0,0,0,0,0,0,0,0,0,0,0,0,798,180,18,36,84,0
2020,720000262,26024,15724,13724,11724,2000,10300,0,0,0,0,10300,300,10000,0,0,0,0,0,4178,420,300,660,120,166
2020,720000292,78034,19694,19694,19694,0,58340,55000,32000,23000,0,3340,3340,0,0,1400,1400,0,0,3190,240,100,420,210,800
2020,720000302,2620,2620,20,20,2600,0,0,0,0,0,0,0,0,0,1800,1800,1800,0,1560,384,48,24,84,0
2020,720000322,36871,18721,18721,18721,0,18150,18000,18000,0,0,150,150,0,0,504,504,0,500,4700,540,60,700,300,391
2020,720000332,12996,10090,9090,8090,1000,2906,0,0,0,0,2906,2680,226,0,2500,2500,0,2500,4622,960,60,540,432,302
2020,720000342,43396,6570,6570,6570,0,36826,33000,30000,3000,0,3826,3600,226,0,2000,2000,0,2000,3370,360,300,240,240,181
2020,720000352,19400,10400,10400,10400,0,9000,7000,7000,0,0,2000,2000,0,0,0,0,0,0,3218,300,100,520,180,57
2020,720000362,12870,1870,1870,1870,0,11000,11000,11000,0,0,0,0,0,0,0,0,0,0,616,204,80,30,12,14
2020,720000372,2640,2640,2440,1240,200,0,0,0,0,0,0,0,0,0,630,630,0,600,1490,504,0,48,180,83
2020,720000382,92333,6520,6520,6520,0,85813,78500,30000,48500,0,7313,6700,613,0,55954,22954,15172,4982,5784,420,450,250,300,470
2020,720000392,13355,3712,3712,3712,0,9643,8000,8000,0,0,1643,1643,0,0,6500,6500,6000,0,2769,252,250,137,228,68
2020,720600211,59698,25928,25928,15928,0,33770,32000,17000,15000,0,1770,1700,70,0,8000,0,0,0,1384,250,50,234,48,132
2020,720600221,4580,4580,80,80,4500,0,0,0,0,0,0,0,0,0,800,800,0,800,2160,100,30,100,300,1
2020,720600251,44132,8932,8932,8932,0,35200,35000,35000,0,0,200,0,200,0,13500,12000,12000,0,810,150,40,60,80,146
2020,720600261,3073,3023,23,23,3000,50,0,0,0,0,50,50,0,0,23330,23330,2000,1000,2260,840,60,480,240,29
2020,720600291,13113,463,463,463,0,12650,12500,12500,0,0,150,0,150,0,7400,7400,7400,0,1980,230,50,280,120,40
2020,720600301,19840,4140,4140,4140,0,15700,15000,15000,0,0,700,700,0,0,8800,8800,8800,0,3500,300,200,300,200,71
2020,720600311,27965,2065,2065,2065,0,25900,23500,23500,0,0,2400,2300,100,0,2696,2696,2596,0,4340,360,80,600,240,141
2020,720600341,10,10,10,10,0,0,0,0,0,0,0,0,0,0,0,0,0,0,536,60,60,60,36,1
2020,720600351,189400,29000,29000,16000,0,160400,152000,33000,119000,0,8400,5000,3400,0,78000,65000,25000,40000,5040,360,400,1000,400,603
2020,720600371,95508,7408,7408,7408,0,88100,70000,10000,60000,0,18100,2600,2500,13000,20000,20000,20000,0,2721,300,250,520,180,152
2020,720600381,202124,14184,14184,12184,0,187940,185000,25000,160000,0,2940,1400,1540,0,80100,80100,79300,800,1550,250,10,400,120,157
2020,720600391,25800,7000,7000,7000,0,18800,17000,17000,0,0,1800,1800,0,0,4750,4750,3950,800,2782,420,72,540,300,113
2020,720700201,42450,7200,7200,7200,0,35250,35000,35000,0,0,250,250,0,0,90,90,0,0,2800,300,300,200,150,88
2020,720700241,3240,2940,2640,2640,300,300,0,0,0,0,300,300,0,0,0,0,0,0,2276,500,50,300,100,388
2020,720700251,50080,4850,4850,4850,0,45230,45000,23000,22000,0,230,150,80,0,24600,22100,18400,2950,5286,200,770,250,216,771
2020,720700261,19702,1250,1250,1250,0,18452,18000,18000,0,0,452,0,452,0,4830,4830,4730,0,2445,180,35,200,200,40
2020,720700281,114900,2600,2600,2600,0,112300,109000,25000,84000,0,3300,300,3000,0,0,0,0,0,2034,440,20,140,124,151
2020,720700291,17000,5400,5400,5400,0,11600,10000,10000,0,0,1600,1600,0,0,68,68,0,0,1940,170,350,200,135,76
2020,720700301,44565,830,830,830,0,43735,43000,3000,40000,0,735,150,585,0,460,460,0,400,1189,224,5,300,48,26
2020,720700331,40251,9641,9641,8641,0,30610,27000,27000,0,0,3610,1610,2000,0,0,0,0,0,4710,960,1300,660,240,1102
2020,720700341,41804,8004,8004,8004,0,33800,31800,31800,0,0,2000,2000,0,0,5090,5090,5090,0,4129,300,15,240,180,280
2020,720700371,104234,11484,11484,11484,0,92750,83000,35000,18000,30000,9750,750,9000,0,44166,29166,26666,0,2760,180,200,100,300,102
2020,720700391,46036,4536,4536,4536,0,41500,40000,25000,15000,0,1500,1500,0,0,4300,4000,4000,0,984,220,60,250,84,137
2020,720800201,4424,2824,2524,2524,300,1600,0,0,0,0,1600,1600,0,0,250,250,0,0,3270,440,100,300,250,135
2020,720800211,15120,120,120,120,0,15000,15000,15000,0,0,0,0,0,0,600,0,0,0,614,136,120,60,18,21
2020,720800231,20310,3610,3610,3510,0,16700,11000,11000,0,0,5700,2600,100,3000,100,100,0,0,1809,150,20,400,400,69
2020,720800241,560,560,310,310,250,0,0,0,0,0,0,0,0,0,0,0,0,0,1176,188,30,60,180,2
2020,720800251,4622,4582,3582,3582,1000,40,0,0,0,0,40,40,0,0,700,700,0,0,2154,588,10,120,144,48
2020,720800291,26775,1675,1675,1675,0,25100,25000,21000,0,4000,100,0,100,0,10600,10600,10600,0,1580,300,20,150,180,29
2020,720800301,66807,1507,1507,1507,0,65300,63000,30000,33000,0,2300,1800,500,0,39200,23200,15000,8000,2551,240,60,360,240,183
2020,720800321,20930,6500,6500,6500,0,14430,13500,13500,0,0,930,930,0,0,0,0,0,0,2286,300,150,248,103,118
2020,720800331,5808,4808,4308,4308,500,1000,0,0,0,0,1000,1000,0,0,0,0,0,0,2617,630,60,240,252,38
2020,720800341,1090,1090,1090,1090,0,0,0,0,0,0,0,0,0,0,0,0,0,0,529,168,72,20,24,1
2020,720800351,23120,3720,3720,3720,0,19400,19000,19000,0,0,400,400,0,0,10000,6000,6000,0,3473,360,960,400,132,62
2020,720800361,52046,14246,14246,14246,0,37800,37000,17000,20000,0,800,800,0,0,0,0,0,0,1168,264,200,80,52,162
2020,720800371,5460,460,460,460,0,5000,5000,5000,0,0,0,0,0,0,0,0,0,0,1264,160,240,240,84,16
2020,720900201,18863,1513,1513,1513,0,17350,10000,10000,0,0,7350,1350,0,6000,0,0,0,0,3993,420,1500,1230,144,37
2020,720900221,38900,270,270,270,0,38630,34500,12000,22500,0,4130,2800,1030,300,5100,5100,3600,0,2740,150,750,130,150,97
2020,720900241,63280,19280,19280,18280,0,44000,25000,25000,0,0,19000,10100,900,8000,0,0,0,0,3110,210,30,350,350,201
2020,720900271,7792,6592,2592,2592,4000,1200,0,0,0,0,1200,1000,200,0,2590,2590,0,800,3490,700,50,400,240,41
2020,720900281,12820,1620,1620,1620,0,11200,11000,11000,0,0,200,0,200,0,140,140,140,0,1064,96,200,80,264,193
2020,720900301,43480,4780,4780,4780,0,38700,38000,30000,8000,0,700,700,0,0,3900,0,0,0,1692,240,360,360,72,126
2020,720900311,21165,5965,5965,5965,0,15200,13000,13000,0,0,2200,2200,0,0,9260,9260,9200,0,1980,200,50,200,150,80
2020,720900321,82246,29246,29246,29246,0,53000,50000,30000,10000,10000,3000,3000,0,0,4700,4700,4700,0,7680,396,260,340,264,806
2020,720900331,48460,2960,2960,960,0,45500,38000,38000,0,0,7500,3000,3000,1500,19200,19200,19200,0,3578,240,30,240,100,1304
2020,720900341,24645,1145,1145,1145,0,23500,21000,21000,0,0,2500,2500,0,0,15800,15800,14700,0,3417,303,40,300,240,155
2020,720900351,45640,3140,3140,140,0,42500,40000,40000,0,0,2500,1500,1000,0,15130,15130,15000,130,1730,240,100,360,60,82
2020,720900361,18080,1980,1980,1980,0,16100,15000,15000,0,0,1100,1100,0,0,3000,3000,0,3000,3304,240,100,420,144,235
2020,720900371,2744,2444,244,244,2200,300,0,0,0,0,300,300,0,0,0,0,0,0,902,210,15,125,82,9
2020,720900381,24414,18114,3114,3114,15000,6300,4000,0,4000,0,2300,2300,0,0,0,0,0,0,2217,360,10,312,168,99
2020,720900391,9915,8615,8615,6115,0,1300,0,0,0,0,1300,1300,0,0,0,0,0,0,1345,115,180,230,60,47
2020,721000222,47140,14840,14840,13840,0,32300,20000,20000,0,0,12300,2300,10000,0,0,0,0,0,2680,240,30,500,180,798
2020,721000232,70,70,70,70,0,0,0,0,0,0,0,0,0,0,1350,1350,0,1350,1130,205,25,110,72,1
2020,721000252,2742,1142,642,642,500,1600,0,0,0,0,1600,1600,0,0,600,600,0,0,1502,390,80,240,92,112
2020,721000262,5100,5100,100,100,5000,0,0,0,0,0,0,0,0,0,5350,5350,0,5000,1564,280,10,360,204,3
2020,721000292,26380,2880,2880,2880,0,23500,22800,19800,3000,0,700,700,0,0,0,0,0,0,1728,228,140,300,230,71
2020,721000302,25168,7368,7368,7368,0,17800,17000,17000,0,0,800,800,0,0,13800,13800,13800,0,1660,400,600,200,200,144
2020,721000312,91690,12690,12690,12690,0,79000,76500,15000,61500,0,2500,2500,0,0,56000,56000,55000,1000,3160,300,240,700,150,610
2020,721000322,1520,1520,20,20,1500,0,0,0,0,0,0,0,0,0,0,0,0,0,394,66,40,60,36,1
2020,721000332,4865,3997,1497,1497,2500,868,0,0,0,0,868,800,68,0,0,0,0,0,1776,264,48,240,144,39
2020,721000352,23320,3260,3260,3260,0,20060,20000,20000,0,0,60,0,60,0,5420,5420,5300,0,1391,168,200,15,96,18
2020,721000362,17380,380,380,380,0,17000,17000,10000,7000,0,0,0,0,0,10900,10800,10500,300,774,110,37,80,72,22
2020,721000372,14920,420,420,420,0,14500,14000,4000,10000,0,500,500,0,0,2000,0,0,0,2332,200,300,396,156,217
2020,721000382,1000,1000,1000,1000,0,0,0,0,0,0,0,0,0,0,0,0,0,0,894,120,50,24,60,2
2020,721000392,3076,3076,2776,2776,300,0,0,0,0,0,0,0,0,0,70,70,0,0,1770,600,84,24,72,43
2020,721600221,35485,10705,10705,6120,0,24780,18000,18000,0,0,6780,6280,500,0,1340,1340,780,560,6060,500,40,1400,350,350
2020,721600251,16306,1826,1826,1826,0,14480,14000,14000,0,0,480,360,120,0,0,0,0,0,1430,240,100,320,140,71
2020,721600281,64722,11422,11422,11422,0,53300,45000,43000,2000,0,8300,6500,1800,0,9200,9200,9200,0,4220,280,90,650,200,935
2020,721600291,57284,5984,5984,5984,0,51300,51000,34000,17000,0,300,0,300,0,11600,11600,11600,0,1680,400,500,10,90,52
2020,721600321,44691,14391,14391,14391,0,30300,28500,25000,0,3500,1800,1500,300,0,1500,1500,0,1500,4530,340,300,350,300,377
2020,721600341,8330,2730,2730,2730,0,5600,5000,5000,0,0,600,600,0,0,0,0,0,0,921,95,300,100,36,15
2020,721600351,13530,150,150,150,0,13380,13000,8000,5000,0,380,380,0,0,300,0,0,0,2097,208,460,210,120,35
2020,721600361,11260,4595,4295,3795,300,6665,0,0,0,0,6665,765,2800,3100,3150,3150,0,3150,2072,472,20,370,120,63
2020,721600391,3400,700,700,700,0,2700,2700,2700,0,0,0,0,0,0,0,0,0,0,668,88,70,30,20,4
2020,721700201,45,45,45,45,0,0,0,0,0,0,0,0,0,0,0,0,0,0,470,120,50,10,24,1
2020,721700231,240,240,40,40,200,0,0,0,0,0,0,0,0,0,0,0,0,0,1092,580,75,15,36,1
2020,721700241,141040,37290,37290,37290,0,103750,102000,82000,20000,0,1750,750,1000,0,200,200,0,0,5770,360,260,300,320,1374
2020,721700261,59545,2445,2445,2445,0,57100,21000,21000,0,0,36100,1100,35000,0,13800,13800,10800,3000,2816,186,400,450,240,158
2020,721700271,30,30,30,30,0,0,0,0,0,0,0,0,0,0,0,0,0,0,418,68,64,0,16,1
2020,721700281,69350,21350,21350,21350,0,48000,36000,36000,0,0,12000,12000,0,0,8854,8854,3254,1000,7380,180,200,300,400,450
2020,721700291,27263,12060,12060,12060,0,15203,13000,13000,0,0,2203,1923,280,0,170,170,0,0,4275,230,65,240,360,89
2020,721700311,1030,1030,30,30,1000,0,0,0,0,0,0,0,0,0,0,0,0,0,906,288,250,10,48,1
2020,721700321,19820,2120,2120,2120,0,17700,17600,3600,14000,0,100,0,100,0,0,0,0,0,832,112,120,144,36,7
2020,721700331,7146,78,78,78,0,7068,7000,7000,0,0,68,0,68,0,0,0,0,0,939,114,35,80,30,5
2020,721700341,18030,11100,11100,11100,0,6930,6500,6500,0,0,430,430,0,0,0,0,0,0,1619,204,25,270,240,139
2020,721700381,8700,200,200,200,0,8500,8000,8000,0,0,500,300,200,0,0,0,0,0,2559,270,89,240,170,236
2020,721700391,3560,60,60,60,0,3500,3500,0,3500,0,0,0,0,0,1100,1100,1100,0,788,180,40,30,18,7
2020,721800201,6448,5456,4456,4456,1000,992,0,0,0,0,992,900,92,0,4350,4350,0,3350,3710,750,200,120,300,98
2020,721800221,128190,19680,19680,19680,0,108510,105000,90000,15000,0,3510,2050,1460,0,36000,8000,8000,0,4330,240,360,1200,240,415
2020,721800231,30718,5548,5548,5548,0,25170,24000,24000,0,0,1170,1000,170,0,0,0,0,0,2375,280,30,60,280,87
2020,721800251,39372,7792,7792,7792,0,31580,29500,29500,0,0,2080,1480,600,0,9930,9930,9930,0,3430,180,700,400,300,316
2020,721800261,36335,13155,13155,13155,0,23180,22000,22000,0,0,1180,1000,180,0,4464,4464,2434,0,4900,300,100,600,400,666
2020,721800271,66230,5130,5130,5130,0,61100,60000,30000,30000,0,1100,1000,100,0,15000,15000,14500,500,2821,190,200,200,240,207
2020,721800281,8865,8865,865,865,8000,0,0,0,0,0,0,0,0,0,5500,5500,0,0,1500,250,120,30,120,9
2020,721800291,93330,180,180,180,0,93150,93000,81000,12000,0,150,0,150,0,9236,9236,9236,0,1428,250,400,0,90,82
2020,721800301,45951,651,651,651,0,45300,45000,9000,36000,0,300,300,0,0,15000,0,0,0,1731,175,100,240,66,38
2020,721800321,74160,23400,23400,13400,0,50760,42000,20000,22000,0,8760,6500,2260,0,3400,2900,2000,900,6040,480,400,1300,360,192
2020,721800331,215635,14572,14572,14572,0,201063,195000,21000,174000,0,6063,950,5113,0,5000,0,0,0,4830,320,120,400,300,434
2020,721800341,57052,20822,20822,20822,0,36230,29000,16000,13000,0,7230,3800,430,3000,0,0,0,0,2920,450,300,500,170,575
2020,721800361,8070,220,220,220,0,7850,7850,6000,1850,0,0,0,0,0,0,0,0,0,2180,200,10,150,240,21
2020,721800371,943,593,293,293,300,350,0,0,0,0,350,350,0,0,0,0,0,0,1438,120,36,240,42,11
2020,721800381,50,50,50,50,0,0,0,0,0,0,0,0,0,0,0,0,0,0,762,100,150,15,22,1
2020,721800391,58822,12122,9122,9122,3000,46700,43000,0,43000,0,3700,3700,0,0,0,0,0,0,3070,380,70,200,240,744
2020,721900201,12890,1240,1240,1240,0,11650,11500,11500,0,0,150,150,0,0,0,0,0,0,4100,180,230,250,360,189
2020,721900211,683,641,641,641,0,42,0,0,0,0,42,0,42,0,0,0,0,0,1250,110,550,90,36,2
2020,721900221,4210,2750,2250,250,500,1460,0,0,0,0,1460,710,750,0,0,0,0,0,3337,750,12,480,225,117
2020,721900231,350,350,50,50,300,0,0,0,0,0,0,0,0,0,400,400,0,0,1782,540,50,280,60,32
2020,721900271,43694,6444,6444,4944,0,37250,32000,32000,0,0,5250,3000,1250,1000,15700,15700,12700,2300,4970,300,30,500,240,494
2020,721900281,37380,6280,6280,6280,0,31100,30000,30000,0,0,1100,400,700,0,9892,9892,8592,1200,3725,240,400,500,300,74
2020,721900301,42828,5628,5628,4628,0,37200,22000,22000,0,0,15200,3700,11000,500,16441,16441,15441,0,6358,400,20,600,288,118
2020,721900311,93730,21230,21230,21230,0,72500,70000,70000,0,0,2500,2500,0,0,2000,0,0,0,1550,240,10,240,120,213
2020,721900331,700,700,700,700,0,0,0,0,0,0,0,0,0,0,0,0,0,0,640,244,0,14,22,7
2020,721900341,18400,400,400,400,0,18000,18000,18000,0,0,0,0,0,0,300,0,0,0,1100,120,40,100,100,33
2020,721900361,6930,6630,6630,6630,0,300,0,0,0,0,300,300,0,0,1550,1550,1500,0,2730,620,180,400,180,81
2020,721900371,60570,14270,14270,12770,0,46300,16000,16000,0,0,30300,300,30000,0,5000,5000,0,4500,4476,600,300,286,290,219
2020,721900391,12011,2011,2011,2011,0,10000,10000,10000,0,0,0,0,0,0,150,0,0,0,970,159,130,15,43,8
2020,722000202,24404,7104,7104,5104,0,17300,17000,17000,0,0,300,300,0,0,0,0,0,0,1640,240,300,300,80,54
2020,722000212,52923,3378,3378,3378,0,49545,49000,29000,20000,0,545,500,45,0,11000,11000,11000,0,2074,180,120,240,144,93
2020,722000222,174850,74830,74830,74830,0,100020,95000,50000,45000,0,5020,4500,520,0,30000,5000,0,5000,6110,400,800,400,500,1493
2020,722000242,33166,4286,4286,4286,0,28880,27000,27000,0,0,1880,1880,0,0,2000,2000,2000,0,2991,276,25,420,120,115
2020,722000262,5050,4850,4590,4590,260,200,0,0,0,0,200,200,0,0,0,0,0,0,2490,180,30,240,162,1
2020,722000272,5640,5640,4140,4140,1500,0,0,0,0,0,0,0,0,0,0,0,0,0,1811,433,324,110,65,1
2020,722000302,30,30,30,30,0,0,0,0,0,0,0,0,0,0,0,0,0,0,625,150,20,10,15,1
2020,722000312,325,25,25,25,0,300,300,300,0,0,0,0,0,0,0,0,0,0,476,70,5,50,72,1
2020,722000342,13750,2900,2900,2900,0,10850,10000,10000,0,0,850,850,0,0,5800,5800,5800,0,1240,180,60,480,120,206
2020,722000352,67600,5400,5400,5400,0,62200,61100,6000,55100,0,1100,1100,0,0,5000,5000,5000,0,2717,300,17,400,180,83
2020,722600201,89404,73854,35854,35854,38000,15550,13700,0,2000,11700,1850,850,1000,0,8000,8000,0,8000,5244,324,130,600,450,766
2020,722600211,550,550,50,50,500,0,0,0,0,0,0,0,0,0,0,0,0,0,695,140,80,40,25,0
2020,722600221,31371,12371,12371,8026,0,19000,18000,18000,0,0,1000,300,700,0,9000,9000,7800,0,5050,240,100,100,170,24
2020,722600231,20970,1870,1870,1870,0,19100,19000,19000,0,0,100,100,0,0,0,0,0,0,903,80,35,195,23,40
2020,722600251,54434,20832,7532,5532,13300,33602,30000,0,30000,0,3602,3340,262,0,20000,0,0,0,3914,193,62,475,350,51
2020,722600261,54552,13502,13502,10502,0,41050,27000,27000,0,0,14050,4700,9350,0,56174,56174,55174,1000,3870,360,10,360,360,150
2020,722600281,63590,12590,12590,8590,0,51000,45000,30000,15000,0,6000,5500,500,0,0,0,0,0,2750,360,100,600,120,2852
2020,722600291,25885,4974,4974,4974,0,20911,13800,13800,0,0,7111,2210,4901,0,7147,7147,5500,0,2805,229,319,487,202,126
2020,722600311,4316,316,316,316,0,4000,4000,4000,0,0,0,0,0,0,0,0,0,0,471,137,70,20,24,10
2020,722600321,87854,14254,14254,14254,0,73600,70000,50000,20000,0,3600,3600,0,0,22100,22000,7000,5000,6736,472,450,300,300,168
2020,722600331,33865,3990,3990,3990,0,29875,28400,4400,24000,0,1475,800,675,0,1000,1000,0,1000,1507,269,10,260,132,56
2020,722600341,5800,800,800,800,0,5000,5000,5000,0,0,0,0,0,0,0,0,0,0,1314,280,30,240,29,12
2020,722700201,2866,2866,1366,1366,1500,0,0,0,0,0,0,0,0,0,140,140,0,0,2440,270,360,60,238,3
2020,722700221,330,330,30,30,300,0,0,0,0,0,0,0,0,0,7000,7000,0,0,1183,310,310,37,36,0
2020,722700241,38272,21142,21142,21142,0,17130,17000,17000,0,0,130,130,0,0,0,0,0,0,1720,240,100,300,130,502
2020,722700251,18801,2301,2301,2301,0,16500,14000,14000,0,0,2500,2500,0,0,3400,3400,3280,0,2520,170,200,250,250,131
2020,722700261,15060,30,30,30,0,15030,15000,15000,0,0,30,0,30,0,0,0,0,0,850,350,70,30,40,17
2020,722700281,113200,38300,38300,38300,0,74900,74700,28000,46700,0,200,200,0,0,0,0,0,0,3644,450,48,180,60,166
2020,722700291,16059,2659,2659,2659,0,13400,12000,12000,0,0,1400,1400,0,0,2000,2000,2000,0,1526,156,60,240,240,38
2020,722700311,108780,17540,17540,17540,0,91240,90540,18000,71000,1540,700,700,0,0,6000,0,0,0,5190,480,300,480,240,169
2020,722700321,11634,2084,2084,2084,0,9550,8700,8700,0,0,850,400,450,0,0,0,0,0,1240,300,196,210,30,41
2020,722700331,18895,1595,1595,1595,0,17300,17000,5000,12000,0,300,300,0,0,4000,4000,4000,0,1234,110,5,240,84,16
2020,722700361,20280,1580,1580,1580,0,18700,17500,17500,0,0,1200,1200,0,0,6300,6300,6300,0,1674,240,140,360,144,107
2020,722800221,1255,1255,1055,1055,200,0,0,0,0,0,0,0,0,0,2000,2000,0,2000,420,80,23,25,70,0
2020,722800231,55900,500,500,500,0,55400,52000,26000,26000,0,3400,3400,0,0,500,0,0,0,3400,250,250,950,350,133
2020,722800241,1050,150,50,50,100,900,0,0,0,0,900,900,0,0,0,0,0,0,1188,322,240,180,72,47
2020,722800261,60920,5370,5370,5370,0,55550,55000,35000,20000,0,550,350,200,0,0,0,0,0,1740,300,300,150,90,164
2020,722800271,710,560,320,320,240,150,0,0,0,0,150,150,0,0,468,468,0,468,840,78,20,150,12,15
2020,722800301,2500,500,500,500,0,2000,2000,2000,0,0,0,0,0,0,0,0,0,0,845,80,130,50,15,3
2020,722800311,5768,5768,5768,5768,0,0,0,0,0,0,0,0,0,0,0,0,0,0,759,348,24,10,20,1
2020,722800321,7565,4221,4221,4101,0,3344,3000,3000,0,0,344,0,344,0,1400,1400,1400,0,1724,245,274,247,20,4
2020,722800331,7625,4705,4705,4705,0,2920,2500,2500,0,0,420,370,50,0,0,0,0,0,2424,365,720,200,96,12
2020,722900201,739,739,239,239,500,0,0,0,0,0,0,0,0,0,0,0,0,0,993,468,20,50,60,1
2020,722900211,155984,36284,36284,26284,0,119700,105000,55000,50000,0,14700,4700,10000,0,21750,21750,18800,0,3210,300,100,360,200,465
2020,722900221,21380,20080,16080,11080,4000,1300,0,0,0,0,1300,0,300,1000,3200,3200,0,3200,1704,240,50,360,84,3
2020,722900231,250,250,50,50,200,0,0,0,0,0,0,0,0,0,20,20,0,20,2175,480,10,240,480,4
2020,722900241,3143,2593,1593,1593,1000,550,0,0,0,0,550,400,150,0,1620,1620,0,1300,2540,1000,30,220,180,140
2020,722900251,1216,591,291,291,300,625,0,0,0,0,625,625,0,0,0,0,0,0,2020,425,15,317,81,104
2020,722900261,39736,10536,10536,10536,0,29200,28000,28000,0,0,1200,1100,100,0,5050,5050,5000,0,3600,360,40,400,200,414
2020,722900281,19754,2854,2854,2854,0,16900,15000,15000,0,0,1900,1900,0,0,0,0,0,0,4180,210,600,300,120,421
2020,722900291,26736,2736,2736,2736,0,24000,24000,24000,0,0,0,0,0,0,0,0,0,0,1150,300,100,40,60,45
2020,722900301,165800,1100,1100,1100,0,164700,161500,23000,138500,0,3200,1800,1400,0,8000,8000,5000,3000,2260,300,50,250,100,98
2020,722900311,16160,10370,10370,10370,0,5790,5500,5500,0,0,290,0,290,0,0,0,0,0,1831,200,1100,54,14,19
2020,722900321,790,790,790,790,0,0,0,0,0,0,0,0,0,0,0,0,0,0,1940,80,10,100,120,1
2020,722900331,46900,3000,3000,3000,0,43900,43000,15000,28000,0,900,900,0,0,24000,9000,3000,6000,2590,250,100,300,250,371
2020,722900351,13700,2200,2200,2200,0,11500,11500,7500,4000,0,0,0,0,0,100,0,0,0,1100,490,100,20,30,12
2020,723000202,92180,17880,17880,17880,0,74300,72900,32700,40200,0,1400,1400,0,0,11200,0,0,0,5879,250,1480,852,227,275
2020,723000212,83997,79145,50145,50145,29000,4852,0,0,0,0,4852,4400,452,0,5000,5000,0,5000,3552,480,250,340,212,609
2020,723000222,28008,2100,2100,2100,0,25908,25000,16000,9000,0,908,700,208,0,15300,14800,14800,0,1591,360,60,120,36,55
2020,723000232,69321,22671,1671,1671,21000,46650,42000,0,42000,0,4650,4650,0,0,32232,2232,0,0,3692,200,97,18,160,358
2020,723000242,14700,300,300,300,0,14400,13600,9000,4600,0,800,800,0,0,0,0,0,0,1098,180,120,120,38,125
2020,723600201,27300,300,300,300,0,27000,27000,27000,0,0,0,0,0,0,0,0,0,0,1494,216,120,124,120,27
2020,723600211,280846,120586,120586,120586,0,160260,64000,39000,25000,0,96260,6000,90260,0,21150,21150,21000,0,6290,500,50,420,360,37991
2020,723600221,86964,21654,21654,21654,0,65310,62000,39000,23000,0,3310,3130,180,0,36280,21280,12980,7500,4200,360,160,400,380,1500
2020,723600241,2190,2040,1740,1740,300,150,0,0,0,0,150,0,150,0,0,0,0,0,1442,160,180,120,72,239
2020,723600251,7397,5684,5684,5684,0,1713,0,0,0,0,1713,1600,113,0,210,210,0,0,2110,220,310,250,100,237
2020,723700221,25342,4742,4742,4742,0,20600,20000,20000,0,0,600,600,0,0,2740,2740,0,2600,3150,200,400,250,300,489
2020,723700231,37566,6966,6966,6966,0,30600,27000,12000,15000,0,3600,3600,0,0,10000,0,0,0,1714,144,30,300,120,544
2020,723700241,27598,12448,12448,12448,0,15150,12000,12000,0,0,3150,2850,300,0,2500,2500,2500,0,2924,360,240,300,204,395
2020,723700251,21090,1000,1000,1000,0,20090,20000,20000,0,0,90,90,0,0,0,0,0,0,2575,200,136,550,120,44
2020,723800201,12730,130,130,130,0,12600,12000,12000,0,0,600,600,0,0,7500,7500,7500,0,1922,192,300,350,200,290
2020,723800211,75500,15500,15500,15500,0,60000,60000,0,60000,0,0,0,0,0,10000,0,0,0,986,240,60,60,26,174
2020,723800221,36066,7316,7316,7316,0,28750,28000,28000,0,0,750,650,100,0,17483,17483,17373,0,2980,240,30,400,240,77
2020,723800231,26196,6396,6396,6396,0,19800,19800,19800,0,0,0,0,0,0,10573,10573,10573,0,3707,192,117,100,350,82
2020,723800241,44780,6100,6100,6100,0,38680,34000,25000,9000,0,4680,200,4480,0,0,0,0,0,1070,200,200,100,40,39
2020,723900201,139893,78393,78393,58393,0,61500,59000,37000,22000,0,2500,2500,0,0,33000,33000,23000,10000,4510,200,100,200,160,934
2020,723900211,47972,7372,7372,7372,0,40600,38000,38000,0,0,2600,1600,1000,0,7800,7800,7800,0,6850,300,200,250,300,530
2020,723900231,21080,80,80,80,0,21000,21000,21000,0,0,0,0,0,0,0,0,0,0,990,300,80,24,32,16
2020,723900241,2010,2010,10,10,2000,0,0,0,0,0,0,0,0,0,0,0,0,0,641,240,200,15,16,0
2020,730000222,28520,20,20,20,0,28500,28500,21500,7000,0,0,0,0,0,3000,1000,1000,0,1600,360,216,60,84,39
2020,730000232,79650,55200,55200,55200,0,24450,24000,24000,0,0,450,450,0,0,40,40,0,0,3820,500,200,600,300,600
2020,730000242,293752,3352,3352,3352,0,290400,238000,238000,0,0,52400,2400,0,50000,40000,40000,40000,0,1713,102,5,360,113,181
2020,730000262,31190,5790,5790,5790,0,25400,25000,25000,0,0,400,400,0,0,600,600,0,600,2070,300,40,180,180,89
2020,730000272,106600,40600,40600,35600,0,66000,64000,24000,40000,0,2000,2000,0,0,38500,18500,12000,2500,6220,360,500,500,360,238
2020,730000282,24000,400,400,400,0,23600,21000,21000,0,0,2600,2600,0,0,0,0,0,0,1116,288,100,126,84,32
2020,730000292,112380,13880,13880,13880,0,98500,95000,80000,15000,0,3500,3400,100,0,14470,13970,6970,7000,7532,480,500,500,252,3160
2020,730000302,5598,1098,1098,1098,0,4500,4500,4500,0,0,0,0,0,0,0,0,0,0,1058,117,360,93,36,11
2020,730000332,7634,2084,2084,2084,0,5550,4000,4000,0,0,1550,0,50,1500,250,250,250,0,763,54,150,215,24,8
2020,730000342,27974,17364,13864,13864,3500,10610,7900,0,7900,0,2710,2710,0,0,1790,1790,0,0,2103,217,74,600,90,52
2020,730000352,15852,15152,13152,13152,2000,700,0,0,0,0,700,700,0,0,600,600,600,0,4650,330,100,400,300,332
2020,730000372,108498,59398,59398,51898,0,49100,46000,41000,5000,0,3100,3100,0,0,7200,7200,7200,0,5522,600,300,182,200,680
2020,730000392,30247,14247,14247,14247,0,16000,15000,15000,0,0,1000,1000,0,0,1560,1560,1550,0,3880,300,1500,150,240,38
2020,730600221,183142,34742,34742,34742,0,148400,145000,37000,108000,0,3400,3400,0,0,14000,10000,10000,0,1732,172,400,350,90,339
2020,730600231,122742,57100,57100,57100,0,65642,62000,37000,25000,0,3642,1182,2460,0,3500,2500,0,2500,3094,300,400,600,204,324
2020,730600261,3060,3060,60,60,3000,0,0,0,0,0,0,0,0,0,0,0,0,0,420,84,43,10,32,2
2020,730600271,22422,20422,2422,2422,18000,2000,0,0,0,0,2000,2000,0,0,14144,14144,11844,400,2446,180,70,240,96,358
2020,730600291,33429,3109,3109,3109,0,30320,30000,10000,20000,0,320,320,0,0,16850,5850,800,4800,3980,120,100,80,420,95
2020,730600311,32460,6655,6655,6655,0,25805,22000,18000,4000,0,3805,3740,65,0,2400,2400,0,0,2540,250,50,600,300,172
2020,730600321,41528,11528,11528,11528,0,30000,30000,30000,0,0,0,0,0,0,0,0,0,0,2306,330,900,80,96,68
2020,730600331,5979,5979,1479,1479,4500,0,0,0,0,0,0,0,0,0,0,0,0,0,1050,250,120,20,70,20
2020,730600341,34262,16082,16082,16082,0,18180,16000,16000,0,0,2180,2180,0,0,9067,9067,2901,6166,2166,300,120,330,216,165
2020,730600371,59035,3235,3235,3235,0,55800,54500,17000,37500,0,1300,1300,0,0,0,0,0,0,2263,196,240,360,114,86
2020,730700231,20343,1343,1343,1343,0,19000,19000,19000,0,0,0,0,0,0,245,245,0,0,624,144,24,60,120,23
2020,730700261,10,10,10,10,0,0,0,0,0,0,0,0,0,0,2226,2226,0,2226,1308,180,120,48,120,1
2020,730700271,30120,5320,5320,4120,0,24800,24500,19500,5000,0,300,300,0,0,500,500,0,0,2280,220,100,120,120,43
2020,730700291,36648,7895,7895,7895,0,28753,27000,27000,0,0,1753,1700,53,0,18500,18500,18500,0,3112,360,50,360,192,265
2020,730700331,470,420,420,420,0,50,0,0,0,0,50,0,50,0,0,0,0,0,887,150,409,20,16,1
2020,730700341,37024,3154,3154,3154,0,33870,32800,5000,27800,0,1070,150,920,0,0,0,0,0,950,150,30,210,60,15
2020,730700351,101600,14150,14150,14150,0,87450,83850,7000,76850,0,3600,700,2900,0,0,0,0,0,1458,296,100,200,72,105
2020,730700361,2690,2690,1740,1740,950,0,0,0,0,0,0,0,0,0,130,130,0,0,1915,360,5,120,120,3
2020,730700381,13944,1444,1444,1444,0,12500,10000,10000,0,0,2500,2500,0,0,0,0,0,0,1374,180,120,120,54,16
2020,730700391,16836,1036,1036,1036,0,15800,15000,15000,0,0,800,400,400,0,4500,4500,700,0,3294,210,120,120,144,51
2020,730800241,5765,65,65,65,0,5700,5700,5700,0,0,0,0,0,0,0,0,0,0,464,58,18,60,24,8
2020,730800261,71673,66606,49606,48606,17000,5067,4000,0,0,4000,1067,337,730,0,0,0,0,0,4154,332,240,280,216,299
2020,730800271,221568,76423,76423,76423,0,145145,142000,54000,88000,0,3145,3000,145,0,0,0,0,0,4842,559,156,360,206,13901
2020,730800281,7350,7200,6700,6700,500,150,0,0,0,0,150,150,0,0,0,0,0,0,3096,744,360,360,216,292
2020,730800301,10300,300,300,300,0,10000,10000,5000,5000,0,0,0,0,0,0,0,0,0,430,82,100,10,18,7
2020,730800311,13278,4478,4478,4478,0,8800,8000,8000,0,0,800,800,0,0,0,0,0,0,2360,360,100,300,240,72
2020,730800321,30532,532,532,532,0,30000,30000,30000,0,0,0,0,0,0,6150,6000,6000,0,1024,320,60,60,24,39
2020,730800331,30134,1785,1785,1785,0,28349,23789,5789,18000,0,4560,2260,0,2300,900,900,0,900,2420,200,200,120,60,45
2020,730800351,24220,1220,1220,1220,0,23000,23000,23000,0,0,0,0,0,0,0,0,0,0,530,126,180,10,10,6
2020,730800371,26660,7480,7480,7480,0,19180,19000,9000,10000,0,180,180,0,0,0,0,0,0,2080,204,100,190,96,59
2020,730800381,210178,113478,113478,113478,0,96700,90000,30000,60000,0,6700,5700,1000,0,1000,0,0,0,5920,450,550,456,230,1091
2020,730900201,150,150,50,50,100,0,0,0,0,0,0,0,0,0,0,0,0,0,1452,543,18,108,84,1
2020,730900221,10600,600,600,600,0,10000,10000,10000,0,0,0,0,0,0,0,0,0,0,599,100,30,10,24,70
2020,730900231,893,677,277,277,400,216,0,0,0,0,216,150,66,0,476,476,0,476,898,144,114,120,120,17
2020,730900241,33714,4934,4934,4934,0,28780,28000,28000,0,0,780,780,0,0,28000,28000,15000,9000,5040,300,250,330,360,69
2020,730900251,105317,3100,3100,3100,0,102217,100300,62300,38000,0,1917,1617,300,0,0,0,0,0,2707,460,100,250,240,239
2020,730900261,395647,32147,32147,26147,0,363500,363500,76500,287000,0,0,0,0,0,112000,80000,76000,4000,5180,600,360,0,180,1038
2020,730900291,87540,16540,16540,14540,0,71000,46000,46000,0,0,25000,9000,10000,6000,17520,17520,17520,0,3220,110,50,400,300,581
2020,730900311,27900,3660,3660,3160,0,24240,21000,21000,0,0,3240,240,1000,2000,7400,7400,7000,0,2228,740,240,180,90,470
2020,730900321,12350,1050,1050,1050,0,11300,11000,6000,5000,0,300,300,0,0,2700,0,0,0,1747,200,145,120,47,47
2020,730900341,14200,6850,6850,6850,0,7350,7000,7000,0,0,350,350,0,0,0,0,0,0,764,196,42,24,28,93
2020,730900351,18565,941,941,641,0,17624,17000,17000,0,0,624,350,274,0,18000,18000,16000,1900,2386,540,120,180,336,97
2020,730900381,19923,5310,5310,3310,0,14613,7800,7800,0,0,6813,4700,2113,0,5500,5500,2500,0,4409,336,20,840,252,185
2020,730900391,46382,6682,6682,6682,0,39700,30000,30000,0,0,9700,1700,8000,0,13883,13883,13883,0,4348,300,100,360,204,125
2020,731000202,145338,4160,4160,4160,0,141178,140000,70000,70000,0,1178,500,678,0,2000,0,0,0,4860,600,300,240,96,911
2020,731000222,18600,18200,1200,1200,17000,400,0,0,0,0,400,300,100,0,0,0,0,0,958,300,50,72,120,41
2020,731000232,45870,520,520,520,0,45350,45000,45000,0,0,350,200,150,0,20900,20900,18900,2000,4084,360,80,300,240,219
2020,731000242,8041,7480,4780,4780,2700,561,0,0,0,0,561,561,0,0,1020,1020,900,0,3102,552,700,240,60,32
2020,731000262,15400,3400,3400,3400,0,12000,12000,12000,0,0,0,0,0,0,7900,7900,7000,900,1512,240,60,192,180,21
2020,731000272,29418,28668,5668,5668,23000,750,0,0,0,0,750,750,0,0,3667,3667,3667,0,3396,156,70,180,420,27
2020,731000302,23784,5184,5184,5184,0,18600,18000,18000,0,0,600,600,0,0,0,0,0,0,2924,370,100,380,250,724
2020,731000332,11280,1280,1280,1280,0,10000,10000,10000,0,0,0,0,0,0,0,0,0,0,914,168,24,33,24,9
2020,731000362,27840,100,100,100,0,27740,25150,25150,0,0,2590,2590,0,0,10230,10230,10000,0,3260,240,120,150,240,98
2020,731000372,4400,4400,2000,2000,2400,0,0,0,0,0,0,0,0,0,0,0,0,0,670,360,60,60,60,1
2020,731000382,4630,1580,280,280,1300,3050,3000,0,3000,0,50,50,0,0,6000,6000,0,6000,2286,288,20,58,170,20
2020,731000392,1824,1824,524,524,1300,0,0,0,0,0,0,0,0,0,0,0,0,0,1010,252,20,60,48,17
2020,731600221,43080,35300,11300,11300,24000,7780,4000,0,4000,0,3780,2980,800,0,22,22,0,0,3594,540,10,480,150,333
2020,731600231,197842,24662,24662,14662,0,173180,172700,47700,125000,0,480,150,330,0,19978,14978,14978,0,1915,210,50,60,145,1207
2020,731600261,2987,2964,2964,2964,0,23,0,0,0,0,23,0,23,0,670,670,670,0,1272,132,360,96,96,11
2020,731600271,14994,1194,1194,1114,0,13800,10000,10000,0,0,3800,3500,0,300,10036,10036,10000,0,5516,300,1000,960,300,119
2020,731600291,8300,300,300,300,0,8000,8000,8000,0,0,0,0,0,0,0,0,0,0,396,80,100,10,36,10
2020,731600301,187,187,187,187,0,0,0,0,0,0,0,0,0,0,0,0,0,0,786,145,255,56,20,1
2020,731600311,13160,5460,5460,5460,0,7700,7700,0,7700,0,0,0,0,0,0,0,0,0,1198,236,36,20,36,16
2020,731600321,28010,6558,6558,6558,0,21452,15000,15000,0,0,6452,6000,452,0,4000,4000,0,0,2849,225,50,600,144,105
2020,731600331,26354,5325,5325,5325,0,21029,20000,6000,14000,0,1029,900,129,0,0,0,0,0,1440,220,120,360,120,47
2020,731600351,39054,13828,13828,12328,0,25226,17000,17000,0,0,8226,5000,226,3000,5485,5485,5485,0,3924,240,20,400,192,232
2020,731600361,22503,21738,14238,14238,7500,765,0,0,0,0,765,200,565,0,50,50,0,0,3393,228,60,446,300,681
2020,731600371,9064,8279,2279,2279,6000,785,0,0,0,0,785,650,135,0,4050,4050,3500,450,3796,276,100,480,240,265
2020,731600381,18330,5900,5900,5900,0,12430,11000,8000,3000,0,1430,1400,30,0,272,272,0,0,940,240,96,144,60,30
2020,731700211,34440,33640,15640,15640,18000,800,0,0,0,0,800,800,0,0,15002,15002,14002,1000,3084,268,36,480,156,321
2020,731700221,8650,650,650,650,0,8000,8000,8000,0,0,0,0,0,0,100,0,0,0,870,120,130,25,50,23
2020,731700231,9210,1510,1510,1510,0,7700,7500,7500,0,0,200,0,200,0,0,0,0,0,1373,162,70,81,104,12
2020,731700241,1327,1327,977,977,350,0,0,0,0,0,0,0,0,0,60,60,0,0,919,127,140,60,37,1
2020,731700251,12742,976,976,976,0,11766,11500,11500,0,0,266,210,56,0,8500,8500,7000,0,2265,124,50,180,216,57
2020,731700261,94356,27166,27166,27166,0,67190,64000,46000,18000,0,3190,2500,690,0,1000,0,0,0,5238,348,150,200,360,1322
2020,731700301,95426,36626,36626,34626,0,58800,56000,33000,23000,0,2800,500,300,2000,15100,0,0,0,5875,420,400,600,300,883
2020,731700331,2096,2096,2096,2096,0,0,0,0,0,0,0,0,0,0,110,110,0,0,646,80,100,15,12,1
2020,731700361,58132,18132,18132,18132,0,40000,40000,40000,0,0,0,0,0,0,500,0,0,0,1788,144,200,60,96,110
2020,731700381,14340,5840,5840,5840,0,8500,7600,7600,0,0,900,900,0,0,9000,9000,6000,3000,1810,210,220,400,200,32
2020,731800201,81610,9910,9910,4910,0,71700,66000,45000,0,21000,5700,3700,1500,500,16000,16000,16000,0,6210,360,600,700,250,253
2020,731800211,34077,3770,3770,3770,0,30307,30000,30000,0,0,307,307,0,0,5800,5800,5300,400,4150,300,500,250,200,391
2020,731800231,7500,7500,5500,5500,2000,0,0,0,0,0,0,0,0,0,0,0,0,0,720,150,100,10,50,1
2020,731800241,38838,838,838,838,0,38000,30000,25000,5000,0,8000,500,0,7500,6550,3050,3030,0,2108,180,36,480,120,22
2020,731800251,202936,19936,7936,7936,12000,183000,183000,0,183000,0,0,0,0,0,21300,0,0,0,2036,276,450,50,240,214
2020,731800281,24552,6662,6662,6662,0,17890,17500,17500,0,0,390,390,0,0,7116,7116,7100,0,2117,276,15,288,138,59
2020,731800321,7972,1492,1492,1492,0,6480,4800,4800,0,0,1680,680,1000,0,200,200,0,200,1710,200,350,280,110,21
2020,731800331,40030,6510,6510,3510,0,33520,31000,27500,0,3500,2520,2520,0,0,21684,21684,19352,1600,3450,420,120,500,300,178
2020,731800341,4508,4508,4508,4508,0,0,0,0,0,0,0,0,0,0,0,0,0,0,1531,247,4,50,180,1
2020,731800371,7673,988,988,988,0,6685,6600,4000,2600,0,85,0,85,0,0,0,0,0,1310,100,600,10,50,13
2020,731900211,8419,8057,2057,2057,6000,362,0,0,0,0,362,327,35,0,5930,5930,5130,600,1778,126,20,540,156,16
2020,731900231,7630,5630,130,130,5500,2000,0,0,0,0,2000,2000,0,0,4250,4250,3250,0,2870,360,50,240,240,65
2020,731900241,5840,5540,2040,2040,3500,300,0,0,0,0,300,300,0,0,200,200,0,0,1774,600,100,480,60,14
2020,731900271,8307,977,977,977,0,7330,6700,6700,0,0,630,630,0,0,500,500,300,200,1933,130,23,480,170,35
2020,731900291,43500,10000,10000,10000,0,33500,33500,26000,7500,0,0,0,0,0,223,223,0,0,1181,264,30,60,72,67
2020,731900301,70400,400,400,400,0,70000,70000,55000,15000,0,0,0,0,0,0,0,0,0,1820,230,400,70,72,133
2020,731900311,22708,2042,1042,1042,1000,20666,20000,0,20000,0,666,666,0,0,0,0,0,0,474,50,5,60,29,19
2020,731900321,4200,300,200,200,100,3900,3700,0,1000,2700,200,0,200,0,0,0,0,0,1224,108,100,96,60,8
2020,731900331,14020,1220,1220,1220,0,12800,10000,10000,0,0,2800,2800,0,0,5880,5880,4500,0,2770,300,50,600,180,84
2020,731900341,14790,11970,9970,9970,2000,2820,2400,0,2400,0,420,420,0,0,1000,0,0,0,6541,890,240,200,120,53
2020,731900361,42700,14300,14300,14300,0,28400,24500,24500,0,0,3900,3900,0,0,0,0,0,0,4530,360,60,360,230,3262
2020,731900371,38046,34746,4746,2246,30000,3300,0,0,0,0,3300,3300,0,0,0,0,0,0,3770,600,120,300,240,1670
2020,731900381,100,100,100,100,0,0,0,0,0,0,0,0,0,0,0,0,0,0,523,136,20,20,17,3
2020,731900391,36750,6570,6570,6570,0,30180,28000,8000,20000,0,2180,1580,600,0,3000,3000,3000,0,1937,300,450,270,160,75
2020,732000202,28634,10504,8504,8504,2000,18130,18000,0,16000,2000,130,0,130,0,942,942,0,320,6274,756,420,438,346,516
2020,732000232,22141,141,141,141,0,22000,22000,22000,0,0,0,0,0,0,1500,0,0,0,1188,240,30,18,72,53
2020,732000252,47993,24445,9445,5945,15000,23548,21500,0,21500,0,2048,2048,0,0,19365,19365,3500,15000,3360,240,120,480,360,120
2020,732000262,2782,2782,782,782,2000,0,0,0,0,0,0,0,0,0,0,0,0,0,3112,1020,170,200,180,1
2020,732000272,2370,2370,570,570,1800,0,0,0,0,0,0,0,0,0,0,0,0,0,317,84,20,0,10,1
2020,732000282,1200,900,600,100,300,300,0,0,0,0,300,0,300,0,0,0,0,0,1676,360,20,240,96,1
2020,732000292,18470,3470,3470,3470,0,15000,15000,15000,0,0,0,0,0,0,800,0,0,0,828,120,30,10,58,9
2020,732000322,200,200,200,200,0,0,0,0,0,0,0,0,0,0,0,0,0,0,414,157,64,33,15,1
2020,732600231,5726,5726,1926,1926,3800,0,0,0,0,0,0,0,0,0,3700,3700,2100,669,867,288,10,120,60,1
2020,732600261,43464,6064,6064,6064,0,37400,34500,14000,20500,0,2900,2900,0,0,5000,5000,4000,500,3492,144,300,396,336,125
2020,732600271,108528,24628,24628,18628,0,83900,75500,9000,66500,0,8400,900,2500,5000,44557,39057,39057,0,4130,102,235,420,348,722
2020,732600291,96820,40820,40820,40820,0,56000,55000,55000,0,0,1000,1000,0,0,0,0,0,0,5380,540,200,600,420,206
2020,732700201,34753,5057,5057,4157,0,29696,27000,27000,0,0,2696,392,2304,0,22162,22162,17192,4220,4035,424,5,200,336,220
2020,732700221,79300,18300,18300,18300,0,61000,54000,22000,30000,2000,7000,7000,0,0,6500,6500,0,0,8310,320,400,700,450,1699
2020,732700261,5192,5192,4192,4192,1000,0,0,0,0,0,0,0,0,0,0,0,0,0,1700,334,30,144,216,16
2020,732700281,69481,2881,2881,2881,0,66600,66000,50000,16000,0,600,600,0,0,18330,5330,2500,1330,4804,420,550,264,240,438
2020,732700291,5104,5104,5004,5004,100,0,0,0,0,0,0,0,0,0,0,0,0,0,3590,600,200,100,300,42
2020,732700301,1705,5,5,5,0,1700,0,0,0,0,1700,1700,0,0,0,0,0,0,1420,250,240,360,70,4
2020,732700311,1090,820,820,820,0,270,0,0,0,0,270,0,270,0,0,0,0,0,1990,120,1070,100,50,1
2020,732700331,66973,5973,5973,5173,0,61000,41000,15000,26000,0,20000,9000,1000,10000,12700,12700,10200,0,2608,108,120,132,120,184
2020,732800211,41264,13664,13664,13664,0,27600,27000,27000,0,0,600,600,0,0,0,0,0,0,3280,320,90,320,240,353
2020,732800231,47816,6020,6020,6020,0,41796,40000,40000,0,0,1796,1796,0,0,6500,6500,4000,2500,2500,300,60,120,360,630
2020,732800251,3165,2065,1565,1565,500,1100,0,0,0,0,1100,1100,0,0,2410,2410,310,1800,4423,840,150,385,259,17
2020,732800281,17148,1148,1148,1148,0,16000,16000,16000,0,0,0,0,0,0,1900,1900,1900,0,2960,480,900,240,180,304
2020,732800301,7760,7760,260,260,7500,0,0,0,0,0,0,0,0,0,5800,5800,5800,0,1436,60,120,120,96,1
2020,732800311,25515,315,315,315,0,25200,24900,2500,22400,0,300,0,300,0,1216,1216,0,1216,744,30,96,42,36,27
2020,732800321,14100,9000,9000,9000,0,5100,5000,5000,0,0,100,0,100,0,0,0,0,0,897,121,60,50,0,2
2020,732800331,18800,1800,1800,1800,0,17000,15000,15000,0,0,2000,2000,0,0,0,0,0,0,482,225,60,10,15,864
2020,732900201,25005,2005,2005,2005,0,23000,23000,23000,0,0,0,0,0,0,0,0,0,0,1383,204,598,20,6,25
2020,732900211,66590,41090,41090,41090,0,25500,25500,25500,0,0,0,0,0,0,0,0,0,0,1788,276,200,144,98,133
2020,732900241,500,500,200,200,300,0,0,0,0,0,0,0,0,0,10000,10000,0,10000,1920,600,20,240,240,1
2020,732900261,21010,10,10,10,0,21000,21000,21000,0,0,0,0,0,0,0,0,0,0,781,150,120,10,64,19
2020,732900281,2183,1283,583,583,700,900,0,0,0,0,900,900,0,0,2905,2905,0,1955,3103,480,180,600,264,90
2020,732900291,95700,11400,11400,11400,0,84300,82700,15000,67700,0,1600,1600,0,0,0,0,0,0,1430,240,240,120,90,129
2020,732900301,4010,190,190,190,0,3820,3700,500,3200,0,120,0,120,0,0,0,0,0,929,80,240,10,24,5
2020,732900321,10280,380,380,380,0,9900,5000,5000,0,0,4900,4900,0,0,1800,1800,0,0,1113,191,50,68,132,52
2020,733000212,38810,6150,6150,1150,0,32660,32400,15000,17400,0,260,260,0,0,5000,0,0,0,830,110,25,70,15,24
2020,733000222,500,500,500,500,0,0,0,0,0,0,0,0,0,0,0,0,0,0,602,212,60,0,10,1
2020,733600211,3600,100,100,100,0,3500,3500,3500,0,0,0,0,0,0,0,0,0,0,385,120,20,10,15,2
2020,733600221,50,50,50,50,0,0,0,0,0,0,0,0,0,0,0,0,0,0,410,120,15,15,20,1
2020,733900201,141770,100,100,100,0,141670,140650,64400,76250,0,1020,0,1020,0,6905,6905,4735,2170,882,68,110,24,20,30
2020,740000212,89294,8748,8748,8748,0,80546,75000,75000,0,0,5546,5000,546,0,0,0,0,0,6721,460,570,670,810,178
2020,740000222,31199,6449,6449,6449,0,24750,21800,19700,0,2100,2950,2950,0,0,5300,5300,5000,0,5549,194,761,239,376,69
2020,740000232,27278,8933,8933,8933,0,18345,17200,17200,0,0,1145,1100,45,0,2000,2000,2000,0,5069,361,1063,362,361,114
2020,740000252,202,202,2,2,200,0,0,0,0,0,0,0,0,0,0,0,0,0,803,120,10,15,15,0
2020,740000262,12660,2400,2400,2400,0,10260,10000,10000,0,0,260,260,0,0,1500,1500,1500,0,1648,132,63,252,84,46
2020,740000282,49822,21322,21322,21322,0,28500,21200,21200,0,0,7300,7300,0,0,7600,7600,0,0,5707,325,10,480,243,1971
2020,740000292,10114,114,114,114,0,10000,10000,10000,0,0,0,0,0,0,0,0,0,0,1039,174,199,43,24,18
2020,740000302,49566,12640,12640,12140,0,36926,30000,30000,0,0,6926,4000,2226,700,10000,10000,10000,0,6420,480,200,240,300,67
2020,740000312,25792,5192,5192,5192,0,20600,20000,20000,0,0,600,600,0,0,2000,2000,0,0,2120,360,300,200,210,72
2020,740000332,15382,2580,2280,2280,300,12802,12000,0,12000,0,802,350,452,0,14900,5900,5900,0,5650,100,100,300,250,787
2020,740000362,370,370,70,70,300,0,0,0,0,0,0,0,0,0,300,300,0,300,841,120,5,40,156,99
2020,740000372,43531,8531,8531,8531,0,35000,32000,27000,5000,0,3000,3000,0,0,5050,50,0,0,3390,300,470,700,250,341
2020,740000382,290,290,190,190,100,0,0,0,0,0,0,0,0,0,1120,1120,0,1120,468,48,5,60,53,0
2020,740000392,3340,3340,340,340,3000,0,0,0,0,0,0,0,0,0,800,800,0,800,974,120,60,60,84,0
2020,740600201,71322,17858,17858,17858,0,53464,51000,51000,0,0,2464,1930,534,0,2000,2000,2000,0,4999,428,55,422,329,4986
2020,740600221,66226,27856,13356,13356,14500,38370,38000,0,38000,0,370,170,200,0,44000,40000,30000,10000,4960,250,1070,470,240,201
2020,740600231,55273,15753,15753,15753,0,39520,39200,33000,6200,0,320,320,0,0,0,0,0,0,2534,300,251,480,300,248
2020,740600241,56230,14698,14698,14698,0,41532,41200,39200,2000,0,332,250,82,0,13000,13000,0,13000,9308,450,250,1350,300,3445
2020,740600251,71,71,71,71,0,0,0,0,0,0,0,0,0,0,0,0,0,0,919,228,153,79,54,1
2020,740600271,36056,14692,14692,12692,0,21364,15500,15500,0,0,5864,720,5144,0,4500,4500,4500,0,3685,214,158,75,192,58
2020,740600281,2604,2562,2562,2562,0,42,0,0,0,0,42,0,42,0,57,57,0,0,1323,161,16,81,77,1
2020,740600321,5436,2936,936,536,2000,2500,0,0,0,0,2500,2400,100,0,3650,3650,0,2000,2500,480,60,360,170,25
2020,740600341,81660,7860,7860,7860,0,73800,47000,0,40000,7000,26800,6800,20000,0,36380,36380,30280,6100,7060,600,250,850,240,656
2020,740600381,31780,15380,15380,15380,0,16400,15000,15000,0,0,1400,1400,0,0,3968,3968,3968,0,2978,324,300,130,240,68
2020,740600391,15738,1120,1120,1120,0,14618,14550,11724,2826,0,68,0,68,0,0,0,0,0,880,325,61,5,26,12
2020,740700221,22081,3831,3831,3831,0,18250,17100,17100,0,0,1150,1000,150,0,6100,6100,6100,0,1842,132,182,301,201,84
2020,740700261,43467,10537,10537,10537,0,32930,27800,23300,0,4500,5130,5130,0,0,9436,9436,9436,0,3475,198,48,345,192,118
2020,740700271,38588,15420,15420,15420,0,23168,23100,23100,0,0,68,0,68,0,0,0,0,0,868,360,30,48,24,60
2020,740700281,87094,17342,17342,16342,0,69752,56000,56000,0,0,13752,13100,652,0,30050,30050,26724,2892,6084,601,132,507,309,759
2020,740700291,2210,2193,1993,1993,200,17,0,0,0,0,17,0,17,0,0,0,0,0,1118,490,42,44,112,1
2020,740700301,23780,4380,4380,3380,0,19400,16000,16000,0,0,3400,3200,200,0,0,0,0,0,1818,250,80,180,84,97
2020,740700311,25700,5500,5500,5500,0,20200,15000,15000,0,0,5200,3200,2000,0,13790,13790,11990,800,2625,220,100,360,170,210
2020,740700331,5098,5098,5098,5098,0,0,0,0,0,0,0,0,0,0,1020,1020,0,0,2680,132,240,240,480,13
2020,740700341,33140,4690,4690,4690,0,28450,13500,13500,0,0,14950,950,14000,0,0,0,0,0,2127,432,300,100,120,258
2020,740700361,27298,24298,6298,6298,18000,3000,0,0,0,0,3000,3000,0,0,9000,9000,9000,0,2660,260,120,360,120,120
2020,740700391,57121,33721,33721,25321,0,23400,18000,18000,0,0,5400,4400,1000,0,5100,5100,3600,0,4674,510,150,284,300,282
2020,740800211,18152,777,777,777,0,17375,16500,16500,0,0,875,700,175,0,15000,11000,11000,0,1521,150,280,190,72,97
2020,740800251,27945,270,270,270,0,27675,27500,19000,8500,0,175,0,175,0,0,0,0,0,980,95,30,95,70,13
2020,740800271,51361,5208,5208,5208,0,46153,41000,31000,10000,0,5153,4780,373,0,100,100,0,0,2938,336,135,683,78,185
2020,740800281,10405,405,405,405,0,10000,10000,10000,0,0,0,0,0,0,0,0,0,0,2007,134,1012,238,42,12
2020,740800291,11301,2277,2277,2277,0,9024,9000,9000,0,0,24,0,24,0,0,0,0,0,2828,125,2015,98,32,9
2020,740800301,19878,1678,1678,1678,0,18200,18200,18200,0,0,0,0,0,0,15121,15121,13188,1933,692,172,36,84,120,177
2020,740800311,21800,300,300,300,0,21500,20000,10000,10000,0,1500,1500,0,0,11516,11516,11516,0,1910,150,20,200,250,58
2020,740800321,50210,50210,50210,210,0,0,0,0,0,0,0,0,0,0,3500,3500,0,0,1720,120,50,200,170,1
2020,740800331,33660,3510,3510,3010,0,30150,30000,30000,0,0,150,150,0,0,21000,21000,21000,0,1250,160,10,120,120,734
2020,740800341,30730,8630,8630,8630,0,22100,20000,20000,0,0,2100,2100,0,0,5240,5240,5240,0,5550,600,300,300,400,2056
2020,740800381,30395,10745,10745,9745,0,19650,15000,15000,0,0,4650,650,4000,0,4975,4975,4975,0,6900,300,400,500,200,26
2020,740900201,6501,5001,5001,3001,0,1500,0,0,0,0,1500,980,520,0,210,210,0,0,1438,336,168,183,84,608
2020,740900211,7420,270,270,270,0,7150,7150,7150,0,0,0,0,0,0,0,0,0,0,702,76,68,11,48,6
2020,740900221,2538,188,188,188,0,2350,2350,2350,0,0,0,0,0,0,0,0,0,0,556,51,2,120,41,4
2020,740900241,71415,51240,51240,51240,0,20175,19000,19000,0,0,1175,350,825,0,0,0,0,0,9606,420,540,360,96,207
2020,740900251,13682,11,11,11,0,13671,13600,13600,0,0,71,0,71,0,0,0,0,0,291,54,48,40,18,18
2020,740900261,52338,2728,2728,2728,0,49610,49000,15000,34000,0,610,410,200,0,0,0,0,0,2568,291,500,156,48,55
2020,740900281,47595,10144,10144,10144,0,37451,37000,17000,20000,0,451,225,226,0,2300,2300,0,2300,3824,905,249,828,205,509
2020,740900291,111314,22724,22724,2724,0,88590,76000,76000,0,0,12590,2250,10340,0,19375,19375,6575,7800,5564,384,62,125,216,2320
2020,740900301,10025,625,625,625,0,9400,7500,7500,0,0,1900,1900,0,0,2425,2425,0,0,3800,170,2000,150,200,180
2020,740900311,28576,1476,1476,1476,0,27100,26500,17000,9500,0,600,600,0,0,0,0,0,0,1390,150,50,190,60,86
2020,740900351,200,200,100,100,100,0,0,0,0,0,0,0,0,0,0,0,0,0,1855,300,5,50,200,0
2020,740900381,161038,80138,68638,68638,11500,80900,80000,0,80000,0,900,900,0,0,30200,30200,17200,13000,9400,1800,100,600,500,356
2020,741000202,375,375,325,325,50,0,0,0,0,0,0,0,0,0,0,0,0,0,1558,336,65,15,144,62
2020,741000212,35439,8213,8213,8213,0,27226,27000,12000,15000,0,226,0,226,0,14030,14030,13600,0,5248,660,120,150,300,191
2020,741000222,10605,723,723,723,0,9882,9800,9800,0,0,82,0,82,0,6000,6000,6000,0,4384,408,120,720,432,27
2020,741000232,25948,948,648,648,300,25000,25000,0,25000,0,0,0,0,0,15416,13416,11416,2000,1595,420,25,120,96,79
2020,741000242,96568,49553,49553,49553,0,47015,47000,10000,37000,0,15,0,15,0,0,0,0,0,1108,168,48,84,118,293
2020,741000252,46480,3780,3780,3780,0,42700,41800,29000,9800,3000,900,900,0,0,5540,5040,0,5000,4852,420,1000,600,180,1314
2020,741000262,79336,33136,33136,33136,0,46200,45500,40000,5500,0,700,700,0,0,0,0,0,0,4019,276,350,242,240,1428
2020,741000272,43479,6279,6279,6279,0,37200,35000,35000,0,0,2200,2200,0,0,19278,19278,19238,0,5307,228,118,669,342,857
2020,741000282,85284,3614,3614,3614,0,81670,81500,81500,0,0,170,0,170,0,25000,25000,25000,0,3980,240,120,600,480,894
2020,741000292,43712,14712,14712,14412,0,29000,29000,29000,0,0,0,0,0,0,212,212,0,0,5832,956,120,240,486,791
2020,741000302,75070,2870,2870,2870,0,72200,71000,10000,61000,0,1200,700,500,0,17600,17600,17600,0,5906,480,50,276,200,3303
2020,741000332,10,10,10,10,0,0,0,0,0,0,0,0,0,0,0,0,0,0,1516,60,20,30,66,307
2020,741000352,46310,2710,2710,2710,0,43600,43600,8000,35600,0,0,0,0,0,0,0,0,0,934,144,120,100,80,53
2020,741000362,12884,661,661,661,0,12223,3500,3500,0,0,8723,900,23,7800,0,0,0,0,2090,200,40,100,150,10
2020,741000372,10601,201,201,201,0,10400,10400,3400,7000,0,0,0,0,0,0,0,0,0,1144,360,180,20,36,7
2020,741000392,74426,30100,30100,30100,0,44326,44000,6000,38000,0,326,50,276,0,800,800,800,0,2483,126,1110,180,72,32
2020,741600201,19959,1101,1101,1101,0,18858,18700,15200,3500,0,158,0,158,0,7150,4650,4650,0,833,151,162,54,24,16
2020,741600211,20202,2264,2264,2264,0,17938,17600,15000,2600,0,338,240,98,0,0,0,0,0,1410,167,180,204,86,26
2020,741600221,9851,51,51,51,0,9800,9800,9800,0,0,0,0,0,0,0,0,0,0,534,63,96,27,26,11
2020,741600231,19651,1021,1021,1021,0,18630,18500,17500,1000,0,130,0,130,0,0,0,0,0,1212,156,101,36,24,77
2020,741600251,34747,7197,7197,7197,0,27550,24800,24000,800,0,2750,2600,150,0,0,0,0,0,4487,324,96,421,245,672
2020,741600261,87451,32338,32338,31338,0,55113,53000,48000,0,5000,2113,2000,113,0,18500,18500,3000,3500,5948,355,516,701,353,1160
2020,741600271,10632,200,200,200,0,10432,10400,10400,0,0,32,0,32,0,15,15,0,0,1020,240,36,30,18,51
2020,741600281,14146,12346,546,446,11800,1800,0,0,0,0,1800,1700,100,0,9400,9400,9400,0,2194,439,176,250,140,33
2020,741600291,2046,2046,746,746,1300,0,0,0,0,0,0,0,0,0,1100,1100,1100,0,945,32,61,24,48,1
2020,741600321,33706,7206,7206,7206,0,26500,23000,23000,0,0,3500,3500,0,0,16100,16100,15000,800,3032,240,120,272,200,36
2020,741600391,30234,7234,7234,6850,0,23000,22000,22000,0,0,1000,1000,0,0,1500,1500,1500,0,4156,252,100,360,144,427
2020,741700211,899,899,336,336,563,0,0,0,0,0,0,0,0,0,0,0,0,0,668,114,15,60,48,1
2020,741700271,22975,1075,1075,1075,0,21900,21900,5400,16500,0,0,0,0,0,0,0,0,0,1078,123,38,36,28,18
2020,741700281,23741,421,421,421,0,23320,22000,22000,0,0,1320,1320,0,0,0,0,0,0,1437,311,136,240,108,93
2020,741700291,70879,43898,43898,43898,0,26981,22000,22000,0,0,4981,4800,181,0,0,0,0,0,1983,216,216,120,72,285
2020,741700311,41020,5820,5820,5820,0,35200,35000,35000,0,0,200,200,0,0,23000,23000,17000,6000,2900,330,45,120,115,620
2020,741700321,4160,2460,2160,1160,300,1700,0,0,0,0,1700,500,1000,200,550,550,0,550,1108,108,60,180,240,85
2020,741700361,33450,1450,1450,1450,0,32000,20000,5000,15000,0,12000,2000,10000,0,7000,7000,7000,0,1357,290,102,115,90,60
2020,741700371,3920,3920,3920,3920,0,0,0,0,0,0,0,0,0,0,637,637,0,637,2150,300,120,400,250,10
2020,741700381,13116,4316,4316,4316,0,8800,7000,7000,0,0,1800,1800,0,0,0,0,0,0,2820,240,540,600,120,345
2020,741800211,31104,7078,7078,7078,0,24026,23000,20000,3000,0,1026,800,226,0,0,0,0,0,2151,243,23,282,96,46
2020,741800241,9313,8696,3896,3896,4800,617,0,0,0,0,617,600,17,0,4750,4750,0,4400,1912,96,10,180,120,374
2020,741800251,13705,4223,4223,4223,0,9482,8900,8900,0,0,582,520,62,0,0,0,0,0,1914,156,40,301,180,33
2020,741800261,491,491,191,191,300,0,0,0,0,0,0,0,0,0,0,0,0,0,949,60,8,18,174,0
2020,741800271,2304,2255,755,755,1500,49,0,0,0,0,49,0,49,0,0,0,0,0,805,192,65,72,34,1
2020,741800281,611,611,11,11,600,0,0,0,0,0,0,0,0,0,3800,3800,0,0,1072,435,75,52,145,28
2020,741800301,20852,17900,1900,1900,16000,2952,0,0,0,0,2952,2500,452,0,0,0,0,0,2450,260,80,420,120,56
2020,741800311,30,30,30,30,0,0,0,0,0,0,0,0,0,0,0,0,0,0,508,170,135,18,30,1
2020,741900211,36476,896,896,896,0,35580,35000,35000,0,0,580,0,580,0,4600,0,0,0,1324,152,115,238,72,72
2020,741900231,108712,13612,13612,13612,0,95100,95000,65000,30000,0,100,0,100,0,3000,0,0,0,1473,346,118,72,59,107
2020,741900241,21506,8360,8360,8360,0,13146,12000,12000,0,0,1146,1100,46,0,30,30,0,0,1351,132,130,31,41,34
2020,741900271,89711,28459,11459,11459,17000,61252,58000,0,58000,0,3252,2800,452,0,30500,3500,0,3500,4831,324,62,543,252,447
2020,741900281,20160,18312,13312,13312,5000,1848,0,0,0,0,1848,1800,48,0,0,0,0,0,4200,390,640,530,360,38
2020,741900291,2397,2397,835,835,1562,0,0,0,0,0,0,0,0,0,0,0,0,0,710,192,115,54,23,0
2020,741900301,21720,3120,3120,3120,0,18600,14000,2000,12000,0,4600,250,4350,0,13000,13000,8000,5000,4560,400,250,500,400,95
2020,741900321,44040,11090,11090,11090,0,32950,30500,5500,25000,0,2450,900,1550,0,2426,2426,0,2426,1668,208,262,56,132,41
2020,741900361,56300,5300,5300,5300,0,51000,47000,47000,0,0,4000,4000,0,0,23685,23685,19685,4000,7980,480,300,1000,300,766
2020,741900391,1552,1552,352,352,1200,0,0,0,0,0,0,0,0,0,0,0,0,0,629,192,18,25,84,1
2020,742000212,2176,1225,225,225,1000,951,0,0,0,0,951,886,65,0,0,0,0,0,2189,612,30,360,54,49
2020,742000222,17313,3813,3813,3813,0,13500,12000,12000,0,0,1500,1500,0,0,8700,8700,6000,2700,2455,241,181,481,132,72
2020,742000232,111,111,11,11,100,0,0,0,0,0,0,0,0,0,0,0,0,0,1340,360,30,20,168,0
2020,742000312,28610,2520,2520,2520,0,26090,20200,4000,16200,0,5890,4680,1210,0,11800,11800,11800,0,3478,70,20,890,348,95
2020,742000322,12302,400,400,400,0,11902,11902,3500,8402,0,0,0,0,0,0,0,0,0,1906,144,1100,36,52,7
2020,742000332,4720,600,600,600,0,4120,4000,4000,0,0,120,120,0,0,445,445,0,445,1789,534,112,60,148,20
2020,742000342,43144,2214,2214,2214,0,40930,39000,25000,14000,0,1930,1930,0,0,9000,9000,8000,1000,1994,230,10,480,360,692
2020,742000372,12359,11859,9859,9859,2000,500,0,0,0,0,500,500,0,0,2000,2000,0,2000,3581,444,50,350,324,249
2020,742000392,101752,49652,49652,34652,0,52100,46000,21000,25000,0,6100,4100,2000,0,1500,500,0,0,7740,1500,650,750,300,3103
2020,742600211,14967,12197,3197,2197,9000,2770,0,0,0,0,2770,1500,1270,0,0,0,0,0,3100,360,50,230,70,48
2020,742600301,7060,1060,1060,1060,0,6000,6000,3000,3000,0,0,0,0,0,2000,0,0,0,845,210,150,30,25,88
2020,742600311,78265,18360,18360,18360,0,59905,56300,3300,53000,0,3605,1305,2300,0,4818,4818,1918,2900,1802,130,300,340,92,88
2020,742600321,3880,3880,3880,3880,0,0,0,0,0,0,0,0,0,0,0,0,0,0,513,70,5,11,120,2
2020,742600331,26018,10958,10958,10958,0,15060,11160,2460,8700,0,3900,1100,2800,0,500,500,500,0,1611,257,50,280,144,167
2020,742600341,15470,1320,1320,1320,0,14150,14000,9500,4500,0,150,0,150,0,1500,1500,0,1500,954,194,100,60,120,41
2020,742700221,93554,39204,39204,39204,0,54350,53000,53000,0,0,1350,750,600,0,0,0,0,0,2955,204,120,207,0,1058
2020,742700231,8240,6002,2602,2602,3400,2238,0,0,0,0,2238,1899,339,0,3892,3892,0,2400,2090,362,98,299,241,32
2020,742700301,22166,4926,4926,4926,0,17240,17100,7500,9600,0,140,0,140,0,0,0,0,0,1407,96,170,90,110,12
2020,742700331,8090,3590,3590,3590,0,4500,4000,4000,0,0,500,500,0,0,0,0,0,0,931,108,20,240,72,51
2020,742700341,22962,8262,8262,8262,0,14700,13000,5000,8000,0,1700,1700,0,0,800,800,0,0,2360,120,20,360,240,102
2020,742700351,27630,4230,4230,4230,0,23400,23300,3500,19800,0,100,0,100,0,300,300,0,300,576,72,120,24,0,9
2020,742800201,40400,6900,6900,6900,0,33500,32000,26000,6000,0,1500,1500,0,0,7000,7000,7000,0,3151,210,100,380,200,92
2020,742800211,86159,25565,25565,24565,0,60594,57500,37500,20000,0,3094,3000,94,0,2060,2060,2000,0,8127,1080,1021,592,118,287
2020,742800221,16652,14302,10302,10302,4000,2350,0,0,0,0,2350,2350,0,0,0,0,0,0,3076,324,190,148,134,121
2020,742800321,7873,7260,2760,2760,4500,613,0,0,0,0,613,500,113,0,0,0,0,0,1295,228,120,300,96,55
2020,742800331,20608,408,408,408,0,20200,20200,5000,15200,0,0,0,0,0,2000,2000,2000,0,575,71,60,120,24,12
2020,742800341,8569,209,209,209,0,8360,8360,1360,7000,0,0,0,0,0,0,0,0,0,671,84,120,10,36,11
2020,742800351,10814,3388,3388,3388,0,7426,6400,6400,0,0,1026,800,226,0,0,0,0,0,2751,480,480,120,360,102
2020,742800371,4170,170,170,170,0,4000,4000,4000,0,0,0,0,0,0,0,0,0,0,544,180,100,20,24,14
2020,742800391,41085,6705,6705,4705,0,34380,31780,22000,9780,0,2600,2600,0,0,0,0,0,0,2004,240,120,144,240,85
2020,742900201,369,369,19,19,350,0,0,0,0,0,0,0,0,0,0,0,0,0,555,144,12,72,21,0
2020,742900231,17259,16333,5833,5833,10500,926,0,0,0,0,926,700,226,0,15,15,0,0,2488,365,201,131,172,67
2020,742900241,19540,16040,3040,3040,13000,3500,1000,0,0,1000,2500,2500,0,0,10000,10000,10000,0,2686,120,20,330,156,126
2020,742900301,2737,2257,57,57,2200,480,0,0,0,0,480,480,0,0,1000,1000,0,1000,1906,360,100,240,96,32
2020,742900311,29426,10316,10316,10316,0,19110,17000,2000,15000,0,2110,1880,230,0,0,0,0,0,1546,160,30,400,216,134
2020,742900331,14285,3460,3460,3460,0,10825,8625,8000,625,0,2200,2200,0,0,4630,4630,2500,0,5960,360,40,500,300,139
2020,742900361,2200,20,20,20,0,2180,2180,2180,0,0,0,0,0,0,0,0,0,0,514,120,60,24,5,2
2020,742900371,13783,8933,8933,8933,0,4850,4700,4700,0,0,150,150,0,0,200,0,0,0,2107,178,480,240,113,50
2020,742900381,10834,5634,5634,5634,0,5200,4000,4000,0,0,1200,400,800,0,12500,12500,12500,0,2004,245,54,565,125,31
2020,742900391,5800,5100,100,100,5000,700,0,0,0,0,700,700,0,0,4500,4500,4500,0,1832,500,10,72,120,100
2020,743000302,65020,20,20,20,0,65000,65000,4000,61000,0,0,0,0,0,500,500,500,0,1016,210,100,30,36,17
2020,750000202,2186,2136,2136,2136,0,50,0,0,0,0,50,0,50,0,0,0,0,0,906,180,5,26,15,1
2020,750000212,2545,2165,1815,1815,350,380,0,0,0,0,380,300,80,0,0,0,0,0,1056,216,48,168,84,31
2020,750000222,2679,1179,1179,1179,0,1500,600,0,0,600,900,700,200,0,5074,5074,0,5000,2576,240,96,360,240,287
2020,750000252,2456,2056,1856,1856,200,400,0,0,0,0,400,400,0,0,1000,1000,0,1000,1530,360,50,500,100,58
2020,750000272,1188,1188,688,688,500,0,0,0,0,0,0,0,0,0,500,500,0,0,750,324,36,60,60,1
2020,750000282,4512,112,112,112,0,4400,4400,4400,0,0,0,0,0,0,0,0,0,0,744,61,300,60,48,6
2020,750000302,12794,3494,3494,3494,0,9300,9300,9300,0,0,0,0,0,0,0,0,0,0,687,109,400,20,48,12
2020,750000312,7161,6661,2661,2661,4000,500,0,0,0,0,500,500,0,0,0,0,0,0,1459,720,3,100,108,17
2020,750000322,43920,2620,2620,2620,0,41300,40000,30000,10000,0,1300,1300,0,0,11500,5500,5500,0,2420,240,200,360,120,81
2020,750000342,122600,74100,56100,50100,18000,48500,48000,0,48000,0,500,500,0,0,3500,3500,0,0,4130,280,200,300,50,1341
2020,750000352,41444,17644,17644,17644,0,23800,23700,23700,0,0,100,0,100,0,0,0,0,0,1114,100,240,132,60,254
2020,750000362,15634,15634,15134,134,500,0,0,0,0,0,0,0,0,0,0,0,0,0,3700,800,2500,10,50,1
2020,750000372,57197,8197,8197,8197,0,49000,18000,17000,1000,0,31000,2600,28400,0,17200,17200,17000,200,4490,348,30,192,180,1637
2020,750000382,119630,3130,3130,3130,0,116500,112000,52000,60000,0,4500,4500,0,0,15000,15000,2000,13000,7400,300,400,800,250,1576
2020,750000392,5040,5040,1040,1040,4000,0,0,0,0,0,0,0,0,0,200,200,0,200,962,180,60,156,96,1
2020,750600201,8150,50,50,50,0,8100,8100,8100,0,0,0,0,0,0,0,0,0,0,695,160,120,20,35,17
2020,750600211,24801,7401,7401,7401,0,17400,17400,17400,0,0,0,0,0,0,0,0,0,0,1605,208,400,45,90,27
2020,750600231,20660,360,360,360,0,20300,20000,20000,0,0,300,300,0,0,800,800,0,800,2870,420,200,300,300,638
2020,750600261,36008,4958,4958,4958,0,31050,28000,26000,2000,0,3050,3050,0,0,5000,0,0,0,2752,500,300,400,100,63
2020,750600291,260,260,10,10,250,0,0,0,0,0,0,0,0,0,2300,2300,300,0,413,75,100,60,48,0
2020,750600301,1340,1340,1340,1340,0,0,0,0,0,0,0,0,0,0,0,0,0,0,1657,297,10,10,168,1
2020,750600311,40262,23462,23462,21462,0,16800,16000,16000,0,0,800,800,0,0,1144,1144,1144,0,3870,220,60,450,240,582
2020,750600321,38015,31515,14515,14115,17000,6500,0,0,0,0,6500,4000,2500,0,10300,10300,8000,800,6332,552,50,600,480,124
2020,750600331,8120,120,120,120,0,8000,8000,8000,0,0,0,0,0,0,0,0,0,0,1288,176,600,20,108,9
2020,750600361,3760,760,760,760,0,3000,3000,3000,0,0,0,0,0,0,0,0,0,0,484,250,53,21,20,1
2020,750600381,71308,42558,42558,42558,0,28750,25000,25000,0,0,3750,3750,0,0,967,967,0,0,5563,480,24,420,360,1324
2020,750700201,13270,3270,3270,3270,0,10000,10000,10000,0,0,0,0,0,0,0,0,0,0,687,216,5,12,24,10
2020,750700221,9240,6640,5640,5640,1000,2600,0,0,0,0,2600,2600,0,0,1000,1000,1000,0,3820,720,200,520,300,331
2020,750700231,1120,620,470,120,150,500,0,0,0,0,500,500,0,0,800,800,0,800,1694,520,24,180,120,27
2020,750700241,38500,7200,7200,7200,0,31300,30000,10000,20000,0,1300,300,1000,0,0,0,0,0,2170,200,20,400,300,58
2020,750700251,9710,210,210,210,0,9500,9500,6500,3000,0,0,0,0,0,60,60,0,0,945,120,200,60,30,17
2020,750700261,11220,320,320,20,0,10900,7000,7000,0,0,3900,2300,600,1000,14880,14880,4480,7400,1214,160,10,240,84,70
2020,750700271,30230,2130,2130,2130,0,28100,25000,25000,0,0,3100,1600,0,1500,5000,5000,3000,2000,4483,350,480,600,516,14
2020,750700291,13140,11240,9240,4240,2000,1900,0,0,0,0,1900,900,1000,0,0,0,0,0,1428,304,60,120,72,4
2020,750700341,53424,41824,41824,41824,0,11600,10000,10000,0,0,1600,1600,0,0,0,0,0,0,2096,190,300,180,98,947
2020,750700351,17756,8006,8006,8006,0,9750,8000,8000,0,0,1750,750,0,1000,1000,1000,0,1000,1750,250,50,500,150,37
2020,750700381,82850,22050,22050,7050,0,60800,26500,20000,6500,0,34300,4300,15000,15000,15100,15000,15000,0,4394,290,100,1100,324,426
2020,750800221,263,263,20,20,243,0,0,0,0,0,0,0,0,0,0,0,0,0,977,160,120,60,12,0
2020,750800231,1456,1306,1056,1056,250,150,0,0,0,0,150,0,150,0,328,328,0,0,901,70,221,126,34,1
2020,750800251,20,20,20,20,0,0,0,0,0,0,0,0,0,0,0,0,0,0,583,65,0,48,24,1
2020,750800301,2510,2110,110,110,2000,400,0,0,0,0,400,400,0,0,0,0,0,0,1945,720,15,200,100,36
2020,750800321,22970,8090,8090,8090,0,14880,12000,12000,0,0,2880,2700,180,0,2030,2030,2030,0,4922,216,50,800,240,82
2020,750800331,24251,6751,6751,3751,0,17500,16000,16000,0,0,1500,1500,0,0,0,0,0,0,3471,363,540,210,185,194
2020,750800351,11182,1682,1682,1682,0,9500,9500,9500,0,0,0,0,0,0,0,0,0,0,564,184,30,5,5,13
2020,750800361,393670,164250,164250,84250,0,229420,176000,26000,150000,0,53420,2920,500,50000,5000,0,0,0,7980,660,240,480,144,3603
2020,750800381,7880,730,730,730,0,7150,6800,6800,0,0,350,350,0,0,0,0,0,0,1360,200,130,50,100,40
2020,750800391,36708,27758,9758,7758,18000,8950,8000,0,8000,0,950,950,0,0,6500,0,0,0,5242,192,300,720,360,161
2020,750900201,25440,1050,1050,250,0,24390,23000,23000,0,0,1390,500,890,0,5380,5380,5300,0,3770,360,120,240,180,54
2020,750900211,25715,1795,1795,1795,0,23920,23000,18000,5000,0,920,920,0,0,3800,3300,1800,1500,3332,252,120,480,312,65
2020,750900241,18200,3400,3400,3400,0,14800,14000,13000,1000,0,800,800,0,0,0,0,0,0,3067,350,65,240,72,46
2020,750900261,103,103,3,3,100,0,0,0,0,0,0,0,0,0,0,0,0,0,682,250,72,36,24,1
2020,750900271,40680,4680,4680,4680,0,36000,36000,35000,1000,0,0,0,0,0,0,0,0,0,5280,360,300,100,240,74
2020,750900281,1125,1125,125,125,1000,0,0,0,0,0,0,0,0,0,2000,2000,0,2000,3111,576,400,180,216,2
2020,750900291,810,810,310,310,500,0,0,0,0,0,0,0,0,0,0,0,0,0,1088,300,20,120,48,1
2020,750900311,19610,210,210,210,0,19400,19000,19000,0,0,400,400,0,0,0,0,0,0,1908,230,500,150,84,75
2020,750900321,70626,16826,3026,3026,13800,53800,40000,0,40000,0,13800,800,13000,0,0,0,0,0,3480,400,50,350,250,672
2020,750900331,51070,16140,16140,16140,0,34930,33000,28000,5000,0,1930,1450,480,0,0,0,0,0,3920,300,50,480,360,145
2020,750900371,83510,33110,10610,10610,22500,50400,50000,0,50000,0,400,0,400,0,0,0,0,0,4253,260,50,1200,288,36
2020,750900391,32196,8046,8046,8046,0,24150,21000,8000,13000,0,3150,2550,600,0,0,0,0,0,1510,120,110,200,150,241
2020,751000212,22670,370,370,370,0,22300,20000,20000,0,0,2300,2300,0,0,0,0,0,0,1972,240,84,480,120,133
2020,751000222,13790,290,290,290,0,13500,12000,12000,0,0,1500,1500,0,0,2936,2936,2800,0,3086,300,12,480,240,751
2020,751000232,16344,6344,6344,6344,0,10000,10000,10000,0,0,0,0,0,0,2500,2500,2500,0,1656,180,300,120,156,20
2020,751000242,42286,5040,5040,5040,0,37246,37000,37000,0,0,246,246,0,0,0,0,0,0,2836,280,350,180,96,43
2020,751000272,34288,3988,3988,3988,0,30300,30000,30000,0,0,300,300,0,0,0,0,0,0,3290,300,200,200,140,121
2020,751000282,1379,1379,379,379,1000,0,0,0,0,0,0,0,0,0,0,0,0,0,2107,300,7,240,180,8
2020,751000302,1400,1400,1000,1000,400,0,0,0,0,0,0,0,0,0,0,0,0,0,1790,540,30,20,120,0
2020,751000312,44136,23436,23436,23436,0,20700,20000,11000,9000,0,700,700,0,0,1200,500,0,500,1334,264,150,250,100,384
2020,751000322,105500,15200,3200,3200,12000,90300,87000,0,87000,0,3300,3300,0,0,100000,100000,100000,0,5680,400,300,500,360,2867
2020,751000352,620,520,520,520,0,100,0,0,0,0,100,100,0,0,0,0,0,0,2804,190,24,500,360,33
2020,751000362,2968,368,368,368,0,2600,0,0,0,0,2600,2300,300,0,0,0,0,0,875,110,50,70,55,53
2020,751000372,1230,1030,30,30,1000,200,0,0,0,0,200,200,0,0,62000,62000,0,0,1836,550,100,200,156,319
2020,751000382,2758,758,758,758,0,2000,0,0,0,0,2000,2000,0,0,0,0,0,0,2290,520,20,240,84,297
2020,751000392,12932,2932,2932,2932,0,10000,10000,10000,0,0,0,0,0,0,2554,2554,2464,0,1780,300,5,120,120,8
2020,751600211,9830,1130,1130,1130,0,8700,8500,8500,0,0,200,200,0,0,0,0,0,0,2186,300,48,540,95,48
2020,751600221,106462,15576,10576,10576,5000,90886,77500,0,77500,0,13386,3186,10200,0,76000,76000,76000,0,5490,1400,50,500,200,166
2020,751600231,78846,7246,7246,7246,0,71600,70000,70000,0,0,1600,1600,0,0,70,70,0,0,2650,300,270,420,280,979
2020,751600261,12880,880,880,880,0,12000,12000,12000,0,0,0,0,0,0,2560,2560,1280,360,1654,250,240,120,180,13
2020,751600271,55246,26338,9048,7548,17290,28908,28000,0,10000,18000,908,600,308,0,24000,21000,0,21000,5526,360,200,1140,272,568
2020,751600281,330,330,30,30,300,0,0,0,0,0,0,0,0,0,0,0,0,0,1005,144,95,50,60,1
2020,751600291,220,220,20,20,200,0,0,0,0,0,0,0,0,0,400,400,0,400,320,60,24,24,8,1
2020,751600311,49886,25066,25066,25066,0,24820,23000,21000,2000,0,1820,1820,0,0,0,0,0,0,5970,500,30,700,360,933
2020,751600341,12220,2220,2220,2220,0,10000,10000,10000,0,0,0,0,0,0,0,0,0,0,1552,200,200,62,60,16
2020,751600351,11890,11390,7890,7890,3500,500,0,0,0,0,500,500,0,0,0,0,0,0,860,50,20,150,60,312
2020,751600371,44392,22592,22592,19592,0,21800,19500,19500,0,0,2300,2300,0,0,0,0,0,0,2560,240,50,360,180,909
2020,751600381,98547,13647,13647,13647,0,84900,82000,80000,2000,0,2900,2700,200,0,8000,0,0,0,3226,230,300,300,156,210
2020,751600391,14440,1740,40,40,1700,12700,7000,0,7000,0,5700,200,3000,2500,3000,3000,0,3000,2205,300,15,350,130,44
2020,751700201,2650,2650,850,850,1800,0,0,0,0,0,0,0,0,0,0,0,0,0,1530,188,15,120,92,1
2020,751700211,9244,1544,1544,1544,0,7700,6700,6700,0,0,1000,1000,0,0,500,500,500,0,2375,235,100,180,90,57
2020,751700221,14370,7320,2320,2320,5000,7050,7000,0,7000,0,50,50,0,0,2400,1400,0,0,812,120,30,72,30,31
2020,751700231,21065,1665,1665,1665,0,19400,19000,19000,0,0,400,400,0,0,11000,11000,11000,0,1638,180,30,108,120,21
2020,751700241,10366,1916,1916,1916,0,8450,8000,8000,0,0,450,450,0,0,0,0,0,0,1484,144,120,290,120,34
2020,751700251,10490,2490,2490,2490,0,8000,8000,8000,0,0,0,0,0,0,0,0,0,0,1156,240,120,96,60,23
2020,751700271,39039,8589,8589,8589,0,30450,30000,30000,0,0,450,450,0,0,0,0,0,0,2072,420,24,240,180,408
2020,751700291,28600,3600,3600,3600,0,25000,25000,25000,0,0,0,0,0,0,100,100,0,0,1690,330,300,110,65,27
2020,751700301,34586,10560,10560,10560,0,24026,22800,5000,17800,0,1226,1000,226,0,100,0,0,0,1087,160,50,150,72,49
2020,751700331,2025,2025,1025,1025,1000,0,0,0,0,0,0,0,0,0,433,433,0,0,2070,420,50,150,300,25
2020,751700361,14510,6440,6440,6440,0,8070,8000,8000,0,0,70,0,70,0,0,0,0,0,878,120,28,54,36,27
2020,751700371,38200,2280,2280,2280,0,35920,30500,7500,23000,0,5420,1000,4420,0,200,200,200,0,1870,250,700,50,90,70
2020,751700381,195500,62300,42300,42300,20000,133200,130000,0,130000,0,3200,2200,1000,0,100000,0,0,0,2660,360,50,300,100,325
2020,751700391,14396,3896,3896,3896,0,10500,10500,7000,3500,0,0,0,0,0,0,0,0,0,2022,400,96,30,66,27
2020,751800201,26240,8420,8420,8420,0,17820,17000,17000,0,0,820,700,120,0,20,20,0,0,4176,300,20,200,96,93
2020,751800211,28239,12739,12739,12739,0,15500,15000,15000,0,0,500,500,0,0,3400,3400,0,3400,4185,305,20,180,120,756
2020,751800221,18184,9684,9684,9684,0,8500,8500,8500,0,0,0,0,0,0,0,0,0,0,2671,250,5,180,336,12
2020,751800251,1550,250,50,50,200,1300,0,0,0,0,1300,1300,0,0,4281,4281,0,4281,2730,630,120,120,156,72
2020,751800271,1903,1903,1503,1503,400,0,0,0,0,0,0,0,0,0,0,0,0,0,2024,516,60,120,108,42
2020,751800291,24231,24046,8046,8046,16000,185,0,0,0,0,185,185,0,0,11600,11600,9000,2600,1970,300,100,100,20,154
2020,751800301,9680,2110,2110,2110,0,7570,7500,2500,5000,0,70,0,70,0,0,0,0,0,480,110,60,40,40,5
2020,751800321,4510,10,10,10,0,4500,4000,4000,0,0,500,500,0,0,3440,3440,820,400,1195,220,15,240,90,31
2020,751800331,11200,5200,5200,5200,0,6000,6000,6000,0,0,0,0,0,0,0,0,0,0,846,120,120,120,36,46
2020,751800341,16370,4970,4970,4970,0,11400,10000,10000,0,0,1400,1400,0,0,0,0,0,0,4952,600,20,180,192,29
2020,751800361,63010,52860,52860,52860,0,10150,8700,2000,6700,0,1450,1000,450,0,0,0,0,0,1320,280,40,120,100,202
2020,751800371,13604,8304,8304,8304,0,5300,4000,4000,0,0,1300,1300,0,0,900,900,0,0,1996,240,360,180,36,34
2020,751800381,11854,2154,2154,2154,0,9700,4500,4500,0,0,5200,200,0,5000,0,0,0,0,1582,240,120,84,88,8
2020,751900211,82559,24659,13659,13659,11000,57900,44500,0,44500,0,13400,2900,3000,7500,3500,3000,3000,0,4390,184,108,660,288,93
2020,751900221,99300,69800,69800,59800,0,29500,21000,21000,0,0,8500,8500,0,0,0,0,0,0,5105,500,300,1000,300,453
2020,751900251,4534,4460,3960,3960,500,74,0,0,0,0,74,74,0,0,0,0,0,0,1780,540,50,160,130,6
2020,751900261,326090,4790,4790,4790,0,321300,320000,120000,200000,0,1300,1300,0,0,104500,104500,103000,1500,13180,480,600,1440,360,3584
2020,751900271,43872,10172,10172,10172,0,33700,25000,10000,15000,0,8700,7700,0,1000,6000,6000,6000,0,3456,200,100,540,348,920
2020,751900281,653,653,3,3,650,0,0,0,0,0,0,0,0,0,130,130,0,0,785,308,20,60,80,1
2020,751900291,1400,1300,300,300,1000,100,0,0,0,0,100,100,0,0,950,950,950,0,4280,950,200,300,360,186
2020,751900311,30880,380,380,380,0,30500,29000,6000,23000,0,1500,500,1000,0,7500,7500,7000,500,1296,300,250,250,36,23
2020,751900321,1000,1000,1000,1000,0,0,0,0,0,0,0,0,0,0,0,0,0,0,675,150,120,50,25,1
2020,751900331,3279,2429,1429,1429,1000,850,0,0,0,0,850,850,0,0,100,100,100,0,2444,480,70,650,324,104
2020,751900351,27400,13000,13000,13000,0,14400,13000,3000,10000,0,1400,1400,0,0,0,0,0,0,1500,150,50,400,50,62
2020,751900361,18990,4990,4990,4990,0,14000,12000,12000,0,0,2000,2000,0,0,100,100,0,0,3675,240,120,100,180,468
2020,751900381,1485,285,285,285,0,1200,1100,1100,0,0,100,100,0,0,0,0,0,0,1041,240,1,300,72,16
2020,751900391,22193,9093,9093,9093,0,13100,11000,3000,8000,0,2100,2050,50,0,0,0,0,0,870,215,36,120,42,87
2020,752000212,12586,5086,5086,5086,0,7500,5000,0,0,5000,2500,2300,200,0,9000,9000,9000,0,4430,250,100,500,180,228
2020,752000242,14746,13896,5896,5896,8000,850,0,0,0,0,850,850,0,0,0,0,0,0,2968,840,20,360,144,25
2020,752000252,220,220,20,20,200,0,0,0,0,0,0,0,0,0,0,0,0,0,815,354,36,5,10,1
2020,752000272,30190,28210,210,210,28000,1980,0,0,0,0,1980,1980,0,0,0,0,0,0,2930,480,30,150,600,376
2020,752000292,58176,8376,8376,8376,0,49800,49000,38000,11000,0,800,800,0,0,10500,10500,0,10500,5726,456,150,450,250,855
2020,752000302,14925,9525,5325,3325,4200,5400,0,0,0,0,5400,5100,300,0,0,0,0,0,2300,240,240,1200,120,111
2020,752000312,2520,20,20,20,0,2500,2500,2500,0,0,0,0,0,0,0,0,0,0,375,70,50,10,15,9
2020,752000332,12616,666,666,666,0,11950,11800,10000,1800,0,150,150,0,0,0,0,0,0,1422,60,36,150,120,25
2020,752000352,59830,24950,24950,24950,0,34880,16000,12000,4000,0,18880,5580,8300,5000,0,0,0,0,5246,260,36,1150,460,291
2020,752000362,6250,1500,1500,1500,0,4750,3900,3000,900,0,850,0,850,0,0,0,0,0,1662,150,200,132,110,25
2020,752000372,2000,1000,1000,1000,0,1000,1000,1000,0,0,0,0,0,0,0,0,0,0,586,100,200,24,12,34
2020,752000382,114320,7320,7320,5220,0,107000,97000,8000,89000,0,10000,5000,5000,0,4000,4000,4000,0,2036,340,36,240,120,107
2020,752600201,77418,55118,55118,48118,0,22300,20000,10000,10000,0,2300,2300,0,0,0,0,0,0,1900,450,100,300,250,172
2020,752600241,116477,34777,34777,34777,0,81700,81000,66000,15000,0,700,700,0,0,0,0,0,0,7650,400,300,1000,250,980
2020,752600251,22800,17800,7800,7800,10000,5000,4000,0,0,4000,1000,1000,0,0,0,0,0,0,2220,190,300,180,120,944
2020,752600261,421,421,171,95,250,0,0,0,0,0,0,0,0,0,100,100,0,0,1002,150,24,132,96,1
2020,752600271,2300,2300,1000,1000,1300,0,0,0,0,0,0,0,0,0,400,400,0,0,802,192,24,12,66,1
2020,752600301,19119,7119,7119,7119,0,12000,12000,12000,0,0,0,0,0,0,3200,3200,0,3200,2540,150,200,60,200,12
2020,752600311,390,390,390,390,0,0,0,0,0,0,0,0,0,0,600,600,0,0,700,200,200,30,50,1
2020,752600331,24602,1202,1202,1202,0,23400,22000,10000,12000,0,1400,1400,0,0,7000,7000,7000,0,2110,180,180,360,360,73
2020,752600341,5600,100,100,100,0,5500,5500,5500,0,0,0,0,0,0,0,0,0,0,1080,120,400,40,20,8
2020,752600351,39944,13124,13124,9124,0,26820,24000,8000,16000,0,2820,2820,0,0,300,300,0,300,4590,280,810,320,380,936
2020,752600361,18100,2100,2100,2100,0,16000,16000,8500,7500,0,0,0,0,0,0,0,0,0,500,200,50,20,30,12
2020,752600371,11000,3500,3500,3500,0,7500,7500,7500,0,0,0,0,0,0,0,0,0,0,1038,150,500,100,48,14
2020,752700211,865,765,265,265,500,100,0,0,0,0,100,100,0,0,706,706,0,0,3810,880,30,180,120,516
2020,752700241,30541,30041,8741,8741,21300,500,0,0,0,0,500,500,0,0,6500,6500,6500,0,5080,400,60,400,170,31
2020,752700251,28355,19255,12755,12755,6500,9100,5000,0,5000,0,4100,3100,1000,0,0,0,0,0,3660,360,120,840,240,164
2020,752700261,8696,8696,696,696,8000,0,0,0,0,0,0,0,0,0,4000,4000,4000,0,1805,700,25,70,120,38
2020,752700271,26402,9402,9402,9402,0,17000,17000,17000,0,0,0,0,0,0,3800,3800,3800,0,3084,300,120,240,144,403
2020,752700301,21930,230,230,230,0,21700,21500,1500,20000,0,200,200,0,0,6320,6320,6000,0,1620,80,400,200,240,42
2020,752700321,10,10,10,10,0,0,0,0,0,0,0,0,0,0,0,0,0,0,553,96,36,59,42,28
2020,752700331,21470,20520,15756,15756,4764,950,0,0,0,0,950,950,0,0,0,0,0,0,1310,380,30,150,80,37
2020,752700341,18600,7300,7300,7300,0,11300,11000,3500,7500,0,300,0,300,0,0,0,0,0,550,150,80,50,40,12
2020,752700351,1100,750,250,250,500,350,0,0,0,0,350,300,50,0,0,0,0,0,1697,296,90,360,216,41
2020,752700361,2070,470,470,470,0,1600,1600,600,1000,0,0,0,0,0,0,0,0,0,796,112,180,60,38,3
2020,752700371,10790,640,640,640,0,10150,8850,650,8200,0,1300,1200,100,0,200,200,200,0,1653,114,866,120,63,35
2020,752800201,35796,10396,10396,9896,0,25400,22000,22000,0,0,3400,400,1000,2000,14953,14953,11523,0,2946,336,100,240,180,87
2020,752800221,43575,1275,1275,1275,0,42300,42000,22000,20000,0,300,300,0,0,10040,8040,5940,2100,2149,240,10,230,145,107
2020,752800231,56117,9347,9347,7347,0,46770,44000,44000,0,0,2770,2500,270,0,20712,20712,17700,3000,6790,1200,150,360,180,646
2020,752800261,66424,2124,2124,2124,0,64300,60000,60000,0,0,4300,4300,0,0,6756,6756,0,0,3640,300,290,250,120,148
2020,752800281,122708,12128,12128,12128,0,110580,110000,0,110000,0,580,580,0,0,38000,23000,23000,0,4190,500,120,240,360,656
2020,752800301,23820,8820,8820,8820,0,15000,15000,15000,0,0,0,0,0,0,140,140,0,0,2870,210,40,420,350,117
2020,752800321,2237,2182,2182,2182,0,55,0,0,0,0,55,50,5,0,0,0,0,0,1168,168,360,160,120,3
2020,752800341,17600,500,500,500,0,17100,15000,15000,0,0,2100,1100,1000,0,0,0,0,0,1310,260,150,100,50,66
2020,752800351,41530,10370,10370,4370,0,31160,29810,14810,15000,0,1350,1300,50,0,2000,2000,2000,0,2200,360,180,600,360,967
2020,752800361,29550,4150,4150,4150,0,25400,25000,20000,5000,0,400,400,0,0,7660,3760,3760,0,915,132,13,60,60,49
2020,752900201,22410,9420,9420,9420,0,12990,12000,0,12000,0,990,790,200,0,0,0,0,0,5927,300,352,600,108,328
2020,752900211,3810,1910,1910,1910,0,1900,0,0,0,0,1900,1900,0,0,447,447,0,100,1890,330,50,170,100,45
2020,752900241,120794,6344,6344,6344,0,114450,112700,49000,31700,32000,1750,1750,0,0,4300,4300,3000,1300,5120,480,20,50,30,928
2020,752900251,12000,2000,1500,1000,500,10000,0,0,0,0,10000,9500,500,0,3580,3580,0,0,1561,290,11,130,240,161
2020,752900281,4560,3460,460,460,3000,1100,0,0,0,0,1100,1100,0,0,200,200,0,0,3600,516,204,360,360,63
2020,752900301,11240,690,690,690,0,10550,10500,4000,6500,0,50,0,50,0,0,0,0,0,810,100,200,40,60,3
2020,752900311,1060,1060,760,340,300,0,0,0,0,0,0,0,0,0,1000,1000,0,1000,918,480,120,10,72,3
2020,752900321,6830,30,30,30,0,6800,6800,6800,0,0,0,0,0,0,0,0,0,0,1284,156,3,80,60,11
2020,752900331,4300,4300,300,300,4000,0,0,0,0,0,0,0,0,0,2000,2000,0,2000,752,160,22,20,120,228
2020,752900341,8620,120,120,120,0,8500,8500,5500,3000,0,0,0,0,0,0,0,0,0,904,168,72,12,52,17
2020,752900351,46940,2940,2940,2940,0,44000,44000,4000,40000,0,0,0,0,0,0,0,0,0,850,150,100,130,50,9
2020,753000212,5940,3940,3240,3240,700,2000,1000,0,1000,0,1000,1000,0,0,3850,3850,1200,2550,2094,604,200,200,40,197
2020,753000222,25200,8700,5200,5200,3500,16500,16000,0,16000,0,500,500,0,0,0,0,0,0,815,84,5,120,72,55
2020,753600201,33929,3128,3128,3128,0,30801,29385,18500,10885,0,1416,1350,66,0,10520,10520,10000,0,1516,204,44,192,204,112
2020,753900201,238600,12600,12600,12600,0,226000,223500,80000,140000,3500,2500,2500,0,0,5000,0,0,0,4428,360,50,288,120,656
2020,753900211,26398,648,648,648,0,25750,25000,25000,0,0,750,750,0,0,11300,11300,11300,0,3923,360,100,600,240,95
2020,760000202,2550,2300,1500,1500,800,250,0,0,0,0,250,250,0,0,143,143,0,0,1480,500,80,200,80,43
2020,760000212,252,152,152,152,0,100,0,0,0,0,100,100,0,0,380,380,0,380,1068,180,20,80,92,8
2020,760000222,68888,13588,13588,13588,0,55300,52000,37000,15000,0,3300,3000,300,0,700,700,0,0,4344,324,120,120,240,1361
2020,760000252,301,301,1,1,300,0,0,0,0,0,0,0,0,0,0,0,0,0,527,260,2,15,0,1
2020,760000262,60300,1800,1800,800,0,58500,55000,55000,0,0,3500,3500,0,0,27300,27300,25500,0,3990,240,100,50,240,179
2020,760000282,45860,4680,4680,4680,0,41180,41000,41000,0,0,180,180,0,0,10333,10333,10333,0,4776,480,240,360,192,837
2020,760000292,39858,4658,4658,4658,0,35200,30000,30000,0,0,5200,5200,0,0,0,0,0,0,2986,320,100,280,216,362
2020,760000302,12004,304,304,304,0,11700,9200,9000,200,0,2500,2500,0,0,300,300,0,0,3390,180,100,560,360,116
2020,760000312,2600,2600,100,100,2500,0,0,0,0,0,0,0,0,0,0,0,0,0,1200,120,360,60,60,5
2020,760000322,12665,1165,1165,1165,0,11500,10000,10000,0,0,1500,1500,0,0,2000,2000,1000,0,3078,234,145,450,336,314
2020,760000332,8100,100,100,100,0,8000,8000,8000,0,0,0,0,0,0,0,0,0,0,231,54,10,10,18,3
2020,760000342,23528,1528,1528,1528,0,22000,22000,10000,12000,0,0,0,0,0,450,0,0,0,1382,118,56,60,40,18
2020,760000352,600,600,500,500,100,0,0,0,0,0,0,0,0,0,1500,1500,0,0,939,384,5,60,48,76
2020,760000362,18260,4160,4160,4160,0,14100,13000,11000,2000,0,1100,1100,0,0,8847,8847,3470,377,3382,240,920,528,144,160
2020,760000372,33228,3728,3728,3728,0,29500,27000,27000,0,0,2500,2500,0,0,0,0,0,0,3530,260,50,360,300,787
2020,760000382,97128,7528,7528,7528,0,89600,87000,27000,60000,0,2600,600,2000,0,0,0,0,0,3708,332,104,480,252,543
2020,760000392,386502,12650,12650,9650,0,373852,350000,65000,285000,0,23852,19400,2452,2000,111500,81500,78500,0,7646,460,14,1300,312,3381
2020,760600201,6836,3636,2636,2636,1000,3200,0,0,0,0,3200,2900,300,0,0,0,0,0,4000,480,300,350,150,1077
2020,760600241,8741,3741,3441,3441,300,5000,5000,0,5000,0,0,0,0,0,7500,7500,7500,0,2220,600,200,100,180,4
2020,760600251,62151,21151,21151,21151,0,41000,39000,39000,0,0,2000,2000,0,0,3000,3000,3000,0,4456,724,200,400,192,705
2020,760600271,57175,12175,12175,12175,0,45000,41000,30000,11000,0,4000,4000,0,0,12184,12184,9184,3000,4250,360,100,360,360,1604
2020,760600291,27549,9597,9597,9597,0,17952,13500,13000,500,0,4452,4000,452,0,150,150,0,0,2402,144,150,156,132,633
2020,760600311,17000,4000,4000,4000,0,13000,13000,10000,3000,0,0,0,0,0,2000,0,0,0,1462,232,1000,10,20,12
2020,760600321,3834,1834,1334,1334,500,2000,1200,0,1200,0,800,800,0,0,7000,7000,0,7000,2809,492,30,200,378,65
2020,760600351,41876,28396,28396,28396,0,13480,12000,8500,3500,0,1480,1380,100,0,0,0,0,0,2541,110,130,420,158,415
2020,760600361,6250,250,250,250,0,6000,6000,6000,0,0,0,0,0,0,0,0,0,0,515,108,35,24,18,5
2020,760600381,40845,13800,13800,3500,0,27045,17000,11000,6000,0,10045,1500,3045,5500,26000,26000,0,26000,3040,208,10,360,312,338
2020,760700201,4402,4122,3622,3622,500,280,0,0,0,0,280,280,0,0,60,60,0,0,2340,320,20,230,420,22
2020,760700211,15810,3610,3610,3610,0,12200,9000,9000,0,0,3200,3200,0,0,1530,1530,0,0,2516,200,500,200,180,72
2020,760700241,45394,11414,6414,6414,5000,33980,32000,0,32000,0,1980,1080,900,0,22000,0,0,0,3565,200,20,350,200,51
2020,760700251,59617,15807,7807,7807,8000,43810,43000,0,43000,0,810,810,0,0,16500,0,0,0,4970,420,50,500,400,607
2020,760700291,27874,7274,7274,7274,0,20600,20000,20000,0,0,600,600,0,0,3000,3000,3000,0,3190,240,50,500,120,194
2020,760700301,29500,3000,3000,3000,0,26500,20000,20000,0,0,6500,6500,0,0,0,0,0,0,2790,200,100,180,540,123
2020,760700311,27766,1546,1546,1546,0,26220,26000,12500,13500,0,220,200,20,0,0,0,0,0,1169,180,50,460,48,29
2020,760700351,18760,8160,8160,8160,0,10600,9500,9500,0,0,1100,1100,0,0,0,0,0,0,5330,90,4200,120,72,25
2020,760700361,14360,1060,1060,1060,0,13300,13000,13000,0,0,300,0,300,0,0,0,0,0,757,360,71,6,15,13
2020,760700371,62298,20998,20998,20998,0,41300,38000,38000,0,0,3300,3300,0,0,7520,7520,7520,0,5100,420,120,280,280,1794
2020,760700381,62784,9154,9154,9154,0,53630,48000,38000,10000,0,5630,5400,230,0,5200,5200,5200,0,4360,330,300,360,300,110
2020,760700391,31026,16746,16746,16746,0,14280,9000,9000,0,0,5280,5280,0,0,0,0,0,0,2966,238,3,300,130,28
2020,760800201,12180,180,180,180,0,12000,12000,12000,0,0,0,0,0,0,0,0,0,0,1830,120,240,10,50,68
2020,760800211,25290,1090,1090,1090,0,24200,24000,24000,0,0,200,200,0,0,1000,0,0,0,1164,230,20,200,74,42
2020,760800221,121910,30310,30310,30310,0,91600,89000,60000,29000,0,2600,2300,300,0,1800,1800,0,1500,8180,300,1500,600,420,1891
2020,760800241,5100,2800,2800,800,0,2300,0,0,0,0,2300,1950,350,0,0,0,0,0,4370,960,60,420,180,51
2020,760800251,126556,64956,64956,64956,0,61600,53000,53000,0,0,8600,7600,1000,0,0,0,0,0,4960,400,1000,500,360,1919
2020,760800261,18052,8052,52,52,8000,10000,0,0,0,0,10000,2000,0,8000,0,0,0,0,690,120,100,200,40,22
2020,760800281,38334,7684,7684,7684,0,30650,28000,28000,0,0,2650,2300,350,0,2800,2800,2800,0,2500,200,100,250,200,140
2020,760800291,39240,5240,5240,5240,0,34000,28000,28000,0,0,6000,6000,0,0,300,300,0,300,2970,230,20,500,300,1958
2020,760800301,29804,9704,9704,9704,0,20100,6100,6100,0,0,14000,3500,10500,0,360,360,0,340,4010,348,60,960,182,657
2020,760800311,23500,16500,6500,3000,10000,7000,6500,0,6500,0,500,500,0,0,200,200,0,200,1310,480,10,300,240,101
2020,760800321,24500,3500,3500,3500,0,21000,17000,17000,0,0,4000,4000,0,0,0,0,0,0,2842,360,120,240,156,647
2020,760800331,3370,3180,3080,3080,100,190,0,0,0,0,190,190,0,0,700,700,0,0,1112,136,0,108,264,117
2020,760800341,57034,7034,7034,4034,0,50000,50000,50000,0,0,0,0,0,0,11000,4000,4000,0,1080,100,300,50,40,78
2020,760800351,700,700,700,700,0,0,0,0,0,0,0,0,0,0,0,0,0,0,310,80,40,10,30,1
2020,760800361,5390,390,390,390,0,5000,5000,4000,1000,0,0,0,0,0,0,0,0,0,2130,92,1360,60,48,10
2020,760800371,44680,20000,20000,20000,0,24680,24000,11000,13000,0,680,180,500,0,0,0,0,0,5672,432,240,240,240,58
2020,760900201,113827,17927,17927,7927,0,95900,95000,15000,80000,0,900,900,0,0,200,200,0,0,3814,390,650,276,168,179
2020,760900221,57365,3565,3565,3565,0,53800,49000,49000,0,0,4800,4800,0,0,21030,21030,13660,5000,2910,240,40,320,240,198
2020,760900231,38400,9500,9500,9500,0,28900,28000,18000,10000,0,900,700,200,0,0,0,0,0,1872,300,100,120,72,232
2020,760900241,24260,4810,4810,4810,0,19450,18000,18000,0,0,1450,1450,0,0,9000,9000,0,9000,2848,360,100,750,180,478
2020,760900271,43580,16380,16380,16380,0,27200,27000,27000,0,0,200,200,0,0,0,0,0,0,3900,500,100,100,150,120
2020,760900301,15290,290,290,290,0,15000,15000,15000,0,0,0,0,0,0,200,0,0,0,1118,200,120,0,48,12
2020,760900311,14230,730,730,730,0,13500,12000,12000,0,0,1500,1500,0,0,6030,6030,6000,0,3220,360,0,300,240,322
2020,760900331,61648,32598,32598,32598,0,29050,27000,17000,10000,0,2050,2050,0,0,0,0,0,0,6558,328,30,480,360,1272
2020,760900341,1210,910,910,910,0,300,0,0,0,0,300,300,0,0,4490,4490,0,0,1537,199,50,235,100,271
2020,760900351,25016,4390,4390,4390,0,20626,20000,10000,10000,0,626,400,226,0,500,500,0,500,1482,120,180,120,132,27
2020,760900361,59159,9820,9820,9820,0,49339,49000,15000,34000,0,339,0,339,0,0,0,0,0,2256,180,60,120,180,34
2020,760900371,63458,28119,28119,28119,0,35339,31000,31000,0,0,4339,4000,339,0,18,18,0,0,3676,360,240,290,156,78
2020,760900381,25440,5060,5060,5060,0,20380,20000,14000,6000,0,380,380,0,0,8394,8394,7794,0,4827,612,154,125,420,106
2020,761000202,62640,16740,16740,16740,0,45900,45000,30000,15000,0,900,900,0,0,17120,5120,5000,100,3990,300,40,200,360,1839
2020,761000212,37000,10000,10000,10000,0,27000,27000,27000,0,0,0,0,0,0,6500,6500,6500,0,3436,1610,60,120,96,321
2020,761000222,74200,8300,8300,8300,0,65900,65000,40000,25000,0,900,400,500,0,27050,3050,0,3000,4140,650,460,250,380,496
2020,761000232,22400,1400,1400,1400,0,21000,21000,21000,0,0,0,0,0,0,0,0,0,0,660,120,10,10,20,15
2020,761000272,1200,1200,1000,1000,200,0,0,0,0,0,0,0,0,0,0,0,0,0,992,96,20,10,96,21
2020,761000282,10140,140,140,140,0,10000,10000,10000,0,0,0,0,0,0,0,0,0,0,723,120,120,15,72,44
2020,761000302,51267,8800,8800,8800,0,42467,40000,35000,5000,0,2467,2300,167,0,6000,6000,3000,3000,3390,192,10,700,204,843
2020,761000312,10124,2474,2474,2474,0,7650,7000,7000,0,0,650,650,0,0,2000,2000,2000,0,2342,376,500,240,30,59
2020,761000322,720,600,600,600,0,120,0,0,0,0,120,70,50,0,0,0,0,0,448,54,1,60,36,16
2020,761000332,9903,9307,2307,2307,7000,596,0,0,0,0,596,370,226,0,117,117,0,0,1972,264,84,336,84,25
2020,761000342,64233,30033,15083,10083,14950,34200,30000,0,30000,0,4200,4200,0,0,11600,11600,10000,1600,7678,772,36,680,360,1696
2020,761000352,104102,41576,26626,26626,14950,62526,60000,0,60000,0,2526,2300,226,0,26000,20000,20000,0,3000,240,100,500,200,421
2020,761000362,26689,7940,7940,7940,0,18749,11480,6000,5480,0,7269,1800,469,5000,0,0,0,0,2584,155,60,676,78,13
2020,761000372,10952,3616,3616,3616,0,7336,7200,4000,3200,0,136,0,136,0,0,0,0,0,545,130,120,25,35,4
2020,761000382,45,15,15,15,0,30,0,0,0,0,30,0,30,0,0,0,0,0,537,120,12,15,40,0
2020,761000392,42954,9184,9184,9184,0,33770,26210,6710,19500,0,7560,1500,6060,0,0,0,0,0,1474,130,310,184,40,42
2020,761600211,82036,44236,44236,44236,0,37800,28000,15000,5000,8000,9800,1800,0,8000,0,0,0,0,1722,240,60,312,120,97
2020,761600231,7130,1130,1130,1130,0,6000,6000,6000,0,0,0,0,0,0,2000,2000,2000,0,1184,144,120,60,180,9
2020,761600261,13055,55,55,55,0,13000,13000,13000,0,0,0,0,0,0,0,0,0,0,806,132,30,24,30,16
2020,761600281,77718,13618,13618,12618,0,64100,60000,30000,30000,0,4100,3400,100,600,6500,6500,6500,0,2040,240,20,480,200,1746
2020,761600301,79777,11897,11897,11897,0,67880,67000,48000,19000,0,880,400,480,0,16500,15500,13000,2500,3876,291,35,450,209,415
2020,761600321,54612,27429,27429,27429,0,27183,25000,25000,0,0,2183,2100,83,0,28860,28860,8860,20000,5270,276,300,2108,216,993
2020,761600351,180850,13050,13050,13050,0,167800,154400,80000,74400,0,13400,3400,10000,0,0,0,0,0,9212,822,550,800,240,506
2020,761600371,155113,14741,14741,14741,0,140372,74000,3000,71000,0,66372,2550,63822,0,11000,11000,9000,0,3687,282,40,240,134,83
2020,761700201,24906,1906,1906,1906,0,23000,23000,23000,0,0,0,0,0,0,3500,3500,3500,0,3151,216,80,300,145,240
2020,761700211,30500,3500,3500,3500,0,27000,27000,27000,0,0,0,0,0,0,1000,0,0,0,1382,192,500,120,60,57
2020,761700231,4251,3951,2951,2951,1000,300,0,0,0,0,300,300,0,0,0,0,0,0,2727,660,25,240,240,51
2020,761700241,31680,13380,13380,13380,0,18300,17000,17000,0,0,1300,1300,0,0,0,0,0,0,4000,360,1200,340,240,437
2020,761700261,440,440,100,100,340,0,0,0,0,0,0,0,0,0,0,0,0,0,678,144,30,10,24,1
2020,761700271,9700,1200,1200,1200,0,8500,8500,8500,0,0,0,0,0,0,0,0,0,0,1006,120,36,60,60,14
2020,761700281,2690,2690,1190,1190,1500,0,0,0,0,0,0,0,0,0,0,0,0,0,816,240,240,10,36,1
2020,761700301,11830,2330,2330,2330,0,9500,9100,9100,0,0,400,400,0,0,0,0,0,0,1551,168,480,170,72,39
2020,761700311,38538,12128,12128,12128,0,26410,26000,26000,0,0,410,220,190,0,0,0,0,0,5185,600,455,240,300,1726
2020,761700331,10944,7844,6344,5344,1500,3100,1000,0,0,1000,2100,1700,400,0,670,670,600,0,2626,510,50,410,256,427
2020,761700341,12478,1410,1410,1410,0,11068,11000,11000,0,0,68,0,68,0,0,0,0,0,880,144,201,30,25,21
2020,761700351,14134,8895,8895,8895,0,5239,5000,5000,0,0,239,0,239,0,0,0,0,0,1282,160,150,120,50,6
2020,761700361,18690,9432,9432,9432,0,9258,8800,2200,6600,0,458,0,458,0,0,0,0,0,2292,116,50,276,144,52
2020,761700371,600,600,600,600,0,0,0,0,0,0,0,0,0,0,0,0,0,0,418,84,36,24,30,1
2020,761700391,21446,5196,5196,4336,0,16250,14000,9000,5000,0,2250,2000,250,0,820,820,0,0,1778,224,250,504,140,718
2020,761800201,5840,5040,40,40,5000,800,0,0,0,0,800,800,0,0,410,410,310,0,2740,250,20,300,360,59
2020,761800211,47646,14096,8096,8096,6000,33550,33000,0,33000,0,550,550,0,0,7300,6000,6000,0,2639,280,900,265,92,98
2020,761800221,12100,3600,3600,3600,0,8500,8500,8500,0,0,0,0,0,0,0,0,0,0,1093,240,150,90,58,17
2020,761800231,16790,3170,3170,3170,0,13620,13000,13000,0,0,620,600,20,0,8760,8760,8760,0,2620,240,160,240,200,45
2020,761800241,109820,5620,5620,5620,0,104200,100000,25000,75000,0,4200,4200,0,0,59301,19301,16701,2600,3240,300,70,300,160,1533
2020,761800251,20900,200,200,200,0,20700,20000,20000,0,0,700,600,100,0,200,0,0,0,1580,120,200,150,160,44
2020,761800271,181672,55412,55412,55412,0,126260,123360,20000,103360,0,2900,2700,200,0,2020,20,0,0,3585,310,200,300,420,814
2020,761800281,21967,3467,3467,3467,0,18500,17000,17000,0,0,1500,500,1000,0,9890,9890,9500,190,2240,300,100,240,120,67
2020,761800301,9709,8170,2170,2170,6000,1539,0,0,0,0,1539,1200,339,0,500,500,0,0,2210,156,180,144,120,46
2020,761800311,9720,320,320,320,0,9400,8000,8000,0,0,1400,1400,0,0,0,0,0,0,599,48,47,241,37,18
2020,761800321,122131,2851,2851,2851,0,119280,116000,8000,108000,0,3280,400,2880,0,0,0,0,0,1211,368,320,75,84,76
2020,761800331,10096,9776,8276,8276,1500,320,0,0,0,0,320,170,150,0,2610,2610,0,2560,1562,270,2,240,240,30
2020,761800341,1107,927,627,627,300,180,0,0,0,0,180,180,0,0,996,996,860,0,2105,360,100,210,180,21
2020,761800351,32361,20946,20946,17746,0,11415,5930,4500,1430,0,5485,4035,1450,0,4000,4000,3000,1000,5400,840,120,720,540,217
2020,761800381,8890,6390,2390,2390,4000,2500,0,0,0,0,2500,2300,200,0,1450,1450,0,500,1092,487,17,90,102,59
2020,761800391,23635,8540,8540,8540,0,15095,12000,0,12000,0,3095,2350,745,0,1300,1000,0,0,1184,168,165,30,51,27
2020,761900211,26300,980,980,980,0,25320,25000,25000,0,0,320,320,0,0,1500,0,0,0,1267,120,360,67,30,41
2020,761900231,2268,2068,1068,1068,1000,200,0,0,0,0,200,100,100,0,0,0,0,0,4210,620,20,670,320,2073
2020,761900241,22550,1050,1050,1050,0,21500,20600,15600,5000,0,900,900,0,0,0,0,0,0,1250,60,10,240,120,55
2020,761900251,653,533,33,33,500,120,0,0,0,0,120,120,0,0,4000,4000,0,2000,1994,540,48,194,112,13
2020,761900281,48918,15618,15618,13618,0,33300,32000,32000,0,0,1300,1200,100,0,9560,9560,7000,2560,4731,300,200,600,480,260
2020,761900301,7270,270,270,270,0,7000,7000,7000,0,0,0,0,0,0,0,0,0,0,369,108,5,24,15,1
2020,761900311,217,192,192,192,0,25,0,0,0,0,25,0,25,0,0,0,0,0,1004,245,250,30,39,1
2020,761900321,1794,1794,1794,1794,0,0,0,0,0,0,0,0,0,0,0,0,0,0,2718,256,50,240,179,1
2020,761900331,39516,9437,9437,9437,0,30079,10533,6200,4333,0,19546,2646,16900,0,0,0,0,0,3379,198,172,420,287,337
2020,761900341,18515,365,365,365,0,18150,18000,18000,0,0,150,150,0,0,8546,8546,8476,0,6012,352,10,580,600,1251
2020,761900361,4060,200,200,200,0,3860,2600,0,2600,0,1260,1200,60,0,2000,2000,0,0,1516,96,400,36,72,12
2020,761900371,11628,2478,2478,2478,0,9150,9100,1500,7600,0,50,0,50,0,0,0,0,0,506,78,48,65,50,6
2020,761900381,8498,7198,7198,7198,0,1300,1000,1000,0,0,300,250,50,0,0,0,0,0,1486,152,45,200,184,38
2020,761900391,12379,2831,2831,2831,0,9548,9500,5000,4500,0,48,0,48,0,0,0,0,0,765,75,20,60,60,3
2020,762000302,93550,10850,10850,10350,0,82700,60000,0,60000,0,22700,6700,16000,0,8000,8000,7000,1000,3365,308,10,250,210,43
2020,762000312,51295,11895,11895,11895,0,39400,38900,3000,35900,0,500,0,500,0,0,0,0,0,1834,60,1210,100,50,11
2020,762000322,38930,5930,5930,5930,0,33000,17500,13000,4500,0,15500,1500,14000,0,11600,11600,0,1600,2040,200,250,500,120,327
2020,762000332,38680,17344,17344,17344,0,21336,19500,3000,16500,0,1836,1287,549,0,0,0,0,0,1587,60,110,162,54,39
2020,762000342,89706,8728,8728,8728,0,80978,75200,5000,70200,0,5778,4600,1178,0,39000,15000,15000,0,6562,242,244,1205,181,152
2020,762000352,15750,300,300,300,0,15450,15300,1000,14300,0,150,100,50,0,0,0,0,0,738,127,240,11,30,11
2020,762000362,19600,2580,2580,2580,0,17020,17000,5000,12000,0,20,20,0,0,0,0,0,0,1258,156,240,180,42,19
2020,762000372,21080,8080,8080,8080,0,13000,13000,5000,8000,0,0,0,0,0,1990,1990,1490,500,2326,130,240,60,36,11
2020,762600311,1254,31,31,31,0,1223,1110,1110,0,0,113,0,113,0,70,70,0,0,699,127,30,55,96,2
2020,762600321,1385,36,36,36,0,1349,1300,1300,0,0,49,0,49,0,0,0,0,0,557,84,120,40,48,6
2020,762600361,24316,7016,7016,7016,0,17300,16100,15500,600,0,1200,1200,0,0,2000,2000,2000,0,3250,210,30,580,290,464
2020,762600371,59862,13692,13692,13692,0,46170,28000,28000,0,0,18170,8000,10170,0,9067,9067,8867,0,3846,300,420,240,180,180
2020,762700311,3735,35,35,35,0,3700,2000,2000,0,0,1700,200,1500,0,0,0,0,0,478,85,30,40,110,8
2020,762700321,5750,2750,2750,2750,0,3000,3000,0,3000,0,0,0,0,0,0,0,0,0,441,80,40,28,59,1
2020,762700341,4800,300,300,300,0,4500,4500,1500,3000,0,0,0,0,0,500,500,500,0,641,288,30,20,24,2
2020,762700351,22997,9770,9770,9770,0,13227,11000,11000,0,0,2227,1850,377,0,20282,20282,7610,11627,3720,360,1200,360,360,175
2020,762700361,3311,11,11,11,0,3300,2000,2000,0,0,1300,1300,0,0,0,0,0,0,592,136,120,120,36,23
2020,762800341,46772,15472,6472,6472,9000,31300,30000,0,30000,0,1300,1300,0,0,0,0,0,0,3786,516,100,240,216,30
2020,762800351,1713,244,244,244,0,1469,1300,1300,0,0,169,120,49,0,1000,1000,0,1000,1123,171,96,240,96,18
2020,762800361,5670,300,300,300,0,5370,5300,5300,0,0,70,0,70,0,0,0,0,0,750,96,120,60,24,2
2020,762900301,6178,1420,1420,1420,0,4758,4600,1100,3500,0,158,0,158,0,0,0,0,0,379,112,30,30,20,3
2020,762900311,154594,19294,19294,19294,0,135300,54000,4000,50000,0,81300,3300,78000,0,39520,39520,7000,30000,3600,160,300,1200,240,123
2020,762900321,35643,2683,2683,2683,0,32960,29100,17900,11200,0,3860,480,1380,2000,0,0,0,0,1535,218,130,181,53,101
2020,762900341,9233,1253,1253,1253,0,7980,7900,5900,2000,0,80,0,80,0,0,0,0,0,728,60,330,12,16,28
2020,762900361,60336,4586,4586,4586,0,55750,53700,6700,47000,0,2050,1500,550,0,10690,690,690,0,2635,250,620,560,132,86
2020,770000302,16615,13615,4115,4115,9500,3000,0,0,0,0,3000,3000,0,0,9500,9500,0,9500,2987,240,35,300,72,486
2020,770000312,10951,1,1,1,0,10950,10600,10000,600,0,350,350,0,0,3950,3950,2450,1500,784,50,12,120,42,21
2020,770000322,110,10,10,10,0,100,0,0,0,0,100,100,0,0,2000,2000,0,0,1532,126,1,180,108,14
2020,770000332,23524,6024,6024,6024,0,17500,16000,6000,10000,0,1500,0,1500,0,0,0,0,0,840,258,330,36,18,11
2020,770000342,38584,12984,12984,11484,0,25600,25000,25000,0,0,600,600,0,0,14000,14000,13000,1000,3110,360,300,400,200,282
2020,770000352,34905,10125,10125,10125,0,24780,24500,10000,14500,0,280,200,80,0,7000,7000,7000,0,3791,220,2000,250,150,81
2020,770000362,14480,680,680,680,0,13800,11000,11000,0,0,2800,2800,0,0,7000,7000,7000,0,3620,360,120,360,240,132
2020,770000382,50060,60,60,60,0,50000,50000,15000,35000,0,0,0,0,0,2000,0,0,0,781,276,100,12,39,19
2020,770000392,11080,1530,1530,1530,0,9550,9000,9000,0,0,550,550,0,0,1800,1800,1800,0,1194,150,50,240,144,33
2020,770600311,72816,26866,26866,25866,0,45950,45000,25000,20000,0,950,600,350,0,500,0,0,0,4718,216,150,500,252,1133
2020,770600331,5052,3602,3602,2602,0,1450,0,0,0,0,1450,900,250,300,175,175,0,0,2367,240,10,240,174,30
2020,770600351,45086,1706,1706,1706,0,43380,41000,6000,35000,0,2380,0,2380,0,500,500,500,0,4089,3428,300,36,19,14
2020,770600361,54560,6560,6560,6560,0,48000,47000,10000,37000,0,1000,1000,0,0,11060,0,0,0,872,144,60,120,48,381
2020,770600371,40510,310,310,310,0,40200,40000,20000,20000,0,200,200,0,0,7402,7402,7402,0,1785,336,10,360,156,44
2020,770600381,19630,1300,1300,1300,0,18330,16000,16000,0,0,2330,2030,300,0,0,0,0,0,1446,210,100,150,120,36
2020,770600391,6020,320,320,320,0,5700,5700,5700,0,0,0,0,0,0,0,0,0,0,775,120,10,10,35,9
2020,770700301,16098,598,598,598,0,15500,13000,13000,0,0,2500,1500,1000,0,8650,8650,7500,800,3510,300,110,300,320,88
2020,770700321,5053,53,53,53,0,5000,5000,5000,0,0,0,0,0,0,0,0,0,0,955,212,100,48,30,7
2020,770700331,12750,2150,2150,2150,0,10600,10000,10000,0,0,600,600,0,0,4200,4200,4200,0,1590,200,40,350,100,417
2020,770700341,46070,16210,16210,16210,0,29860,24800,19800,5000,0,5060,2360,2700,0,7200,3700,3700,0,2874,480,400,180,180,546
2020,770700351,29970,7970,7970,7970,0,22000,19000,19000,0,0,3000,3000,0,0,2190,2190,2190,0,2775,240,20,240,180,273
2020,770700361,25,25,25,25,0,0,0,0,0,0,0,0,0,0,2000,2000,0,0,998,50,108,25,60,1
2020,770700371,89892,15592,15592,15592,0,74300,73000,19000,54000,0,1300,1300,0,0,1500,0,0,0,2870,350,100,340,130,186
2020,770700381,28380,7280,7280,7280,0,21100,19500,12500,7000,0,1600,1500,100,0,0,0,0,0,1765,129,1200,60,25,110
2020,770700391,205,205,5,5,200,0,0,0,0,0,0,0,0,0,2000,2000,0,0,660,120,120,60,30,0
2020,770800301,8986,2336,2336,2336,0,6650,5500,5500,0,0,1150,1150,0,0,4910,4910,4910,0,2250,240,20,180,180,79
2020,770800311,40510,15010,15010,15010,0,25500,25000,25000,0,0,500,500,0,0,0,0,0,0,2924,252,20,480,192,287
2020,770800321,8700,200,200,200,0,8500,8000,8000,0,0,500,500,0,0,2000,2000,0,0,4298,2554,180,300,144,453
2020,770800341,45861,14941,14941,9941,0,30920,26000,26000,0,0,4920,4500,420,0,0,0,0,0,4200,300,180,960,240,235
2020,770800361,11800,500,500,500,0,11300,9000,9000,0,0,2300,1800,500,0,0,0,0,0,2815,220,120,280,240,147
2020,770800371,27207,3807,3807,3807,0,23400,4500,4500,0,0,18900,14900,0,4000,9273,9273,4500,4260,2678,352,130,100,356,101
2020,770800381,8042,6542,5542,2542,1000,1500,0,0,0,0,1500,500,1000,0,0,0,0,0,4160,720,0,360,480,314
2020,770900301,22460,1410,1410,1410,0,21050,21000,21000,0,0,50,50,0,0,0,0,0,0,895,150,400,120,25,37
2020,770900311,4910,4770,2470,2470,2300,140,0,0,0,0,140,100,40,0,0,0,0,0,1970,200,200,300,70,28
2020,770900321,17380,300,300,300,0,17080,17000,6000,11000,0,80,0,80,0,0,0,0,0,1640,130,600,24,96,12
2020,770900331,1600,1600,20,20,1580,0,0,0,0,0,0,0,0,0,1020,1020,1020,0,481,180,30,60,30,1
2020,770900341,2075,2075,1215,1215,860,0,0,0,0,0,0,0,0,0,1000,1000,1000,0,549,180,50,10,30,1
2020,770900351,20950,6400,6400,1400,0,14550,14000,14000,0,0,550,460,90,0,5500,5500,5500,0,2775,264,100,620,96,101
2020,770900361,18714,7464,5464,5464,2000,11250,11000,0,11000,0,250,250,0,0,0,0,0,0,608,62,10,120,48,49
2020,770900371,899,899,899,899,0,0,0,0,0,0,0,0,0,0,0,0,0,0,256,70,30,10,18,1
2020,770900381,43452,22152,19152,19152,3000,21300,20000,0,20000,0,1300,800,500,0,0,0,0,0,3350,300,100,200,200,1494
2020,771000302,1388,1388,1288,1288,100,0,0,0,0,0,0,0,0,0,0,0,0,0,1660,440,10,50,100,1
2020,771000332,20798,11817,11817,9817,0,8981,3700,3700,0,0,5281,1281,4000,0,300,300,0,300,4150,150,300,260,230,52
2020,771000372,400,400,100,100,300,0,0,0,0,0,0,0,0,0,0,0,0,0,782,300,50,5,27,1
2020,771600301,15691,4618,4618,4618,0,11073,10000,10000,0,0,1073,873,200,0,4000,4000,2500,1500,3000,180,360,240,212,69
2020,771600321,60368,30368,30368,30368,0,30000,18000,18000,0,0,12000,3500,8500,0,4000,0,0,0,5700,220,30,1200,250,158
2020,771600331,5200,200,200,200,0,5000,5000,5000,0,0,0,0,0,0,2800,2800,2800,0,684,150,110,10,36,7
2020,771600361,33210,17810,17810,9810,0,15400,12000,12000,0,0,3400,3400,0,0,1736,1736,0,0,6626,463,700,880,294,985
2020,771600381,51350,5300,5300,5300,0,46050,46000,11000,35000,0,50,0,50,0,0,0,0,0,1825,1130,250,5,10,26
2020,771600391,10997,884,884,884,0,10113,10000,4000,6000,0,113,0,113,0,0,0,0,0,555,86,0,120,0,123
2020,771700331,8048,948,948,948,0,7100,7000,7000,0,0,100,100,0,0,5912,5912,3784,0,2296,80,14,200,360,45
2020,771700371,1428,1368,1368,1368,0,60,0,0,0,0,60,0,60,0,0,0,0,0,929,132,26,13,20,1
2020,771700391,15700,450,450,450,0,15250,13500,5000,8500,0,1750,250,1500,0,3500,0,0,0,1380,180,240,95,15,15
2020,771800301,40160,6260,6260,6260,0,33900,24000,11000,13000,0,9900,1600,8300,0,2700,2700,2700,0,1689,165,36,410,38,75
2020,771800311,6052,5732,732,732,5000,320,0,0,0,0,320,320,0,0,2290,2290,0,2290,1462,300,200,300,72,30
2020,771800331,41500,5400,5400,400,0,36100,35000,30000,5000,0,1100,300,300,500,0,0,0,0,1790,250,50,120,70,44
2020,771800341,38956,14156,14156,14156,0,24800,3500,1000,2500,0,21300,100,21200,0,3500,3500,0,3000,2426,270,500,290,60,34
2020,771800351,99040,10440,10440,10440,0,88600,85000,30000,55000,0,3600,3600,0,0,0,0,0,0,1380,120,180,300,240,512
2020,771800361,9892,6392,5392,5392,1000,3500,0,0,0,0,3500,1400,2100,0,1100,1100,0,300,4050,500,180,300,300,6
2020,771800371,56960,25460,25460,15460,0,31500,25500,23000,2500,0,6000,1800,4200,0,0,0,0,0,2850,150,100,400,200,106
2020,771800381,107602,26002,12502,12502,13500,81600,80000,0,80000,0,1600,1600,0,0,48500,46000,44000,2000,3300,200,100,300,100,481
2020,771900311,5659,3548,3248,3248,300,2111,0,0,0,0,2111,2111,0,0,1066,1066,0,0,2108,438,50,600,120,195
2020,771900321,10360,7860,7360,7360,500,2500,0,0,0,0,2500,2500,0,0,300,300,0,0,2900,600,100,300,200,33
2020,771900331,33944,28844,12344,12344,16500,5100,3500,0,3500,0,1600,1600,0,0,20000,19700,19200,0,1473,190,60,180,230,41
2020,771900351,18707,572,572,572,0,18135,18000,10000,8000,0,135,0,135,0,3800,3800,3800,0,656,94,40,5,72,9
2020,771900371,11050,250,250,250,0,10800,10000,10000,0,0,800,300,0,500,6000,6000,0,0,1768,136,200,192,144,50
2020,772000302,19740,6740,6740,4140,0,13000,12000,12000,0,0,1000,300,700,0,0,0,0,0,1685,200,250,200,70,21
2020,772000312,66891,17911,17911,17911,0,48980,47000,28000,19000,0,1980,1750,230,0,10500,10000,0,0,3408,362,264,300,216,487
2020,772000332,7300,300,300,300,0,7000,7000,7000,0,0,0,0,0,0,2000,2000,2000,0,758,108,68,30,56,23
2020,772000342,91200,11800,11800,11800,0,79400,75000,7000,68000,0,4400,600,3800,0,1000,0,0,0,3300,300,50,500,250,158
2020,772000352,2840,350,350,350,0,2490,2380,2380,0,0,110,0,110,0,0,0,0,0,513,80,120,40,13,3
2020,772000372,109790,19966,19966,19966,0,89824,82500,35000,47500,0,7324,7044,280,0,300,0,0,0,2127,977,60,250,120,282
2020,772000382,18236,3936,3936,3936,0,14300,14300,14300,0,0,0,0,0,0,0,0,0,0,1384,174,200,10,140,23
2020,772600311,3416,2716,2216,2216,500,700,0,0,0,0,700,700,0,0,0,0,0,0,1420,320,240,180,120,35
2020,772600351,27670,1000,1000,1000,0,26670,20000,8000,12000,0,6670,1350,5320,0,5000,5000,0,5000,4014,444,50,1200,300,441
2020,772600371,25120,8770,8770,8770,0,16350,15750,12000,3750,0,600,450,150,0,0,0,0,0,1980,210,600,360,120,53
2020,772700301,9138,1738,1738,1738,0,7400,6900,6400,500,0,500,200,300,0,1700,1700,1700,0,3476,360,480,360,156,315
2020,772700331,660,260,260,260,0,400,0,0,0,0,400,0,400,0,0,0,0,0,1280,50,300,100,30,11
2020,772700341,143393,6593,6593,6593,0,136800,85000,50000,35000,0,51800,3500,48300,0,1500,0,0,0,2286,240,150,300,96,197
2020,772700351,34970,22500,22500,22500,0,12470,12000,9000,3000,0,470,300,170,0,0,0,0,0,2558,140,480,250,58,783
2020,772800311,1056,956,956,956,0,100,0,0,0,0,100,100,0,0,0,0,0,0,1926,240,30,48,60,43
2020,772800321,3823,3,3,3,0,3820,3820,3820,0,0,0,0,0,0,0,0,0,0,670,30,60,20,20,5
2020,772800331,16330,6000,6000,6000,0,10330,10000,5000,5000,0,330,0,330,0,0,0,0,0,1020,120,330,240,30,2
2020,772800341,85996,10276,10276,10276,0,75720,59800,8800,51000,0,15920,1250,14670,0,0,0,0,0,2774,150,270,240,144,143
2020,772900301,20400,1100,1100,1100,0,19300,18000,18000,0,0,1300,1300,0,0,700,700,0,0,3400,150,50,300,200,312
2020,772900311,50922,5822,5822,5822,0,45100,42600,36000,6600,0,2500,2200,300,0,1760,1760,1760,0,4750,380,200,270,300,152
2020,772900321,180495,8345,8345,8345,0,172150,169000,90000,79000,0,3150,2400,750,0,88000,78000,78000,0,6000,400,100,400,400,400
2020,772900331,1149,1124,624,624,500,25,0,0,0,0,25,0,25,0,1300,1300,0,1300,858,200,40,60,48,30
2020,772900341,4700,200,200,200,0,4500,4500,4500,0,0,0,0,0,0,0,0,0,0,286,80,50,10,6,2
2020,772900351,8070,200,200,200,0,7870,7500,7500,0,0,370,270,100,0,0,0,0,0,664,82,12,108,22,44
2020,772900361,300,300,300,300,0,0,0,0,0,0,0,0,0,0,0,0,0,0,290,96,10,10,14,2
2020,780000302,9866,1866,1866,1866,0,8000,8000,8000,0,0,0,0,0,0,0,0,0,0,1494,152,85,55,52,55
2020,780000342,32776,3296,3296,3296,0,29480,17500,17500,0,0,11980,3500,4480,4000,10700,10700,7300,3400,2547,222,84,576,138,208
2020,780000372,26830,1530,1530,1530,0,25300,24000,10000,14000,0,1300,1300,0,0,10150,10150,5600,4550,3840,120,60,300,240,99
2020,780000382,31939,3359,1359,1359,2000,28580,27930,0,27930,0,650,650,0,0,21580,2580,0,2580,4093,180,150,240,240,9
2020,780000392,52224,1374,1374,1374,0,50850,50500,22000,28500,0,350,350,0,0,21090,19090,19000,0,2883,320,364,400,180,62
2020,780600311,47730,10230,10230,9230,0,37500,25500,18000,7500,0,12000,1000,11000,0,21500,18500,7000,11500,4586,620,30,156,315,53
2020,780600321,19250,200,200,200,0,19050,19050,12050,7000,0,0,0,0,0,0,0,0,0,900,156,10,10,24,15
2020,780600331,6020,1020,1020,1020,0,5000,5000,5000,0,0,0,0,0,0,0,0,0,0,1093,186,400,30,60,10
2020,780600361,27236,6156,6156,6156,0,21080,18000,18000,0,0,3080,3000,80,0,8600,8600,8600,0,2960,216,62,216,252,165
2020,780600371,5000,1000,1000,1000,0,4000,4000,4000,0,0,0,0,0,0,0,0,0,0,1085,65,300,10,20,7
2020,780700311,5979,3949,3449,3449,500,2030,0,0,0,0,2030,1990,40,0,0,0,0,0,2086,362,30,300,70,32
2020,780700321,13290,4190,4190,4190,0,9100,8000,8000,0,0,1100,1100,0,0,0,0,0,0,1490,96,84,224,55,72
2020,780700331,7004,5304,3304,3304,2000,1700,0,0,0,0,1700,1700,0,0,1782,1782,1200,500,1340,315,3,216,116,133
2020,780700341,31718,8628,8628,8628,0,23090,22400,0,9200,13200,690,690,0,0,13200,13200,0,13200,2923,240,900,120,144,42
2020,780700361,2910,1410,1110,110,300,1500,0,0,0,0,1500,0,1500,0,0,0,0,0,2094,204,20,10,110,1
2020,780800311,28718,2263,2263,2263,0,26455,10455,8000,2455,0,16000,2200,800,13000,0,0,0,0,1511,134,628,96,48,24
2020,780800321,4370,270,270,270,0,4100,4100,4100,0,0,0,0,0,0,0,0,0,0,1296,156,84,120,40,6
2020,780800341,32792,17608,6808,4808,10800,15184,11000,0,11000,0,4184,3100,1084,0,1558,1558,0,1558,3000,250,100,400,250,156
2020,780800351,43055,8552,8552,7152,0,34503,32390,19000,390,13000,2113,2000,113,0,100,100,0,0,2540,300,200,180,120,26
2020,780800361,73996,23396,23396,9396,0,50600,46000,22000,24000,0,4600,4400,200,0,30712,13712,13612,0,3920,360,240,480,480,134
2020,780800371,315,315,15,15,300,0,0,0,0,0,0,0,0,0,3500,3500,0,3500,906,336,10,84,144,4
2020,780800381,31625,2790,2790,2790,0,28835,28000,28000,0,0,835,835,0,0,12600,7700,1700,6000,5764,160,450,660,342,216
2020,780800391,95352,15502,15502,15502,0,79850,75300,45300,30000,0,4550,4200,350,0,37350,37350,37000,0,3386,516,360,240,180,6591
2020,780900311,21400,4600,4600,4600,0,16800,16500,9000,7500,0,300,300,0,0,2000,0,0,0,1640,170,250,72,48,25
2020,780900331,23492,6606,6606,6606,0,16886,16500,7500,9000,0,386,250,136,0,1340,1340,1340,0,1614,152,20,360,132,55
2020,780900341,94,94,94,94,0,0,0,0,0,0,0,0,0,0,0,0,0,0,691,86,150,50,15,1
2020,780900351,33335,14335,14335,8335,0,19000,13000,9000,4000,0,6000,3500,1300,1200,20,20,0,0,2904,145,50,240,156,106
2020,780900361,24522,2972,2972,2972,0,21550,21500,21500,0,0,50,50,0,0,0,0,0,0,2130,330,150,230,120,53
2020,780900381,110,110,110,110,0,0,0,0,0,0,0,0,0,0,0,0,0,0,600,144,36,1,29,1
2020,780900391,19564,3064,3064,3064,0,16500,13000,13000,0,0,3500,3500,0,0,8200,8200,8200,0,2404,252,10,600,264,164
2020,781000312,85000,300,300,300,0,84700,84250,32000,52250,0,450,400,50,0,48200,18450,18450,0,2500,300,100,100,300,479
2020,781000322,11900,900,900,900,0,11000,8500,8500,0,0,2500,2300,200,0,5000,5000,5000,0,4066,130,40,470,216,136
2020,781000332,30088,8488,8488,6488,0,21600,9000,9000,0,0,12600,600,12000,0,6524,6524,6500,0,2326,156,220,360,150,121
2020,781000342,110,110,10,10,100,0,0,0,0,0,0,0,0,0,134,134,0,0,720,338,0,30,52,1
2020,781000352,4180,3590,3290,3290,300,590,0,0,0,0,590,590,0,0,0,0,0,0,2093,540,280,130,133,9
2020,781000362,8490,2140,2140,2140,0,6350,6000,6000,0,0,350,350,0,0,0,0,0,0,1399,195,80,154,150,40
2020,781000372,14470,7170,7170,5170,0,7300,6200,6200,0,0,1100,900,200,0,0,0,0,0,2820,180,20,312,220,45
2020,781000382,82403,39778,9778,9778,30000,42625,41000,0,41000,0,1625,1300,325,0,27013,2013,0,0,3016,190,10,420,120,133
2020,781600301,243066,13766,13766,10766,0,229300,208000,23000,185000,0,21300,300,21000,0,200000,200000,200000,0,4626,1110,250,300,280,168
2020,781600311,25466,6216,6216,6216,0,19250,19000,19000,0,0,250,250,0,0,7940,7940,7940,0,2398,290,25,160,182,133
2020,781600341,77228,12228,12228,12228,0,65000,61000,30000,31000,0,4000,4000,0,0,27000,25000,20000,5000,4204,240,300,250,144,477
2020,781600351,19500,2500,2500,2500,0,17000,17000,11000,6000,0,0,0,0,0,8000,8000,5000,3000,2610,130,120,420,180,439
2020,781600371,166516,11066,11066,11066,0,155450,152000,20000,132000,0,3450,2450,1000,0,22000,1000,0,1000,4930,600,300,360,420,2111
2020,781600381,92105,12222,12222,12222,0,79883,78000,36000,32000,10000,1883,1770,113,0,22000,0,0,0,2510,184,160,300,56,351
2020,781600391,65030,8290,8290,8290,0,56740,56000,38000,18000,0,740,590,150,0,1500,0,0,0,2014,230,30,240,84,179
2020,781700301,38077,13777,13777,10277,0,24300,20000,17000,0,3000,4300,4100,200,0,13050,13050,10250,2800,3310,219,900,168,300,185
2020,781700311,18481,5365,5365,5065,0,13116,11000,11000,0,0,2116,2100,16,0,7029,7029,4229,0,3502,840,10,216,294,227
2020,781700341,32318,11918,11918,11918,0,20400,20000,20000,0,0,400,400,0,0,2830,2830,2830,0,2676,232,180,170,180,100
2020,781700351,26082,6417,6417,6417,0,19665,19000,19000,0,0,665,620,45,0,0,0,0,0,1781,156,0,252,170,52
2020,781700361,28238,10908,10908,10908,0,17330,17000,17000,0,0,330,330,0,0,3597,3597,3597,0,3840,230,120,380,258,308
2020,781700371,10266,10266,3266,3266,7000,0,0,0,0,0,0,0,0,0,5890,5890,5860,0,890,120,50,50,50,1
2020,781700391,7580,6280,1780,1780,4500,1300,0,0,0,0,1300,1100,200,0,0,0,0,0,3800,180,50,540,360,503
2020,781800321,22599,19263,8263,7763,11000,3336,0,0,0,0,3336,3200,136,0,3230,3230,0,2000,3898,290,460,360,288,51
2020,781800331,23705,8105,105,105,8000,15600,0,0,0,0,15600,3600,0,12000,7000,7000,7000,0,4970,600,10,360,300,40
2020,781800341,19700,1000,1000,1000,0,18700,18000,0,18000,0,700,700,0,0,1500,500,0,0,1080,48,24,60,48,81
2020,781800351,74802,21074,21074,6074,0,53728,30500,23000,7500,0,23228,7550,5678,10000,23238,23238,20155,3000,5106,180,50,440,366,618
2020,781800361,29398,3816,3816,3816,0,25582,23000,23000,0,0,2582,1940,642,0,2050,2050,2000,0,2892,216,60,240,66,60
2020,781800371,62200,3700,3700,3700,0,58500,57000,45000,12000,0,1500,1500,0,0,15000,15000,15000,0,4800,360,400,600,360,488
2020,781800391,43057,8457,8457,4457,0,34600,26000,26000,0,0,8600,600,3000,5000,40000,40000,20000,0,4950,240,10,600,360,203
2020,781900301,19040,240,240,240,0,18800,18000,18000,0,0,800,800,0,0,20200,20200,13000,6500,7603,240,120,360,180,338
2020,781900331,17890,4440,4440,4440,0,13450,13000,13000,0,0,450,400,50,0,5379,5379,5379,0,3513,192,5,360,480,173
2020,781900341,38502,7652,7652,7652,0,30850,30500,12500,18000,0,350,150,200,0,1500,0,0,0,3812,540,200,250,72,278
2020,781900361,1552,1402,602,602,800,150,0,0,0,0,150,150,0,0,12550,12550,0,12300,3640,380,20,400,250,850
2020,781900371,34992,5922,5922,5922,0,29070,25000,13000,12000,0,4070,4070,0,0,78,78,0,0,3577,142,600,465,120,248
2020,782000302,1300,1300,300,300,1000,0,0,0,0,0,0,0,0,0,0,0,0,0,1967,687,20,20,180,126
2020,782000312,3650,3400,3400,3400,0,250,0,0,0,0,250,250,0,0,0,0,0,0,1376,438,10,180,72,97
2020,782000322,13660,2460,2460,2460,0,11200,11000,11000,0,0,200,200,0,0,5200,5200,5200,0,2406,356,100,300,180,155
2020,782000332,47440,3840,3840,3840,0,43600,38000,38000,0,0,5600,5600,0,0,1000,1000,0,1000,6812,456,40,360,240,1605
2020,782000352,6600,100,100,100,0,6500,6500,6500,0,0,0,0,0,0,0,0,0,0,1232,144,90,60,24,5
2020,782000362,27079,5240,5240,5240,0,21839,11500,11500,0,0,10339,1339,0,9000,1500,1500,1500,0,2546,302,124,216,241,22
2020,782000372,5140,40,40,40,0,5100,5100,5100,0,0,0,0,0,0,80,80,0,0,940,104,80,13,63,6
2020,782000382,21730,310,310,310,0,21420,18900,8100,10800,0,2520,780,1740,0,1700,1700,0,1700,2248,187,300,60,110,92
2020,782000392,458,180,180,180,0,278,0,0,0,0,278,278,0,0,0,0,0,0,1235,150,80,75,97,23
2020,782600301,56800,6200,6200,6200,0,50600,45000,0,45000,0,5600,5600,0,0,21000,0,0,0,2810,240,50,480,240,575
2020,782600311,19746,346,346,46,0,19400,19000,19000,0,0,400,400,0,0,21120,21120,13000,6800,6349,880,25,276,428,704
2020,782600341,3230,3230,2030,2030,1200,0,0,0,0,0,0,0,0,0,0,0,0,0,711,180,100,24,12,1
2020,782600351,19012,5256,5256,4656,0,13756,12000,12000,0,0,1756,1530,226,0,4800,4800,4800,0,5510,780,800,240,300,240
2020,782600391,150,150,150,150,0,0,0,0,0,0,0,0,0,0,0,0,0,0,356,58,105,12,26,1
2020,782700331,61240,22140,22140,22140,0,39100,39000,0,39000,0,100,100,0,0,0,0,0,0,1119,204,10,70,60,73
2020,782700341,16120,4520,4520,4520,0,11600,11000,11000,0,0,600,450,150,0,0,0,0,0,3000,350,230,480,240,427
2020,782700361,38324,13424,13424,13424,0,24900,14500,14500,0,0,10400,900,9500,0,7600,7600,0,0,4104,180,240,360,240,162
2020,782700371,9161,1161,1161,1161,0,8000,8000,8000,0,0,0,0,0,0,0,0,0,0,1170,132,104,50,84,8
2020,782700381,40,40,40,40,0,0,0,0,0,0,0,0,0,0,0,0,0,0,552,94,30,7,18,0
2020,782700391,16090,4190,4190,4190,0,11900,11400,0,11400,0,500,0,500,0,0,0,0,0,1272,190,60,20,42,21
2020,782800301,26090,16840,16840,16840,0,9250,8000,8000,0,0,1250,1250,0,0,40,40,0,0,2705,225,100,360,120,58
2020,782800311,13450,250,250,250,0,13200,13200,12000,1200,0,0,0,0,0,0,0,0,0,1710,500,400,30,120,17
2020,782800341,29930,2400,2400,2400,0,27530,27000,19000,8000,0,530,530,0,0,0,0,0,0,1027,100,60,120,103,38
2020,782800351,11439,3135,3135,3135,0,8304,8064,3600,4464,0,240,240,0,0,1850,1850,1850,0,2675,180,30,360,300,34
2020,782800361,44678,3104,3104,3104,0,41574,19000,7000,12000,0,22574,2450,20124,0,0,0,0,0,1905,117,96,120,60,70
2020,782800381,27410,8160,8160,8160,0,19250,18800,6800,12000,0,450,450,0,0,0,0,0,0,1856,139,50,300,120,51
2020,782800391,9150,2350,2350,2350,0,6800,6300,3000,3300,0,500,50,450,0,0,0,0,0,1073,110,184,65,39,19
2020,782900301,35699,8460,8460,8460,0,27239,26900,23000,3900,0,339,0,339,0,18800,8500,8500,0,1806,385,100,15,66,74
2020,782900321,51180,27600,27600,27600,0,23580,23000,23000,0,0,580,580,0,0,16000,16000,11000,5000,6200,480,500,480,360,760
2020,782900331,28090,27140,5140,5140,22000,950,0,0,0,0,950,950,0,0,5070,5070,5000,0,2280,280,300,480,240,110
2020,782900351,140,140,140,140,0,0,0,0,0,0,0,0,0,0,0,0,0,0,530,65,120,29,16,1
2020,782900371,4972,1172,1172,1172,0,3800,3800,3800,0,0,0,0,0,0,0,0,0,0,2614,300,24,50,120,4
2020,782900381,1788,1338,838,838,500,450,0,0,0,0,450,450,0,0,560,560,0,540,3376,600,6,50,240,21
2020,782900391,7410,7335,7335,7335,0,75,75,0,75,0,0,0,0,0,0,0,0,0,664,69,34,17,36,1
2020,783000302,12924,4524,4524,4524,0,8400,5000,5000,0,0,3400,3400,0,0,1000,1000,0,0,2563,132,290,620,156,72
2020,783000312,9200,1500,1500,1500,0,7700,7280,4580,2700,0,420,400,20,0,0,0,0,0,1196,100,200,100,86,75
2020,783600301,34453,8653,8653,8653,0,25800,9000,9000,0,0,16800,1000,15800,0,0,0,0,0,1665,120,300,220,60,54
2020,783700301,2021,21,21,21,0,2000,2000,2000,0,0,0,0,0,0,150,150,0,0,1551,205,300,80,96,3
2020,783700311,976,976,976,976,0,0,0,0,0,0,0,0,0,0,0,0,0,0,445,130,10,20,35,1
2020,783800301,142812,29512,29512,29512,0,113300,96000,15000,81000,0,17300,5800,11500,0,1000,1000,0,1000,2720,250,150,600,200,142
2020,783900301,24360,12360,12360,9260,0,12000,9000,4000,5000,0,3000,0,3000,0,1140,1140,740,0,3701,116,3000,45,0,13
2020,790000212,6599,99,99,99,0,6500,6500,6500,0,0,0,0,0,0,1742,1742,1000,742,2069,250,40,420,168,4
2020,790000232,4016,1616,1116,1116,500,2400,0,0,0,0,2400,700,700,1000,1700,1700,0,0,2374,480,120,20,144,88
2020,790000252,18266,4266,4266,4266,0,14000,9000,9000,0,0,5000,5000,0,0,1400,1400,0,0,3716,276,200,250,240,225
2020,790000262,31566,31566,22740,22740,8826,0,0,0,0,0,0,0,0,0,0,0,0,0,1344,250,180,60,24,107
2020,790000272,9126,9126,300,300,8826,0,0,0,0,0,0,0,0,0,0,0,0,0,1057,180,220,100,72,540
2020,790000282,84508,19586,7481,7481,12105,64922,64700,0,33000,31700,222,222,0,0,31574,6574,0,6400,4553,606,85,293,241,523
2020,790000302,12150,2150,2150,2150,0,10000,10000,10000,0,0,0,0,0,0,0,0,0,0,1240,100,60,150,60,15
2020,790000332,2792,1442,1442,1442,0,1350,0,0,0,0,1350,350,500,500,20000,20000,20000,0,4478,840,50,100,240,47
2020,790000342,85550,100,100,100,0,85450,85000,10000,75000,0,450,400,50,0,10000,10000,10000,0,1414,144,240,86,52,19
2020,790000362,112500,3700,3700,3700,0,108800,108000,37000,71000,0,800,800,0,0,450,0,0,0,2000,150,300,200,120,270
2020,790000372,1572,1572,1572,1572,0,0,0,0,0,0,0,0,0,0,0,0,0,0,1292,386,12,60,84,1
2020,790000382,40984,3310,3010,1010,300,37674,30000,0,30000,0,7674,4874,800,2000,27380,27380,20000,6880,5604,934,50,1240,360,71
2020,790000392,2500,2500,2500,2500,0,0,0,0,0,0,0,0,0,0,0,0,0,0,421,60,120,0,24,4
2020,790600201,72612,16662,16662,16662,0,55950,55500,28000,27500,0,450,450,0,0,12000,0,0,0,4020,210,300,400,360,379
2020,790600301,2300,1200,100,100,1100,1100,0,0,0,0,1100,1100,0,0,400,400,0,0,1860,240,500,230,120,206
2020,790600311,25166,3546,3546,3546,0,21620,16000,16000,0,0,5620,4620,1000,0,6992,6992,0,6000,3858,212,50,480,360,150
2020,790600341,53210,5210,5210,5210,0,48000,48000,20000,28000,0,0,0,0,0,0,0,0,0,1575,180,500,105,60,123
2020,790600351,2522,2112,2062,2062,50,410,0,0,0,0,410,410,0,0,0,0,0,0,2826,654,585,290,216,167
2020,790600381,115432,16932,16932,16932,0,98500,96000,44000,52000,0,2500,2500,0,0,0,0,0,0,7850,480,400,600,390,215
2020,790700201,80128,1628,1628,1628,0,78500,78400,23400,55000,0,100,0,100,0,0,0,0,0,572,240,36,24,36,62
2020,790700211,91740,19040,4040,2040,15000,72700,70000,0,70000,0,2700,1500,700,500,21420,9420,8000,1120,5560,360,100,400,500,207
2020,790700301,15960,2960,2960,2960,0,13000,13000,5000,8000,0,0,0,0,0,0,0,0,0,1145,380,50,50,50,10
2020,790700311,41540,960,960,960,0,40580,39500,27000,12500,0,1080,830,250,0,20000,20000,5000,15000,1362,100,240,150,72,39
2020,790700321,17417,627,627,627,0,16790,16000,0,16000,0,790,790,0,0,0,0,0,0,4255,292,100,428,220,76
2020,790700331,490,40,40,40,0,450,0,0,0,0,450,450,0,0,0,0,0,0,842,60,60,84,18,24
2020,790700341,199000,3000,3000,3000,0,196000,189000,29000,160000,0,7000,2000,5000,0,1500,1500,0,1500,1226,100,50,240,72,218
2020,790700371,115906,5980,5980,5980,0,109926,109000,26000,83000,0,926,400,526,0,0,0,0,0,2338,135,372,144,62,534
2020,790800201,6345,4345,1845,1845,2500,2000,0,0,0,0,2000,0,0,2000,2500,2500,0,2500,2630,270,10,180,150,1
2020,790800231,18880,3880,3880,3880,0,15000,15000,15000,0,0,0,0,0,0,0,0,0,0,1144,264,240,120,60,16
2020,790800241,21534,2334,2334,2334,0,19200,18000,15000,3000,0,1200,1200,0,0,4530,4530,4530,0,1690,320,30,210,140,167
2020,790800261,30461,1861,1861,1861,0,28600,25000,12000,13000,0,3600,100,1500,2000,13500,4000,0,0,4071,540,160,420,360,201
2020,790800301,200,200,200,200,0,0,0,0,0,0,0,0,0,0,0,0,0,0,694,66,60,100,36,2
2020,790800311,33022,5022,5022,5022,0,28000,25000,25000,0,0,3000,3000,0,0,0,0,0,0,3930,240,60,720,300,193
2020,790800351,1025,1025,1025,1025,0,0,0,0,0,0,0,0,0,0,0,0,0,0,387,26,10,0,20,1
2020,790800361,660,10,10,10,0,650,0,0,0,0,650,650,0,0,1550,1550,0,1550,2280,400,50,300,120,103
2020,790800381,186770,23420,8420,4420,15000,163350,160000,0,160000,0,3350,350,0,3000,69000,20000,15000,5000,4720,480,100,500,300,1495
2020,790900201,16104,41,41,41,0,16063,16000,16000,0,0,63,0,63,0,0,0,0,0,1445,300,500,10,15,18
2020,790900221,2804,2554,1554,1554,1000,250,0,0,0,0,250,250,0,0,0,0,0,0,2326,660,36,360,180,15
2020,790900231,76320,3820,3820,3820,0,72500,70000,22000,48000,0,2500,2000,500,0,2000,0,0,0,4696,390,700,480,156,244
2020,790900241,2000,2000,2000,2000,0,0,0,0,0,0,0,0,0,0,0,0,0,0,524,48,10,60,36,1
2020,790900281,36630,20530,6530,6530,14000,16100,13000,0,13000,0,3100,2700,400,0,200,200,0,0,4920,300,300,180,240,94
2020,790900301,5680,5300,5300,5300,0,380,0,0,0,0,380,150,230,0,1240,1240,0,1200,2469,776,65,60,168,50
2020,790900321,16344,15844,15844,15844,0,500,0,0,0,0,500,500,0,0,0,0,0,0,3502,166,48,240,300,80
2020,790900341,8150,2150,2150,2150,0,6000,6000,6000,0,0,0,0,0,0,0,0,0,0,740,64,36,0,15,10
2020,790900361,1518,1498,98,98,1400,20,0,0,0,0,20,0,20,0,0,0,0,0,542,228,60,5,18,0
2020,790900371,85303,17103,17103,17103,0,68200,67000,50000,17000,0,1200,1000,200,0,17086,17086,13386,3500,6700,350,200,250,300,668
2020,790900381,56170,3370,3370,3370,0,52800,50000,50000,0,0,2800,2800,0,0,23700,23700,21700,2000,3700,300,100,500,200,698
2020,791000202,12950,11750,950,450,10800,1200,0,0,0,0,1200,800,400,0,7300,7300,0,7000,4756,816,100,840,120,56
2020,791000222,173400,1100,1100,1100,0,172300,150000,70000,80000,0,22300,2300,20000,0,70000,70000,70000,0,4650,300,200,720,540,3057
2020,791000232,79665,8065,8065,8065,0,71600,70000,70000,0,0,1600,1600,0,0,12600,12600,12600,0,2950,300,20,300,480,1274
2020,791000312,1360,1160,1060,1060,100,200,0,0,0,0,200,200,0,0,5000,5000,0,3000,1895,76,660,120,96,51
2020,791000322,3090,1090,820,820,270,2000,0,0,0,0,2000,2000,0,0,2240,2240,0,0,774,169,20,250,0,54
2020,791000332,61200,48200,8300,8300,39900,13000,0,0,0,0,13000,3000,10000,0,30000,30000,0,30000,4850,250,50,50,200,18543
2020,791000342,16232,15232,5262,5262,9970,1000,0,0,0,0,1000,1000,0,0,9970,9970,9970,0,3304,336,100,240,288,55
2020,791600301,5,5,5,5,0,0,0,0,0,0,0,0,0,0,0,0,0,0,476,156,24,0,96,1
2020,791600311,98037,20592,20592,14592,0,77445,76500,23000,53500,0,945,850,95,0,1000,1000,0,1000,4957,181,500,360,300,231
2020,791600321,35910,1260,1260,1260,0,34650,30000,20000,10000,0,4650,1500,3150,0,5800,5800,3800,2000,1447,348,20,360,150,38
2020,791700301,2055,2055,55,55,2000,0,0,0,0,0,0,0,0,0,2000,2000,2000,0,2810,120,30,60,120,1
2020,791700321,282918,13218,13218,13218,0,269700,268000,20000,248000,0,1700,1700,0,0,5500,4500,0,4500,4676,196,1000,360,300,839
2020,791700341,49900,800,800,800,0,49100,36000,36000,0,0,13100,3100,0,10000,0,0,0,0,3002,300,50,600,72,41
2020,791800201,13700,200,200,200,0,13500,13500,13500,0,0,0,0,0,0,0,0,0,0,495,60,110,30,30,30
2020,791800221,23936,136,136,136,0,23800,20000,20000,0,0,3800,3400,400,0,13127,13127,10138,340,4056,370,20,216,400,173
2020,791800231,55850,9700,9700,9700,0,46150,46000,23000,23000,0,150,50,100,0,0,0,0,0,2184,600,61,58,49,52
2020,791800301,56249,6849,6849,6849,0,49400,48000,40000,8000,0,1400,1400,0,0,600,600,0,0,5220,130,230,700,100,631
2020,791800311,240410,8616,8616,8616,0,231794,227000,20000,207000,0,4794,4500,294,0,133660,111660,110000,0,7140,600,60,600,300,1022
2020,791800331,35400,3230,3230,3230,0,32170,31000,24000,7000,0,1170,0,1170,0,1300,1300,0,1300,974,73,100,10,96,86
2020,791900211,71100,20200,20200,20200,0,50900,50000,50000,0,0,900,900,0,0,70,70,0,70,2154,300,60,240,144,114
2020,791900221,44068,6468,6468,6468,0,37600,37000,27000,10000,0,600,600,0,0,11000,11000,11000,0,3574,300,60,524,120,130
2020,791900231,36639,9639,9639,9639,0,27000,24000,24000,0,0,3000,3000,0,0,7000,7000,7000,0,3170,320,200,200,160,291
2020,791900311,230,200,200,200,0,30,0,0,0,0,30,0,30,0,0,0,0,0,615,70,70,20,12,1
2020,791900321,30978,6658,6658,6658,0,24320,24000,24000,0,0,320,320,0,0,3038,3038,3000,0,3504,360,120,640,264,58
2020,791900341,99900,12500,12500,12500,0,87400,87000,37000,50000,0,400,400,0,0,3000,0,0,0,1763,228,50,150,72,98
2020,792800251,1320,920,920,920,0,400,0,0,0,0,400,400,0,0,200,200,0,0,1509,155,25,204,142,6
2020,792800261,115100,3500,3500,3500,0,111600,110000,70000,40000,0,1600,1500,100,0,0,0,0,0,1434,200,100,200,84,201
2020,792800271,148940,4140,4140,4140,0,144800,141000,60000,81000,0,3800,3800,0,0,44000,44000,44000,0,2890,180,280,200,300,533
2020,792800291,3030,30,30,30,0,3000,3000,3000,0,0,0,0,0,0,0,0,0,0,552,182,0,12,48,0
2020,793800281,98175,16925,16925,13925,0,81250,80000,60000,20000,0,1250,1250,0,0,19600,7600,0,7600,4295,360,65,200,120,698
2020,793800291,90294,16444,16444,16444,0,73850,70000,70000,0,0,3850,3050,800,0,0,0,0,0,7864,300,600,1320,380,214
2020,794800211,45422,3922,3922,3922,0,41500,41000,41000,0,0,500,500,0,0,20000,20000,20000,0,3220,260,800,470,150,457
2020,794800231,16180,9180,5180,2180,4000,7000,0,0,0,0,7000,0,7000,0,3960,3960,0,3960,2360,732,60,120,180,1
2020,795800241,72788,31088,14088,14088,17000,41700,36000,0,36000,0,5700,5500,200,0,18000,0,0,0,3480,180,200,720,100,1060
2020,795800261,160350,14350,14350,14350,0,146000,140000,40000,100000,0,6000,6000,0,0,35000,3000,0,3000,5300,360,300,600,240,2104
2020,810000132,1011,1011,11,11,1000,0,0,0,0,0,0,0,0,0,0,0,0,0,1205,680,1,60,80,1
2020,810000142,2360,2160,1160,460,1000,200,0,0,0,0,200,200,0,0,2030,2030,1800,0,4260,800,40,200,300,87
2020,810000182,15000,15000,1000,1000,14000,0,0,0,0,0,0,0,0,0,0,0,0,0,768,60,60,0,48,16
2020,810000202,552,52,52,52,0,500,0,0,0,0,500,500,0,0,7000,7000,0,2000,1403,96,10,360,120,44
2020,810000212,28725,8725,2225,2225,6500,20000,20000,0,20000,0,0,0,0,0,12100,10100,10000,0,2437,438,65,84,180,17
2020,810000222,18930,1030,1030,1030,0,17900,17000,7000,10000,0,900,700,150,50,0,0,0,0,1606,120,60,240,96,54
2020,810000232,39705,13205,13205,13205,0,26500,26000,25000,1000,0,500,500,0,0,0,0,0,0,3884,264,200,144,156,1367
2020,810000242,6585,6385,885,385,5500,200,0,0,0,0,200,0,200,0,0,0,0,0,858,180,50,42,41,4
2020,810000262,48580,6080,6080,5080,0,42500,38000,38000,0,0,4500,4500,0,0,0,0,0,0,4970,940,30,600,200,87
2020,810000272,31340,3340,3340,3340,0,28000,26000,20000,6000,0,2000,2000,0,0,0,0,0,0,5132,300,300,600,312,107
2020,810000282,33980,14830,7330,2330,7500,19150,0,0,0,0,19150,4150,3000,12000,0,0,0,0,5158,1044,74,300,588,967
2020,810000302,52937,2337,2337,2337,0,50600,49000,49000,0,0,1600,1600,0,0,9000,9000,8000,1000,2515,240,50,100,150,94
2020,810000312,16100,6100,6100,6100,0,10000,10000,10000,0,0,0,0,0,0,1000,1000,1000,0,2664,144,120,600,360,30
2020,810000322,1315,1315,815,815,500,0,0,0,0,0,0,0,0,0,15,15,0,0,522,114,12,36,60,1
2020,810000332,4296,4296,796,796,3500,0,0,0,0,0,0,0,0,0,0,0,0,0,1510,200,50,130,120,61
2020,810000342,59100,39350,21350,21350,18000,19750,19300,0,11500,7800,450,450,0,0,5000,5000,5000,0,3572,240,400,360,192,2820
2020,810000352,144575,11575,11575,11575,0,133000,133000,22000,111000,0,0,0,0,0,18000,0,0,0,5744,180,3000,120,84,222
2020,810000382,44000,6200,6200,6200,0,37800,35000,35000,0,0,2800,2800,0,0,0,0,0,0,5360,360,200,240,160,224
2020,810000392,55420,9220,9220,9220,0,46200,42700,41500,0,1200,3500,3500,0,0,19100,19100,17600,1500,5400,480,240,600,360,682
2020,810600131,163710,75660,50660,50660,25000,88050,88000,0,88000,0,50,0,50,0,45000,7000,7000,0,1470,200,100,120,120,178
2020,810600171,142100,7100,7100,7100,0,135000,135000,100000,35000,0,0,0,0,0,35500,0,0,0,784,200,120,12,72,122
2020,810600181,3480,3480,680,680,2800,0,0,0,0,0,0,0,0,0,2260,2260,1860,0,1232,180,400,16,42,1
2020,810600211,10900,10900,4900,4900,6000,0,0,0,0,0,0,0,0,0,550,550,500,0,779,62,20,35,42,1
2020,810600221,5064,64,64,64,0,5000,5000,5000,0,0,0,0,0,0,0,0,0,0,1670,130,300,130,60,32
2020,810600231,15070,3070,3070,3070,0,12000,12000,12000,0,0,0,0,0,0,2000,0,0,0,1732,50,120,270,92,14
2020,810600341,166500,65500,65500,65500,0,101000,96000,26000,70000,0,5000,0,5000,0,14000,0,0,0,2610,270,600,50,140,1058
2020,810600361,32224,14074,14074,14074,0,18150,18000,11000,7000,0,150,0,150,0,0,0,0,0,1124,360,120,60,36,51
2020,810600371,13780,13630,630,630,13000,150,0,0,0,0,150,150,0,0,0,0,0,0,1781,240,120,720,91,37
2020,810600391,530,530,30,30,500,0,0,0,0,0,0,0,0,0,0,0,0,0,1186,576,20,120,130,1
2020,810601101,28890,3890,3890,3890,0,25000,23000,23000,0,0,2000,2000,0,0,300,300,300,0,2958,156,100,720,240,109
2020,810601111,84856,13756,13756,9756,0,71100,60000,60000,0,0,11100,3600,0,7500,2700,2700,2700,0,5054,216,10,504,327,680
2020,810601121,10400,9200,8700,8700,500,1200,0,0,0,0,1200,1200,0,0,6500,6500,0,5100,3132,600,12,360,240,365
2020,810700121,17141,141,141,141,0,17000,17000,17000,0,0,0,0,0,0,3600,3600,0,0,2456,120,60,240,240,20
2020,810700131,26400,21100,11100,9600,10000,5300,0,0,0,0,5300,300,0,5000,8000,8000,8000,0,4889,768,48,144,175,47
2020,810700141,7150,7150,150,150,7000,0,0,0,0,0,0,0,0,0,0,0,0,0,586,50,150,30,30,35
2020,810700161,120300,10000,10000,10000,0,110300,110000,110000,0,0,300,0,300,0,0,0,0,0,1284,360,24,10,30,130
2020,810700171,4800,4800,4300,4300,500,0,0,0,0,0,0,0,0,0,130,130,0,0,2286,694,36,20,84,552
2020,810700181,61588,6588,6588,5588,0,55000,50000,50000,0,0,5000,5000,0,0,4200,4200,1300,0,4460,300,60,600,300,409
2020,810700191,64584,13584,13584,11584,0,51000,50000,50000,0,0,1000,1000,0,0,0,0,0,0,3480,420,100,600,360,354
2020,810700221,8958,8958,3958,3958,5000,0,0,0,0,0,0,0,0,0,1310,1310,0,1260,2560,270,10,240,180,13
2020,810700241,5948,948,948,923,0,5000,5000,5000,0,0,0,0,0,0,0,0,0,0,1171,190,270,60,36,17
2020,810700251,17260,260,260,260,0,17000,13000,13000,0,0,4000,3800,200,0,0,0,0,0,2430,234,350,250,360,124
2020,810700261,54005,18030,18030,18030,0,35975,32500,15000,17500,0,3475,3000,475,0,11440,4440,3440,0,5570,450,120,580,360,117
2020,810700271,92000,2000,2000,2000,0,90000,90000,90000,0,0,0,0,0,0,15000,0,0,0,2710,360,150,60,120,378
2020,810700281,61257,4052,4052,4052,0,57205,50000,50000,0,0,7205,4200,3005,0,3000,0,0,0,5290,312,250,540,115,120
2020,810700291,21955,3555,3555,3555,0,18400,16000,16000,0,0,2400,2400,0,0,8870,8870,8700,0,2034,180,40,300,144,69
2020,810700331,77540,1360,1360,1360,0,76180,75000,50000,25000,0,1180,680,500,0,3000,0,0,0,1402,400,40,80,72,324
2020,810700351,23862,9462,7962,6962,1500,14400,13600,0,13600,0,800,800,0,0,0,0,0,0,1548,192,18,240,102,40
2020,810700391,35127,2107,2107,2107,0,33020,32000,32000,0,0,1020,1020,0,0,15365,15365,14965,0,4350,240,30,240,300,282
2020,810701101,9950,9550,2550,2550,7000,400,0,0,0,0,400,400,0,0,0,0,0,0,1548,96,20,240,72,28
2020,810800101,97530,1680,1680,1680,0,95850,95000,95000,0,0,850,850,0,0,9600,9600,9600,0,6510,520,2100,430,210,292
2020,810800151,73701,2690,2690,2690,0,71011,71000,21000,50000,0,11,0,11,0,9170,9170,9170,0,1467,178,10,156,180,83
2020,810800161,376050,6050,6050,6050,0,370000,320000,300000,20000,0,50000,0,50000,0,70000,40000,40000,0,6430,500,500,360,240,1631
2020,810800181,302140,51640,51640,51640,0,250500,250000,170000,80000,0,500,500,0,0,46000,1000,1000,0,4340,600,100,500,240,656
2020,810800201,467,422,172,172,250,45,0,0,0,0,45,0,45,0,4620,4620,0,4620,2940,340,636,252,420,30
2020,810800211,40150,5150,5150,5150,0,35000,35000,35000,0,0,0,0,0,0,5500,0,0,0,1493,140,30,84,24,22
2020,810800221,59,8,8,8,0,51,0,0,0,0,51,0,51,0,0,0,0,0,660,360,0,24,10,0
2020,810800231,3530,30,30,30,0,3500,3500,3500,0,0,0,0,0,0,0,0,0,0,1533,135,240,120,168,24
2020,810800241,17624,6624,6624,6624,0,11000,11000,11000,0,0,0,0,0,0,0,0,0,0,2010,120,10,120,120,98
2020,810800251,9412,9412,5912,5912,3500,0,0,0,0,0,0,0,0,0,1200,1200,700,500,4130,720,600,720,240,17
2020,810800271,13550,1500,1500,1500,0,12050,12000,12000,0,0,50,0,50,0,0,0,0,0,511,60,40,10,15,5
2020,810800281,231,231,231,231,0,0,0,0,0,0,0,0,0,0,0,0,0,0,1152,180,240,120,72,3
2020,810800301,82332,5632,5632,5632,0,76700,74500,64500,10000,0,2200,2200,0,0,400,400,0,400,3410,450,300,480,150,143
2020,810800311,2181,1581,1081,1081,500,600,0,0,0,0,600,600,0,0,4000,4000,0,4000,1420,540,70,360,100,90
2020,810800321,68240,4840,4840,4840,0,63400,61000,50000,11000,0,2400,2250,150,0,57135,48135,17840,25000,6640,240,150,500,420,495
2020,810800331,22620,20220,3720,3720,16500,2400,0,0,0,0,2400,2400,0,0,0,0,0,0,4850,580,120,400,150,48
2020,810800371,11130,11130,4630,4630,6500,0,0,0,0,0,0,0,0,0,0,0,0,0,1006,84,36,72,264,54
2020,810800381,98390,4390,390,390,4000,94000,94000,0,81000,13000,0,0,0,0,44300,13300,13000,0,2166,288,24,168,216,88
2020,810800391,9340,8840,1840,240,7000,500,0,0,0,0,500,0,0,500,2190,2190,0,1300,956,180,10,10,120,12
2020,810900101,443000,294000,294000,294000,0,149000,140000,140000,0,0,9000,4000,5000,0,0,0,0,0,12000,1000,700,1300,300,594
2020,810900111,34034,5734,5734,5734,0,28300,25000,25000,0,0,3300,3300,0,0,2600,2600,0,0,3800,900,200,700,200,854
2020,810900121,34315,4315,4315,4315,0,30000,29000,27000,2000,0,1000,1000,0,0,500,0,0,0,4600,400,150,300,250,49
2020,810900161,126566,21066,21066,21066,0,105500,105000,90000,15000,0,500,400,100,0,5000,0,0,0,1795,600,300,120,50,501
2020,810900181,102000,2000,2000,2000,0,100000,100000,100000,0,0,0,0,0,0,2500,0,0,0,8420,1000,360,120,240,209
2020,810900191,108666,2166,2166,2166,0,106500,106000,106000,0,0,500,500,0,0,30000,0,0,0,1638,680,50,60,48,141
2020,810900201,3008,8,8,8,0,3000,3000,3000,0,0,0,0,0,0,2000,2000,0,0,775,120,180,50,15,11
2020,810900211,26317,9151,9151,9151,0,17166,17000,17000,0,0,166,0,166,0,0,0,0,0,1158,360,40,2,36,26
2020,810900221,110563,7514,7514,7514,0,103049,103000,53000,50000,0,49,0,49,0,0,0,0,0,4790,330,160,80,120,572
2020,810900241,530,505,5,5,500,25,0,0,0,0,25,0,25,0,7300,7300,300,0,908,480,0,24,24,0
2020,810900251,27812,2245,2245,2245,0,25567,15000,15000,0,0,10567,500,10067,0,14000,14000,11000,0,1245,144,30,180,151,52
2020,810900261,4800,4800,4800,4800,0,0,0,0,0,0,0,0,0,0,0,0,0,0,944,280,10,72,30,9
2020,810900271,18220,220,220,220,0,18000,18000,18000,0,0,0,0,0,0,7000,0,0,0,1200,72,560,70,48,13
2020,810900281,16540,5140,5140,5140,0,11400,11400,11400,0,0,0,0,0,0,0,0,0,0,1701,180,100,180,108,93
2020,810900291,3578,3560,560,560,3000,18,0,0,0,0,18,0,18,0,0,0,0,0,1510,540,12,72,120,82
2020,810900301,131360,1670,1670,1670,0,129690,127000,60000,67000,0,2690,2500,190,0,17566,17566,17516,0,2787,350,150,250,312,1118
2020,810900311,80130,12230,12230,11480,0,67900,62000,50000,0,12000,5900,5900,0,0,16850,16550,0,950,6860,480,160,1000,320,1018
2020,810900351,22246,2946,2946,2946,0,19300,18000,18000,0,0,1300,1300,0,0,9000,9000,9000,0,2560,230,170,400,220,43
2020,810900371,87110,12510,12510,12510,0,74600,74600,40000,34600,0,0,0,0,0,20500,0,0,0,1890,250,10,150,150,245
2020,810900381,96695,30695,30695,28695,0,66000,64000,64000,0,0,2000,2000,0,0,27870,27870,25970,1900,4160,300,600,600,200,1542
2020,810900391,11958,9458,9458,9458,0,2500,0,0,0,0,2500,2500,0,0,2130,2130,0,2130,4120,360,120,120,480,1036
2020,811000112,21120,21120,120,120,21000,0,0,0,0,0,0,0,0,0,4000,4000,4000,0,1887,360,20,360,240,23
2020,811000122,131200,4200,4200,4200,0,127000,125000,125000,0,0,2000,2000,0,0,33200,33200,29500,3700,6480,480,100,350,250,1638
2020,811000132,65420,5420,4420,4420,1000,60000,60000,0,60000,0,0,0,0,0,63000,12000,12000,0,1295,445,30,20,100,92
2020,811000162,38873,1753,1753,1753,0,37120,37000,37000,0,0,120,120,0,0,500,500,0,0,3906,360,120,144,228,83
2020,811000172,30000,1000,1000,1000,0,29000,28000,28000,0,0,1000,500,500,0,300,300,0,0,1444,240,60,50,84,45
2020,811000182,155000,46000,46000,36000,0,109000,95000,80000,15000,0,14000,14000,0,0,500,0,0,0,11300,1000,1000,1500,300,22697
2020,811000192,3250,3150,150,150,3000,100,0,0,0,0,100,0,100,0,1400,1400,0,1400,3820,1200,30,200,240,37
2020,811000202,1100,1100,100,100,1000,0,0,0,0,0,0,0,0,0,0,0,0,0,1568,498,10,120,120,1
2020,811000222,20240,5126,5126,5126,0,15114,15000,0,15000,0,114,0,114,0,0,0,0,0,1330,320,160,40,0,9
2020,811000232,10215,9962,4962,4962,5000,253,0,0,0,0,253,0,253,0,1600,1600,1500,0,4046,1620,10,120,120,2
2020,811000242,94960,38510,38510,38510,0,56450,56000,10000,46000,0,450,200,250,0,19500,500,0,500,2843,60,250,180,60,113
2020,811000252,9450,350,350,350,0,9100,9000,9000,0,0,100,100,0,0,70,70,0,0,1416,60,360,300,84,28
2020,811000262,11890,2315,2315,1315,0,9575,9500,9500,0,0,75,0,75,0,350,350,350,0,5010,240,300,480,420,205
2020,811000272,20,20,20,20,0,0,0,0,0,0,0,0,0,0,0,0,0,0,1380,150,50,120,120,0
2020,811000282,67350,3192,3192,3192,0,64158,60000,60000,0,0,4158,4000,158,0,100,100,0,0,2788,378,240,300,120,3082
2020,811000292,145508,12808,12808,12808,0,132700,130000,80000,50000,0,2700,2700,0,0,30900,30900,30000,0,5100,500,100,1800,300,668
2020,811000302,2205,2205,80,80,2125,0,0,0,0,0,0,0,0,0,0,0,0,0,396,104,20,7,12,1
2020,811000312,4900,4900,900,900,4000,0,0,0,0,0,0,0,0,0,0,0,0,0,950,400,60,60,60,1
2020,811000322,40900,29800,7800,7800,22000,11100,9300,0,0,9300,1800,1800,0,0,9300,9300,0,9300,4592,120,500,200,72,320
2020,811000332,39980,8450,8450,8450,0,31530,30000,30000,0,0,1530,1500,30,0,0,0,0,0,1881,240,120,171,138,96
2020,811000352,1505,1505,5,5,1500,0,0,0,0,0,0,0,0,0,0,0,0,0,639,360,10,10,24,1
2020,811000372,168070,8670,8670,5670,0,159400,150000,150000,0,0,9400,1300,8100,0,40200,28200,28200,0,3540,240,20,240,300,1235
2020,811000382,54800,1800,1800,1800,0,53000,50000,50000,0,0,3000,3000,0,0,0,0,0,0,1800,240,120,240,240,90
2020,811000392,276311,156368,131368,131368,25000,119943,115000,0,115000,0,4943,3150,1793,0,5000,0,0,0,11220,480,2000,500,120,1881
2020,811600111,19918,1918,1918,1918,0,18000,18000,18000,0,0,0,0,0,0,6760,6760,5760,1000,4740,360,120,180,300,24
2020,811600121,21420,14620,7620,6620,7000,6800,4800,0,0,4800,2000,2000,0,0,1000,1000,0,1000,4376,960,100,600,300,193
2020,811600131,65530,5530,5530,5530,0,60000,60000,60000,0,0,0,0,0,0,30000,30000,30000,0,6101,300,120,90,216,358
2020,811600151,126732,16532,16532,16532,0,110200,110000,110000,0,0,200,200,0,0,58000,8000,8000,0,5176,284,2000,480,252,251
2020,811600181,42710,5710,5710,5710,0,37000,37000,37000,0,0,0,0,0,0,90,90,0,90,3100,300,150,480,60,87
2020,811600201,700,700,700,700,0,0,0,0,0,0,0,0,0,0,0,0,0,0,701,70,128,25,18,1
2020,811600211,1500,900,900,900,0,600,0,0,0,0,600,600,0,0,0,0,0,0,1373,180,150,50,30,70
2020,811600221,33606,13606,13606,13606,0,20000,20000,20000,0,0,0,0,0,0,0,0,0,0,1211,165,100,38,68,102
2020,811600231,46100,11100,11100,11100,0,35000,35000,35000,0,0,0,0,0,0,0,0,0,0,2340,240,600,60,120,60
2020,811600251,30450,10180,10180,10180,0,20270,20000,20000,0,0,270,90,180,0,0,0,0,0,1191,220,120,160,43,62
2020,811600261,18240,240,240,240,0,18000,18000,18000,0,0,0,0,0,0,1500,1500,0,0,754,132,40,40,72,18
2020,811600271,15581,1489,1489,1489,0,14092,11000,11000,0,0,3092,3000,92,0,4000,4000,4000,0,2460,310,400,600,120,38
2020,811600291,21940,3640,3640,3640,0,18300,16500,16500,0,0,1800,1800,0,0,0,0,0,0,1270,120,10,250,120,151
2020,811600321,75070,14570,14570,14570,0,60500,55000,55000,0,0,5500,5500,0,0,0,0,0,0,3756,300,60,360,156,2475
2020,811600341,64000,59500,7500,7500,52000,4500,0,0,0,0,4500,4300,200,0,40,40,0,0,3054,280,330,180,84,2219
2020,811600351,449,449,149,149,300,0,0,0,0,0,0,0,0,0,2200,2200,0,800,848,344,48,84,96,1
2020,811600361,28353,353,353,353,0,28000,26000,26000,0,0,2000,2000,0,0,15000,15000,15000,0,2270,180,50,600,120,62
2020,811700111,800,800,300,300,500,0,0,0,0,0,0,0,0,0,0,0,0,0,1550,400,120,120,100,1
2020,811700121,380,380,80,80,300,0,0,0,0,0,0,0,0,0,1208,1208,0,948,1450,420,40,120,80,1
2020,811700141,18390,18390,18390,18390,0,0,0,0,0,0,0,0,0,0,0,0,0,0,2050,180,60,100,200,334
2020,811700151,286550,77550,20550,20550,57000,209000,208000,0,208000,0,1000,1000,0,0,48191,47691,47691,0,4520,250,10,360,120,437
2020,811700171,112700,6900,6900,6900,0,105800,105000,65000,40000,0,800,800,0,0,0,0,0,0,4320,360,500,360,360,378
2020,811700191,39034,28740,8740,6740,20000,10294,10000,0,10000,0,294,0,294,0,15500,15500,14900,0,4780,240,200,360,180,205
2020,811700201,4940,4940,2940,2940,2000,0,0,0,0,0,0,0,0,0,1100,1100,1100,0,1026,330,10,60,50,1
2020,811700211,163050,5900,5900,5900,0,157150,151000,40000,111000,0,6150,2150,4000,0,58000,56000,56000,0,2754,300,240,480,180,456
2020,811700221,40330,30,30,30,0,40300,40000,40000,0,0,300,300,0,0,15100,12600,9800,1400,1020,240,24,120,36,63
2020,811700231,26179,8990,8990,8990,0,17189,17000,12000,5000,0,189,0,189,0,0,0,0,0,2554,130,1452,50,90,5
2020,811700251,5210,5210,5210,5210,0,0,0,0,0,0,0,0,0,0,0,0,0,0,2408,636,60,240,120,24
2020,811700271,48680,1330,1330,1330,0,47350,43000,43000,0,0,4350,3550,800,0,0,0,0,0,4808,410,145,980,140,194
2020,811700281,13700,200,200,200,0,13500,13000,13000,0,0,500,0,500,0,4374,4374,4280,0,901,156,20,15,60,20
2020,811700291,39330,7420,7420,7420,0,31910,30000,30000,0,0,1910,1660,250,0,0,0,0,0,2482,210,124,100,84,55
2020,811700311,15343,843,843,843,0,14500,14500,14500,0,0,0,0,0,0,10600,10600,10400,200,1604,98,1144,10,72,34
2020,811700321,60,60,60,60,0,0,0,0,0,0,0,0,0,0,0,0,0,0,502,150,0,5,60,2
2020,811700361,1240,240,40,40,200,1000,0,0,0,0,1000,0,1000,0,1140,1140,0,1140,504,60,3,15,36,0
2020,811700391,1580,1580,80,80,1500,0,0,0,0,0,0,0,0,0,800,800,800,0,1105,320,120,55,20,1
2020,811800111,31020,1020,1020,1020,0,30000,30000,30000,0,0,0,0,0,0,0,0,0,0,1644,200,180,60,24,18
2020,811800121,501,501,1,1,500,0,0,0,0,0,0,0,0,0,0,0,0,0,620,430,50,10,15,1
2020,811800131,50100,100,100,100,0,50000,50000,50000,0,0,0,0,0,0,1000,0,0,0,2670,60,1160,120,240,51
2020,811800141,50150,150,150,150,0,50000,50000,50000,0,0,0,0,0,0,19100,4300,4000,300,2890,200,300,120,130,51
2020,811800171,257400,25800,800,800,25000,231600,230000,0,230000,0,1600,400,1200,0,87000,38000,35000,3000,5160,850,120,300,250,1128
2020,811800181,62996,43796,1796,1796,42000,19200,15000,0,15000,0,4200,1800,2400,0,36750,36750,33600,2450,7300,450,1000,150,500,812
2020,811800191,65862,1732,1732,1732,0,64130,63000,63000,0,0,1130,0,1130,0,12810,12810,12790,0,6130,360,120,590,420,247
2020,811800201,51038,16548,16548,16548,0,34490,34000,29000,0,5000,490,400,90,0,0,0,0,0,4830,360,100,450,250,919
2020,811800211,150080,65780,65780,65780,0,84300,84000,56000,28000,0,300,300,0,0,17000,0,0,0,2260,252,50,120,215,204
2020,811800221,50245,5095,5095,5095,0,45150,45000,45000,0,0,150,0,150,0,2138,2138,2138,0,2953,252,450,170,156,51
2020,811800231,110640,20940,20940,20440,0,89700,89000,51000,38000,0,700,500,200,0,28460,28460,28460,0,6226,816,500,350,200,497
2020,811800261,7500,7200,500,500,6700,300,0,0,0,0,300,300,0,0,0,0,0,0,2156,204,60,340,132,47
2020,811800271,39550,1250,1250,1250,0,38300,28400,19000,9400,0,9900,2900,0,7000,3420,3420,3300,120,1829,84,100,95,150,43
2020,811800281,5154,4784,2784,1984,2000,370,0,0,0,0,370,370,0,0,700,700,0,700,2610,840,15,230,85,19
2020,811800291,25100,100,100,100,0,25000,25000,25000,0,0,0,0,0,0,3500,3500,3500,0,831,140,100,15,36,22
2020,811800311,94610,2010,2010,2010,0,92600,92000,92000,0,0,600,600,0,0,10000,10000,0,10000,2880,240,100,200,180,1521
2020,811800321,239900,62900,62900,62900,0,177000,158000,80000,78000,0,19000,4000,15000,0,8000,0,0,0,4480,600,240,120,120,661
2020,811800361,262600,30600,30600,30600,0,232000,232000,180000,52000,0,0,0,0,0,30000,30000,30000,0,2160,600,120,120,120,685
2020,811800371,2700,2700,200,200,2500,0,0,0,0,0,0,0,0,0,1800,1800,0,0,1760,380,30,130,170,3
2020,811900131,311200,105900,105900,91400,0,205300,190000,130000,60000,0,15300,2300,13000,0,800,800,0,0,4240,600,50,720,420,5146
2020,811900151,140750,250,250,250,0,140500,140000,60000,80000,0,500,500,0,0,27470,14470,14470,0,2220,340,1000,10,70,234
2020,811900161,890,610,110,110,500,280,0,0,0,0,280,280,0,0,0,0,0,0,2062,600,60,240,120,52
2020,811900171,5,5,5,5,0,0,0,0,0,0,0,0,0,0,0,0,0,0,814,264,70,10,10,0
2020,811900181,1450,1450,950,950,500,0,0,0,0,0,0,0,0,0,0,0,0,0,2050,620,30,200,200,3
2020,811900191,112956,45256,6256,6256,39000,67700,66000,0,44000,22000,1700,1700,0,0,22000,0,0,0,4230,250,20,350,120,1511
2020,811900201,34080,1680,1680,1680,0,32400,32000,32000,0,0,400,400,0,0,100,0,0,0,1808,154,360,14,320,28
2020,811900231,13230,1030,1030,1030,0,12200,12000,12000,0,0,200,0,200,0,0,0,0,0,478,99,140,34,15,17
2020,811900241,320,320,20,20,300,0,0,0,0,0,0,0,0,0,80,80,0,0,720,144,60,84,12,0
2020,811900251,1544,1544,1244,1244,300,0,0,0,0,0,0,0,0,0,1000,1000,0,0,1215,140,5,100,100,0
2020,811900271,15870,120,120,120,0,15750,15000,15000,0,0,750,750,0,0,10000,10000,10000,0,2552,192,30,550,130,123
2020,811900281,53180,7980,7980,7480,0,45200,45000,45000,0,0,200,200,0,0,1800,1800,0,1800,6808,852,120,660,420,684
2020,811900291,108,108,8,8,100,0,0,0,0,0,0,0,0,0,0,0,0,0,870,300,60,36,24,0
2020,811900301,1300,700,100,100,600,600,0,0,0,0,600,600,0,0,300,300,0,0,2441,350,160,300,300,62
2020,811900311,28166,12166,2166,2166,10000,16000,16000,0,16000,0,0,0,0,0,1000,0,0,0,1309,480,80,12,72,11
2020,811900341,26388,25975,5975,5975,20000,413,0,0,0,0,413,150,263,0,2000,2000,0,2000,4046,216,100,600,240,1354
2020,811900361,106116,55896,1896,1896,54000,50220,50000,0,50000,0,220,220,0,0,9400,9400,9400,0,3720,480,240,480,360,178
2020,811900371,11740,6740,6740,6740,0,5000,0,0,0,0,5000,5000,0,0,3000,3000,0,3000,4000,300,150,360,200,348
2020,811900381,25566,4666,4666,4666,0,20900,19600,18000,1600,0,1300,1300,0,0,5800,0,0,0,1815,320,330,170,115,91
2020,811900391,42930,2230,2230,2230,0,40700,39000,27000,12000,0,1700,1700,0,0,5950,5950,5500,300,2239,144,60,240,145,33
2020,812000102,1020,1020,20,20,1000,0,0,0,0,0,0,0,0,0,0,0,0,0,1754,492,720,36,66,3
2020,812000132,3642,3642,1142,1142,2500,0,0,0,0,0,0,0,0,0,0,0,0,0,2748,429,48,180,131,174
2020,812000152,3084,84,84,84,0,3000,0,0,0,0,3000,1000,0,2000,300,300,0,0,3050,180,300,800,200,1
2020,812000162,38860,5860,5860,5860,0,33000,33000,18000,15000,0,0,0,0,0,10000,5000,5000,0,778,180,80,50,48,45
2020,812000172,26100,100,100,100,0,26000,26000,26000,0,0,0,0,0,0,0,0,0,0,1077,220,120,15,52,54
2020,812000182,49860,4560,4560,4560,0,45300,45000,30000,15000,0,300,300,0,0,25250,15250,15200,0,3244,264,190,324,276,185
2020,812000212,22990,190,190,190,0,22800,21000,15000,6000,0,1800,1800,0,0,2500,2000,2000,0,1532,120,12,120,200,22
2020,812000222,500,500,500,500,0,0,0,0,0,0,0,0,0,0,0,0,0,0,862,300,10,60,72,2
2020,812000232,26038,6028,6028,6028,0,20010,19500,18500,1000,0,510,450,60,0,200,200,0,0,2140,150,30,400,300,44
2020,812000242,34682,10650,10650,10650,0,24032,24000,24000,0,0,32,0,32,0,0,0,0,0,1616,180,600,60,96,116
2020,812000262,14010,10,10,10,0,14000,14000,14000,0,0,0,0,0,0,0,0,0,0,1155,154,436,10,48,15
2020,812000272,20180,180,180,180,0,20000,17000,17000,0,0,3000,3000,0,0,9500,9500,8500,1000,3480,500,200,300,200,132
2020,812000282,28644,8344,3344,3344,5000,20300,20000,0,20000,0,300,200,100,0,5133,133,0,0,4084,344,390,300,180,398
2020,812000292,26550,5150,5150,5150,0,21400,21000,21000,0,0,400,400,0,0,0,0,0,0,1560,240,60,240,120,46
2020,812000302,22961,19461,4461,4461,15000,3500,3500,0,0,3500,0,0,0,0,0,0,0,0,2112,432,180,96,96,11
2020,812000312,27583,2470,2470,2470,0,25113,24400,24400,0,0,713,600,113,0,14900,14900,14400,500,3299,180,24,120,80,124
2020,812000332,68150,42850,18350,18350,24500,25300,22900,0,0,22900,2400,2400,0,0,45000,45000,45000,0,3178,495,418,65,120,2505
2020,812000352,116475,45975,45975,45975,0,70500,70000,70000,0,0,500,500,0,0,0,0,0,0,11240,600,200,250,360,4089
2020,812000372,14900,2900,2900,2900,0,12000,12000,12000,0,0,0,0,0,0,0,0,0,0,2630,130,50,120,180,85
2020,812000382,11100,100,100,100,0,11000,11000,11000,0,0,0,0,0,0,3411,3411,3211,200,2634,156,1210,48,84,21
2020,812000392,4074,4074,174,174,3900,0,0,0,0,0,0,0,0,0,3300,3300,3300,0,1025,220,120,10,20,1
2020,812600101,208889,26891,26891,26891,0,181998,181000,75000,106000,0,998,998,0,0,65994,23994,17094,6900,8100,700,1000,1200,600,1250
2020,812600111,1,1,1,1,0,0,0,0,0,0,0,0,0,0,0,0,0,0,1130,228,10,36,96,0
2020,812600161,297,297,17,17,280,0,0,0,0,0,0,0,0,0,0,0,0,0,1564,370,10,70,144,7
2020,812600171,57670,19170,1170,1170,18000,38500,36000,0,0,36000,2500,2500,0,0,20000,20000,3000,17000,3254,180,50,240,204,1244
2020,812600181,1510,1510,510,510,1000,0,0,0,0,0,0,0,0,0,2400,2400,0,2400,2392,744,10,144,144,1
2020,812600191,103000,13000,13000,13000,0,90000,90000,60000,30000,0,0,0,0,0,3000,0,0,0,3300,300,200,200,150,3908
2020,812600201,40452,33852,8852,8852,25000,6600,0,0,0,0,6600,1600,5000,0,20000,20000,20000,0,6308,360,470,276,360,437
2020,812600211,573,573,73,73,500,0,0,0,0,0,0,0,0,0,0,0,0,0,782,295,120,10,15,1
2020,812600221,25060,24060,11560,11560,12500,1000,0,0,0,0,1000,1000,0,0,20,20,0,0,2246,144,120,252,180,489
2020,812600261,670,670,370,370,300,0,0,0,0,0,0,0,0,0,0,0,0,0,1488,300,60,96,144,2
2020,812600311,53095,3095,3095,3095,0,50000,50000,50000,0,0,0,0,0,0,26800,26800,26800,0,5185,205,10,1260,240,51
2020,812600361,9985,9785,6285,2785,3500,200,0,0,0,0,200,200,0,0,2000,2000,1400,0,1736,250,36,180,120,37
2020,812600371,320,320,170,170,150,0,0,0,0,0,0,0,0,0,3558,3558,0,3558,420,84,30,10,16,3
2020,812700101,30500,6300,6300,6300,0,24200,22000,22000,0,0,2200,200,0,2000,0,0,0,0,1876,550,20,12,120,49
2020,812700111,60510,510,510,510,0,60000,60000,60000,0,0,0,0,0,0,30500,13000,13000,0,2342,620,120,180,216,299
2020,812700121,78800,2300,2300,2300,0,76500,71000,71000,0,0,5500,3500,2000,0,20000,20000,10000,0,2762,250,300,360,132,471
2020,812700141,57600,2600,2600,2600,0,55000,55000,30000,25000,0,0,0,0,0,3000,0,0,0,1860,240,800,10,40,111
2020,812700151,73443,11293,11293,11293,0,62150,60000,60000,0,0,2150,1800,350,0,750,750,0,0,3120,180,100,200,180,367
2020,812700161,81316,10716,10716,10216,0,70600,70000,70000,0,0,600,600,0,0,0,0,0,0,2498,276,200,300,72,173
2020,812700221,87231,9531,9531,9531,0,77700,74000,71000,0,3000,3700,3500,200,0,13000,13000,1000,12000,5580,480,50,250,250,807
2020,812700241,260,110,10,10,100,150,0,0,0,0,150,150,0,0,9200,9200,0,0,880,400,10,100,30,37
2020,812700261,65140,12140,12140,12140,0,53000,52000,38000,14000,0,1000,1000,0,0,0,0,0,0,5570,250,200,360,240,564
2020,812700271,10334,10334,3334,3334,7000,0,0,0,0,0,0,0,0,0,2000,2000,0,2000,2212,412,30,310,150,3
2020,812700281,21157,5457,5457,5457,0,15700,15000,15000,0,0,700,700,0,0,1760,1760,1760,0,2847,240,60,300,27,343
2020,812700291,30040,24290,8290,8290,16000,5750,0,0,0,0,5750,5350,400,0,6200,6200,1200,5000,4084,360,320,360,144,671
2020,812700301,22872,18972,4972,4972,14000,3900,0,0,0,0,3900,3200,700,0,11200,11200,9600,1500,5402,720,50,240,84,388
2020,812700311,55380,8580,8580,8580,0,46800,46000,46000,0,0,800,700,100,0,24600,24600,24600,0,3000,120,570,360,240,388
2020,812700321,30320,4520,4520,4520,0,25800,25000,25000,0,0,800,800,0,0,0,0,0,0,1011,204,200,120,55,138
2020,812700341,10480,5580,1280,1280,4300,4900,0,0,0,0,4900,900,4000,0,500,500,0,500,1568,264,240,360,132,56
2020,812700351,16710,16710,13210,13210,3500,0,0,0,0,0,0,0,0,0,2000,2000,2000,0,1260,140,200,30,110,3
2020,812700361,281100,7000,7000,7000,0,274100,267000,75000,192000,0,7100,2100,0,5000,156700,128200,128200,0,2870,200,110,340,200,250
2020,812700371,120380,58380,58380,58380,0,62000,60000,45000,0,15000,2000,2000,0,0,0,0,0,0,2820,250,60,120,300,764
2020,812700381,10169,1169,1169,1169,0,9000,9000,9000,0,0,0,0,0,0,0,0,0,0,604,70,100,50,24,11
2020,812700391,11175,2075,2075,2075,0,9100,8000,8000,0,0,1100,1100,0,0,0,0,0,0,546,100,20,76,10,60
2020,812800101,2310,2310,310,310,2000,0,0,0,0,0,0,0,0,0,2900,2900,0,1800,5070,1380,30,240,400,0
2020,812800111,67072,16172,16172,16172,0,50900,48000,48000,0,0,2900,2900,0,0,12900,12900,8000,4900,5852,252,1000,300,240,442
2020,812800121,39235,690,690,190,0,38545,38000,38000,0,0,545,0,245,300,18350,18350,18350,0,4328,248,100,250,300,35
2020,812800131,4426,3226,726,226,2500,1200,0,0,0,0,1200,0,0,1200,400,400,0,0,2350,690,120,150,180,1
2020,812800151,29247,7747,7747,7747,0,21500,20000,20000,0,0,1500,1500,0,0,11940,11940,11340,600,2790,150,50,100,120,125
2020,812800171,35050,1050,1050,1050,0,34000,34000,18000,16000,0,0,0,0,0,8000,0,0,0,585,140,50,40,15,56
2020,812800191,49110,8760,8760,8760,0,40350,40000,40000,0,0,350,350,0,0,26784,26784,20984,5000,4050,290,100,280,140,726
2020,812800201,5720,1100,1100,1100,0,4620,4500,4500,0,0,120,0,120,0,0,0,0,0,1783,144,396,48,72,4
2020,812800211,7152,7152,152,152,7000,0,0,0,0,0,0,0,0,0,1500,1500,0,1400,3179,120,15,240,144,6
2020,812800221,19840,4040,4040,4040,0,15800,13000,13000,0,0,2800,2500,300,0,1500,1500,0,1500,1884,240,120,180,156,214
2020,812800231,46154,7004,7004,7004,0,39150,34100,21500,12600,0,5050,4700,350,0,0,0,0,0,3050,360,240,360,180,652
2020,812800251,8262,262,262,262,0,8000,8000,8000,0,0,0,0,0,0,1400,0,0,0,1668,84,60,60,48,26
2020,812800261,228,228,12,12,216,0,0,0,0,0,0,0,0,0,0,0,0,0,615,156,25,24,24,0
2020,812800271,394,394,34,34,360,0,0,0,0,0,0,0,0,0,0,0,0,0,686,188,17,24,25,0
2020,812800291,200,200,200,200,0,0,0,0,0,0,0,0,0,0,0,0,0,0,885,120,50,120,15,160
2020,812800301,900,550,50,50,500,350,0,0,0,0,350,350,0,0,2500,2500,500,0,1994,480,12,420,72,94
2020,812800311,47650,7050,7050,7050,0,40600,40300,40300,0,0,300,300,0,0,18560,18560,18560,0,3745,180,25,600,120,273
2020,812800321,65468,2468,2468,2468,0,63000,62000,45000,17000,0,1000,1000,0,0,14075,3075,3000,0,3326,180,72,240,84,297
2020,812800331,38200,200,200,200,0,38000,38000,38000,0,0,0,0,0,0,0,0,0,0,894,240,96,10,36,51
2020,812800351,34010,33410,11410,7410,22000,600,0,0,0,0,600,600,0,0,13000,13000,13000,0,4680,240,360,480,480,37
2020,812800371,284,284,20,20,264,0,0,0,0,0,0,0,0,0,0,0,0,0,569,80,5,30,24,0
2020,812800391,58820,820,820,820,0,58000,58000,58000,0,0,0,0,0,0,0,0,0,0,1900,420,200,200,120,63
2020,812900101,16750,750,750,750,0,16000,16000,16000,0,0,0,0,0,0,0,0,0,0,860,180,120,60,60,23
2020,812900121,75920,7920,7920,7920,0,68000,68000,68000,0,0,0,0,0,0,0,0,0,0,870,236,20,20,24,85
2020,812900141,109170,10870,10870,10870,0,98300,98000,70000,28000,0,300,300,0,0,33200,2200,0,2200,5400,360,300,600,480,559
2020,812900151,65352,4652,4652,4652,0,60700,60000,60000,0,0,700,700,0,0,18000,18000,18000,0,3200,400,30,300,300,102
2020,812900171,37146,15296,15296,15296,0,21850,21000,21000,0,0,850,850,0,0,0,0,0,0,2520,200,100,490,180,302
2020,812900211,25750,50,50,50,0,25700,25700,25700,0,0,0,0,0,0,28300,28300,16300,0,1056,70,50,100,36,25
2020,812900231,10800,2790,2790,2790,0,8010,8000,8000,0,0,10,0,10,0,500,0,0,0,1466,144,230,24,36,49
2020,812900251,22278,21678,1678,1678,20000,600,0,0,0,0,600,600,0,0,0,0,0,0,2744,204,100,106,204,21
2020,812900261,47820,10620,10620,7620,0,37200,25000,25000,0,0,12200,100,100,12000,9980,9980,9980,0,2394,240,150,480,84,130
2020,812900291,42600,42600,6600,6600,36000,0,0,0,0,0,0,0,0,0,0,0,0,0,1703,182,15,82,90,6
2020,812900311,1970,1670,670,670,1000,300,0,0,0,0,300,300,0,0,0,0,0,0,2350,820,10,250,140,31
2020,812900321,58670,14670,14670,14670,0,44000,40000,40000,0,0,4000,4000,0,0,1300,1300,0,1300,3766,336,300,660,300,215
2020,812900331,47249,649,649,649,0,46600,45000,43000,2000,0,1600,1600,0,0,12518,12518,12368,0,3010,210,50,350,300,103
2020,812900351,13340,140,140,140,0,13200,12000,12000,0,0,1200,1200,0,0,2300,2300,2300,0,1280,180,100,400,100,11
2020,812900361,8200,200,200,200,0,8000,8000,8000,0,0,0,0,0,0,540,540,0,0,941,120,36,90,100,14
2020,812900371,414,414,14,14,400,0,0,0,0,0,0,0,0,0,600,600,0,0,1196,200,120,70,120,0
2020,812900391,65536,4036,4036,4036,0,61500,60000,60000,0,0,1500,1500,0,0,16500,16500,16500,0,3500,230,50,350,150,287
2020,813000102,56900,20900,20900,20900,0,36000,35000,35000,0,0,1000,1000,0,0,1000,1000,0,1000,5800,200,800,600,240,155
2020,813000112,105373,13023,13023,13023,0,92350,92000,42000,50000,0,350,350,0,0,23210,210,0,0,2630,90,150,180,60,181
2020,813000132,38482,5282,5282,5282,0,33200,31000,31000,0,0,2200,2200,0,0,0,0,0,0,3560,300,300,400,360,78
2020,813000152,1618,1218,218,218,1000,400,0,0,0,0,400,400,0,0,100,100,0,0,2988,960,32,200,252,11
2020,813000162,5050,5050,50,50,5000,0,0,0,0,0,0,0,0,0,5445,5445,0,5145,1446,66,30,50,240,13
2020,813000202,25702,120,120,120,0,25582,25000,25000,0,0,582,400,182,0,10000,10000,10000,0,3301,360,240,120,240,479
2020,813000212,32840,4430,4430,1430,0,28410,27000,27000,0,0,1410,1000,410,0,6000,6000,6000,0,4942,450,72,300,180,521
2020,813000222,24410,5810,5810,5810,0,18600,18000,18000,0,0,600,600,0,0,0,0,0,0,3856,450,150,544,120,91
2020,813000272,2010,2010,10,10,2000,0,0,0,0,0,0,0,0,0,0,0,0,0,1288,456,15,120,52,1
2020,813000312,20570,12570,70,70,12500,8000,8000,0,0,8000,0,0,0,0,0,0,0,0,2070,200,70,150,180,105
2020,813000322,9900,9900,2900,2900,7000,0,0,0,0,0,0,0,0,0,0,0,0,0,746,60,10,10,54,6
2020,813000352,19641,141,141,141,0,19500,18000,18000,0,0,1500,1500,0,0,4180,4180,1340,2840,1930,192,60,480,120,83
2020,813000362,55826,3366,3366,3366,0,52460,47500,29000,18500,0,4960,4460,500,0,21208,7208,7208,0,2640,500,200,600,120,204
2020,813000372,14055,12355,355,355,12000,1700,0,0,0,0,1700,1700,0,0,0,0,0,0,2695,360,25,600,360,201
2020,813000382,39699,6299,6299,6299,0,33400,23000,23000,0,0,10400,400,0,10000,0,0,0,0,4322,360,300,1152,480,401
2020,813600111,90791,14291,14291,14291,0,76500,73000,50000,23000,0,3500,3500,0,0,0,0,0,0,5940,750,800,150,350,830
2020,813600121,33780,3530,3530,3530,0,30250,30000,30000,0,0,250,250,0,0,0,0,0,0,2735,300,15,120,150,96
2020,813600141,8760,8360,860,860,7500,400,0,0,0,0,400,400,0,0,0,0,0,0,1080,360,30,60,50,9
2020,813600151,19680,2580,2580,2580,0,17100,17000,10000,7000,0,100,100,0,0,6020,5720,4220,1500,2180,180,210,80,240,224
2020,813600161,21960,110,110,110,0,21850,21000,21000,0,0,850,850,0,0,14530,14530,14530,0,1990,85,100,370,280,38
2020,813600171,105966,3966,3966,3966,0,102000,100000,100000,0,0,2000,2000,0,0,31000,31000,29000,0,3272,240,400,200,156,154
2020,813600191,101600,5100,5100,3600,0,96500,96000,48000,48000,0,500,0,0,500,10000,0,0,0,2062,380,12,50,200,624
2020,813600201,3336,3336,1336,1336,2000,0,0,0,0,0,0,0,0,0,950,950,0,150,969,144,10,75,60,1
2020,813600221,244,244,4,4,240,0,0,0,0,0,0,0,0,0,0,0,0,0,719,96,10,30,32,0
2020,813600231,522,352,12,12,340,170,0,0,0,0,170,0,170,0,0,0,0,0,720,103,46,31,22,0
2020,813600241,20050,50,50,50,0,20000,20000,20000,0,0,0,0,0,0,800,0,0,0,968,71,90,40,47,20
2020,813600261,65727,280,280,280,0,65447,57000,39000,18000,0,8447,800,147,7500,440,440,0,0,2100,100,80,320,240,85
2020,813600301,37424,8724,8724,8724,0,28700,25000,25000,0,0,3700,3700,0,0,0,0,0,0,1986,222,340,260,145,351
2020,813600311,71285,12519,12519,12519,0,58766,58500,55000,3500,0,266,40,226,0,14800,14800,11900,2900,5150,400,1300,250,150,651
2020,813600321,230,30,30,30,0,200,0,0,0,0,200,200,0,0,1000,1000,0,0,2761,36,500,900,45,132
2020,813600351,10300,10000,10000,10000,0,300,0,0,0,0,300,300,0,0,2000,2000,0,2000,3565,360,10,100,275,251
2020,813600361,451,451,21,21,430,0,0,0,0,0,0,0,0,0,16105,16105,0,15900,2023,761,110,120,74,6
2020,813600371,66605,3605,3605,3605,0,63000,63000,43000,20000,0,0,0,0,0,23991,23991,21991,2000,4630,360,300,120,150,412
2020,813700101,4560,4060,3060,3060,1000,500,0,0,0,0,500,500,0,0,0,0,0,0,3490,840,50,240,240,20
2020,813700141,26676,7176,6176,6176,1000,19500,17000,0,17000,0,2500,2500,0,0,13650,13650,11880,0,2622,900,12,70,180,66
2020,813700151,16300,16300,3300,3300,13000,0,0,0,0,0,0,0,0,0,3000,3000,3000,0,1088,120,10,60,48,40
2020,813700171,90350,350,350,350,0,90000,90000,90000,0,0,0,0,0,0,15000,0,0,0,718,200,80,12,36,121
2020,813700181,12700,12350,5350,5350,7000,350,0,0,0,0,350,350,0,0,228,228,0,0,1910,108,120,360,72,127
2020,813700201,33269,5569,5569,5569,0,27700,27000,27000,0,0,700,700,0,0,6400,6400,5400,1000,4440,200,20,360,360,99
2020,813700211,47800,7600,7600,7600,0,40200,38500,24000,14500,0,1700,1700,0,0,4500,4500,4500,0,4170,240,360,360,140,154
2020,813700221,85870,23200,23200,18200,0,62670,60000,30000,30000,0,2670,250,1620,800,9500,9000,9000,0,2920,240,100,150,240,130
2020,813700231,37862,13862,13862,13862,0,24000,24000,24000,0,0,0,0,0,0,1169,1169,0,0,3720,1530,50,120,120,71
2020,813700261,3082,3064,64,64,3000,18,0,0,0,0,18,0,18,0,651,651,0,651,1375,396,60,84,102,1
2020,813700301,1930,630,130,130,500,1300,0,0,0,0,1300,1300,0,0,2500,2500,0,0,1510,800,20,200,200,42
2020,813700321,9000,9000,3000,3000,6000,0,0,0,0,0,0,0,0,0,0,0,0,0,914,84,100,30,50,2
2020,813700331,7940,7740,6740,6740,1000,200,0,0,0,0,200,200,0,0,0,0,0,0,2250,150,50,100,120,71
2020,813700341,31660,4660,160,160,4500,27000,0,0,0,0,27000,14000,0,13000,13000,13000,0,0,1810,230,80,400,130,35
2020,813700361,2980,2980,1780,1780,1200,0,0,0,0,0,0,0,0,0,0,0,0,0,2650,342,10,230,240,3
2020,813800121,9090,1890,890,890,1000,7200,0,0,0,0,7200,1200,0,6000,6620,6620,6620,0,1105,330,100,20,120,1
2020,813800131,4644,3894,894,894,3000,750,0,0,0,0,750,750,0,0,1360,1360,1000,360,1145,160,120,120,50,24
2020,813800141,76825,31525,9525,7525,22000,45300,42000,0,42000,0,3300,2300,0,1000,30000,0,0,0,5040,300,50,600,140,47
2020,813800151,1060,1060,60,60,1000,0,0,0,0,0,0,0,0,0,1330,1330,0,0,2170,840,360,120,180,8
2020,813800161,22052,21852,4852,4852,17000,200,0,0,0,0,200,200,0,0,0,0,0,0,2050,420,200,180,120,22
2020,813800191,14280,14280,4280,4280,10000,0,0,0,0,0,0,0,0,0,0,0,0,0,1612,132,200,120,60,4
2020,813800201,3880,3880,3880,3880,0,0,0,0,0,0,0,0,0,0,0,0,0,0,1731,600,90,118,76,12
2020,813800221,45836,19520,3520,3520,16000,26316,26316,0,24000,2316,0,0,0,0,16000,16000,0,16000,1318,180,360,50,48,42
2020,813800241,9470,8770,1270,1270,7500,700,0,0,0,0,700,700,0,0,2060,2060,1360,700,2504,244,80,720,180,40
2020,813800261,2840,2610,110,110,2500,230,0,0,0,0,230,230,0,0,500,500,0,400,1872,712,10,60,80,172
2020,813800301,64669,11269,11269,8269,0,53400,52000,52000,0,0,1400,1400,0,0,0,0,0,0,3738,360,100,300,168,718
2020,813800321,10638,638,638,638,0,10000,10000,10000,0,0,0,0,0,0,0,0,0,0,677,192,124,18,22,30
2020,813800331,15833,720,720,720,0,15113,15000,15000,0,0,113,0,113,0,0,0,0,0,1250,240,530,20,18,19
2020,813800391,50376,3600,3600,3600,0,46776,46000,31000,15000,0,776,550,226,0,0,0,0,0,2138,219,80,250,120,109
2020,813900151,1450,1150,150,150,1000,300,0,0,0,0,300,300,0,0,1700,1700,0,500,3156,960,200,100,120,120
2020,813900171,54754,4754,4754,4754,0,50000,50000,50000,0,0,0,0,0,0,38900,38900,31400,6500,3410,840,200,150,200,14
2020,813900181,67490,1990,1990,1990,0,65500,65000,65000,0,0,500,500,0,0,0,0,0,0,4758,382,150,650,276,628
2020,813900211,102340,14190,14190,9190,0,88150,85000,85000,0,0,3150,2500,650,0,28720,28720,28600,0,3418,510,100,218,220,103
2020,813900221,11070,9370,6370,6370,3000,1700,0,0,0,0,1700,1600,100,0,0,0,0,0,1855,420,70,160,95,404
2020,813900241,14030,780,780,780,0,13250,13000,13000,0,0,250,150,100,0,19589,19589,15500,4000,3578,300,120,470,240,65
2020,813900301,196,196,16,16,180,0,0,0,0,0,0,0,0,0,0,0,0,0,760,113,100,0,96,1
2020,813900321,15070,70,70,70,0,15000,15000,15000,0,0,0,0,0,0,7200,6700,6700,0,1001,260,200,20,36,26
2020,813900341,210,210,110,110,100,0,0,0,0,0,0,0,0,0,3200,3200,0,3200,1224,312,0,60,180,1
2020,813900351,9573,9573,73,73,9500,0,0,0,0,0,0,0,0,0,8550,8550,0,8550,2160,120,12,396,396,12
2020,813900361,60121,19621,19621,19621,0,40500,35000,35000,0,0,5500,5500,0,0,17850,17850,9850,0,6292,552,30,240,840,2291
2020,813900371,263,240,40,40,200,23,0,0,0,0,23,0,23,0,0,0,0,0,1704,132,10,240,312,2
2020,813900381,5300,5200,5200,5200,0,100,0,0,0,0,100,100,0,0,0,0,0,0,1656,240,500,60,36,61
2020,814000112,171178,88278,88278,88278,0,82900,80000,80000,0,0,2900,2900,0,0,0,0,0,0,9000,600,1000,1000,300,258
2020,814000132,74010,13360,3360,3360,10000,60650,58750,0,58750,0,1900,1900,0,0,67550,67550,64000,3550,4104,1500,115,130,144,1657
2020,814000152,508477,104477,104477,104477,0,404000,400000,400000,0,0,4000,4000,0,0,60,60,0,0,3580,500,200,50,160,1276
2020,814000182,11053,11053,53,53,11000,0,0,0,0,0,0,0,0,0,0,0,0,0,433,68,10,10,24,1
2020,814000192,11665,11665,1665,1665,10000,0,0,0,0,0,0,0,0,0,7000,7000,7000,0,732,60,15,72,96,14
2020,814000302,3700,2650,1650,1650,1000,1050,1000,0,1000,0,50,50,0,0,0,0,0,0,1629,570,200,60,86,26
2020,814000312,5170,5170,2170,2170,3000,0,0,0,0,0,0,0,0,0,0,0,0,0,2330,480,200,180,120,3
2020,814000342,30000,7000,7000,7000,0,23000,23000,23000,0,0,0,0,0,0,0,0,0,0,1644,336,195,48,108,26
2020,814000352,45622,21642,21642,11642,0,23980,21000,21000,0,0,2980,980,2000,0,13950,13950,13950,0,5595,216,58,456,276,232
2020,814000362,30750,250,250,250,0,30500,30000,30000,0,0,500,500,0,0,14625,14625,14625,0,2442,216,36,230,180,303
2020,814000382,62700,2700,2700,2700,0,60000,60000,60000,0,0,0,0,0,0,6000,0,0,0,1168,300,600,0,18,21
2020,814000392,36102,4476,4476,4476,0,31626,30000,30000,0,0,1626,1400,226,0,11900,11900,11900,0,2635,263,40,210,144,99
2020,814600101,104540,8000,8000,8000,0,96540,95000,95000,0,0,1540,1540,0,0,0,0,0,0,3740,400,50,200,100,1289
2020,814600111,10010,10010,10,10,10000,0,0,0,0,0,0,0,0,0,1480,1480,0,900,6840,1990,110,240,180,31
2020,814600131,29540,8940,8940,8940,0,20600,20000,20000,0,0,600,600,0,0,10760,10760,10760,0,3900,300,240,300,240,103
2020,814600141,50150,150,150,150,0,50000,50000,50000,0,0,0,0,0,0,7900,4400,0,0,1146,360,200,60,36,97
2020,814600181,74616,71216,23216,23216,48000,3400,0,0,0,0,3400,3000,400,0,12000,12000,12000,0,4080,330,300,384,200,889
2020,814600301,43570,3220,3220,3220,0,40350,28000,28000,0,0,12350,2350,10000,0,11800,11800,0,1800,2240,300,500,360,20,110
2020,814600311,36292,30792,7792,7792,23000,5500,3300,0,3300,0,2200,2200,0,0,1660,1000,1000,0,3394,300,36,240,180,551
2020,814600321,36510,14260,14260,14260,0,22250,22000,22000,0,0,250,250,0,0,0,0,0,0,2620,300,50,600,120,214
2020,814600331,23164,1164,1164,1164,0,22000,22000,22000,0,0,0,0,0,0,0,0,0,0,664,180,120,36,18,43
2020,814600351,22342,1142,1142,1142,0,21200,18000,18000,0,0,3200,3200,0,0,10836,10836,9320,0,2110,130,50,240,200,157
2020,814600361,92350,2350,2350,2350,0,90000,90000,40000,50000,0,0,0,0,0,27000,0,0,0,1200,150,50,10,0,61
2020,814600381,67330,7500,7500,7500,0,59830,50000,35000,15000,0,9830,9580,250,0,20600,13600,13600,0,2688,350,200,900,110,1145
2020,814700101,135300,5200,5200,5200,0,130100,130000,80000,50000,0,100,100,0,0,0,0,0,0,2274,310,10,84,54,211
2020,814700141,6700,200,200,200,0,6500,6500,6500,0,0,0,0,0,0,0,0,0,0,933,381,60,24,36,17
2020,814700161,74144,4644,4644,4644,0,69500,67000,57000,10000,0,2500,2500,0,0,17180,9680,8300,0,3125,240,84,240,192,440
2020,814700171,31873,5528,5528,5528,0,26345,22000,22000,0,0,4345,4300,45,0,13310,13310,9000,0,2838,200,300,396,336,700
2020,814700181,12980,12400,4000,4000,8400,580,0,0,0,0,580,580,0,0,842,842,0,722,2196,200,110,366,84,28
2020,814700311,23325,45,45,45,0,23280,23000,23000,0,0,280,280,0,0,0,0,0,0,1094,183,10,156,135,57
2020,814700361,37740,600,600,600,0,37140,37000,37000,0,0,140,140,0,0,7768,7768,7768,0,2321,360,550,150,36,51
2020,814700371,257680,56880,56880,56880,0,200800,200000,65000,135000,0,800,500,300,0,50170,25170,25170,0,5188,300,170,480,180,399
2020,814800101,11745,11045,11045,11045,0,700,0,0,0,0,700,700,0,0,2100,2100,0,1200,3010,400,20,250,210,165
2020,814800121,27819,6838,6838,6838,0,20981,20000,20000,0,0,981,800,181,0,0,0,0,0,4540,360,200,600,240,55
2020,814800151,2420,2420,20,20,2400,0,0,0,0,0,0,0,0,0,0,0,0,0,1018,180,171,15,42,0
2020,814800181,2525,2525,25,25,2500,0,0,0,0,0,0,0,0,0,1500,1500,1500,0,1025,420,200,10,15,1
2020,814800191,9460,9460,1460,1460,8000,0,0,0,0,0,0,0,0,0,5600,5600,5600,0,970,140,100,50,40,29
2020,814800311,172800,38300,38300,38300,0,134500,129000,40000,89000,0,5500,5500,0,0,55000,0,0,0,4012,360,50,372,204,735
2020,814800321,57315,2165,2165,2165,0,55150,55000,55000,0,0,150,150,0,0,15500,15500,14000,1500,6340,336,60,180,204,619
2020,814800331,25738,10338,10338,5338,0,15400,12800,0,0,12800,2600,600,0,2000,6405,6405,0,6405,3436,360,120,180,132,83
2020,814800351,233690,22440,22440,21440,0,211250,200000,60000,140000,0,11250,11250,0,0,43000,0,0,0,4344,540,480,360,324,2386
2020,814800371,51250,34750,8250,8250,26500,16500,15000,0,0,15000,1500,1500,0,0,17000,17000,17000,0,2680,240,60,240,120,311
2020,814800381,134140,81740,41740,40740,40000,52400,50000,0,50000,0,2400,2400,0,0,6300,6300,6300,0,4250,720,20,360,120,524
2020,814900101,15950,15950,5950,5950,10000,0,0,0,0,0,0,0,0,0,500,500,500,0,1018,60,10,100,48,13
2020,814900131,60950,60750,750,750,60000,200,0,0,0,0,200,200,0,0,0,0,0,0,2130,370,200,70,120,204
2020,814900141,61450,6450,6450,6450,0,55000,55000,55000,0,0,0,0,0,0,30000,0,0,0,1309,321,40,72,60,188
2020,814900151,7630,2580,2580,2580,0,5050,5000,0,5000,0,50,50,0,0,0,0,0,0,1078,360,40,150,48,41
2020,814900181,48700,48700,28700,28700,20000,0,0,0,0,0,0,0,0,0,2300,2300,0,2300,3340,240,300,120,120,1617
2020,814900301,101043,30933,30933,30933,0,70110,70000,40000,30000,0,110,110,0,0,15,15,0,0,2381,363,322,156,108,103
2020,814900331,551,551,51,51,500,0,0,0,0,0,0,0,0,0,0,0,0,0,1263,790,0,15,18,3
2020,814900351,150350,1300,1300,1300,0,149050,149000,29000,120000,0,50,0,50,0,0,0,0,0,1190,420,120,36,54,385
2020,814900371,53085,15735,15735,15735,0,37350,36400,33000,3400,0,950,950,0,0,0,0,0,0,1490,270,120,500,130,104
2020,814900391,1455,655,155,155,500,800,0,0,0,0,800,800,0,0,400,400,0,0,2228,540,20,360,168,255
2020,815000112,51500,6500,6500,6500,0,45000,45000,45000,0,0,0,0,0,0,0,0,0,0,1640,300,20,36,48,94
2020,815000142,117170,3290,3290,3290,0,113880,113000,70000,43000,0,880,500,380,0,67120,33120,33000,0,1930,300,60,80,120,260
2020,815000162,312100,117100,117100,97100,0,195000,191000,143000,48000,0,4000,3000,1000,0,20000,10000,10000,0,6689,650,100,300,402,1683
2020,815000172,19355,19355,355,355,19000,0,0,0,0,0,0,0,0,0,10020,10020,10000,0,2550,216,10,480,144,1
2020,815000182,15160,11660,1660,1660,10000,3500,3500,0,0,3500,0,0,0,0,0,0,0,0,2392,540,10,60,72,11
2020,815000302,23381,821,821,821,0,22560,22000,22000,0,0,560,560,0,0,5000,5000,5000,0,2864,324,10,360,240,260
2020,815000312,16930,16800,800,800,16000,130,0,0,0,0,130,130,0,0,0,0,0,0,3300,400,300,600,300,14
2020,815000332,57000,5400,5400,5400,0,51600,50000,33000,17000,0,1600,1600,0,0,15000,15000,15000,0,2492,360,84,300,168,175
2020,815000342,70140,41040,21040,21040,20000,29100,28000,0,28000,0,1100,1100,0,0,20765,5765,3000,2765,2468,240,84,420,168,471
2020,815000382,900,900,900,900,0,0,0,0,0,0,0,0,0,0,0,0,0,0,1696,192,20,300,84,41
2020,815000392,1000,1000,600,600,400,0,0,0,0,0,0,0,0,0,0,0,0,0,1251,144,600,72,46,1
2020,815600121,60500,500,500,500,0,60000,60000,60000,0,0,0,0,0,0,0,0,0,0,440,192,80,10,25,49
2020,815600131,7690,90,90,90,0,7600,7600,7600,0,0,0,0,0,0,2749,2749,2749,0,586,72,24,12,48,8
2020,815600181,45130,130,130,130,0,45000,45000,45000,0,0,0,0,0,0,0,0,0,0,877,180,50,120,72,38
2020,815600191,653,653,3,3,650,0,0,0,0,0,0,0,0,0,0,0,0,0,299,140,70,3,10,1
2020,815600301,49986,7556,7556,7556,0,42430,24500,24500,0,0,17930,2220,210,15500,3000,3000,3000,0,3517,288,125,540,150,98
2020,815600331,16365,10865,2865,2865,8000,5500,5000,0,0,5000,500,500,0,0,4500,4500,4500,0,3116,240,700,120,240,150
2020,815600351,103330,8300,8300,8300,0,95030,95000,95000,0,0,30,30,0,0,21728,2728,2593,0,3620,290,700,240,324,174
2020,815700111,28156,12856,12856,12856,0,15300,15000,15000,0,0,300,300,0,0,0,0,0,0,2850,240,200,120,240,782
2020,815700151,2824,2824,2324,2324,500,0,0,0,0,0,0,0,0,0,1500,1500,1500,0,2524,684,30,84,240,138
2020,815700161,62004,15154,15154,14514,0,46850,45000,45000,0,0,1850,650,1200,0,0,0,0,0,4568,410,180,340,198,1005
2020,815700181,319450,18550,18550,18550,0,300900,300000,300000,0,0,900,900,0,0,99000,87000,87000,0,1693,150,0,120,60,1256
2020,815700191,21980,18480,14980,14980,3500,3500,0,0,0,0,3500,3500,0,0,0,0,0,0,2070,120,10,370,120,378
2020,815700301,4700,4700,4700,4700,0,0,0,0,0,0,0,0,0,0,0,0,0,0,966,231,105,35,27,2
2020,815700311,224450,29950,29950,29950,0,194500,190000,190000,0,0,4500,4500,0,0,30000,30000,30000,0,6270,400,30,1000,360,9861
2020,815700331,181960,11360,11360,11360,0,170600,153000,75000,78000,0,17600,5600,9000,3000,195600,163600,109000,4200,6920,480,150,1440,250,3846
2020,815700341,102454,46204,46204,46204,0,56250,55000,30000,25000,0,1250,1250,0,0,6000,0,0,0,2516,260,150,250,156,503
2020,815700351,3715,3715,215,215,3500,0,0,0,0,0,0,0,0,0,0,0,0,0,510,60,40,60,54,0
2020,815700361,49197,2547,1547,1547,1000,46650,39000,0,39000,0,7650,650,0,7000,8000,8000,8000,0,1880,700,20,350,120,60
2020,815700381,5000,4600,100,100,4500,400,0,0,0,0,400,400,0,0,3211,3211,0,3211,1206,234,240,120,12,0
2020,815700391,73033,19783,19783,19783,0,53250,52750,39250,13500,0,500,500,0,0,18062,17062,12962,4100,5070,324,186,384,132,154
2020,815800101,111780,51580,51580,38580,0,60200,60000,60000,0,0,200,200,0,0,0,0,0,0,6420,480,240,480,300,2238
2020,815800111,64088,3388,3388,3388,0,60700,60000,60000,0,0,700,700,0,0,74075,74075,55375,0,3170,300,100,400,220,1095
2020,815800121,8624,6324,2374,2374,3950,2300,2300,0,0,2300,0,0,0,0,0,0,0,0,1953,104,450,126,180,31
2020,815800141,7208,7208,208,208,7000,0,0,0,0,0,0,0,0,0,30,30,0,0,1144,150,180,120,90,32
2020,815800151,330,330,30,30,300,0,0,0,0,0,0,0,0,0,0,0,0,0,366,96,20,10,36,1
2020,815800161,28034,2284,2284,2284,0,25750,25000,25000,0,0,750,750,0,0,11400,11400,11400,0,1727,240,120,390,137,67
2020,815800301,111810,61810,1810,1810,60000,50000,50000,0,50000,0,0,0,0,0,26000,26000,25000,1000,1760,360,100,100,100,222
2020,815800321,2500,0,0,0,0,2500,0,0,0,0,2500,2500,0,0,14060,14060,0,9300,3052,324,100,540,360,78
2020,815800331,25190,390,390,390,0,24800,23000,23000,0,0,1800,1800,0,0,1400,1400,1400,0,3103,300,50,130,15,113
2020,815800341,41560,41460,29460,29460,12000,100,0,0,0,0,100,100,0,0,0,0,0,0,1783,200,120,200,50,527
2020,815800371,1455,1455,55,55,1400,0,0,0,0,0,0,0,0,0,900,900,900,0,250,100,10,24,10,0
2020,815800391,11974,9724,9724,9724,0,2250,0,0,0,0,2250,2250,0,0,0,0,0,0,6051,300,160,900,336,86
2020,815900101,63522,2622,2622,1622,0,60900,57000,57000,0,0,3900,3900,0,0,25500,25500,20500,2000,5950,960,50,500,240,2879
2020,815900131,97521,7511,1511,1511,6000,90010,90000,0,90000,0,10,10,0,0,26250,15250,15000,0,3997,672,20,120,144,77
2020,815900151,5741,5741,3241,3241,2500,0,0,0,0,0,0,0,0,0,0,0,0,0,1688,192,5,150,80,1
2020,815900161,10528,10528,7328,7328,3200,0,0,0,0,0,0,0,0,0,1772,1772,872,500,2961,120,1000,140,180,99
2020,815900171,1757,1757,7,7,1750,0,0,0,0,0,0,0,0,0,30000,30000,0,0,590,300,30,10,0,1
2020,815900181,25505,5,5,5,0,25500,25000,25000,0,0,500,500,0,0,0,0,0,0,631,140,68,10,40,45
2020,815900331,27288,5288,5288,5288,0,22000,20000,20000,0,0,2000,2000,0,0,1085,1085,0,720,3255,280,270,115,220,180
2020,815900341,40995,395,395,395,0,40600,40000,40000,0,0,600,300,300,0,0,0,0,0,732,120,84,84,60,52
2020,815900351,3756,2506,6,6,2500,1250,0,0,0,0,1250,550,0,700,1150,1150,0,0,831,150,24,45,100,6
2020,815900361,27143,8443,8443,8443,0,18700,18000,18000,0,0,700,700,0,0,9532,9532,7732,1800,3950,300,100,150,350,198
2020,815900381,43143,2143,2143,2143,0,41000,41000,41000,0,0,0,0,0,0,15600,15600,15100,500,1612,180,10,180,180,89
2020,816000102,3620,3530,530,530,3000,90,0,0,0,0,90,90,0,0,860,860,850,0,1542,438,144,240,180,13
2020,816000112,72650,2650,2650,2650,0,70000,70000,70000,0,0,0,0,0,0,20000,0,0,0,2091,156,30,180,240,129
2020,816000122,27045,25845,7845,7845,18000,1200,0,0,0,0,1200,1200,0,0,800,800,0,0,2920,180,80,300,240,77
2020,816000132,6300,6300,2300,2300,4000,0,0,0,0,0,0,0,0,0,0,0,0,0,2688,240,60,360,120,258
2020,816000142,23752,23652,652,652,23000,100,0,0,0,0,100,100,0,0,16000,16000,16000,0,1350,120,50,240,60,286
2020,816000152,5980,5380,4880,4880,500,600,0,0,0,0,600,600,0,0,0,0,0,0,1342,432,60,60,120,13
2020,816000162,34200,33000,6500,6500,26500,1200,0,0,0,0,1200,0,1200,0,13000,13000,0,13000,1984,240,50,180,144,810
2020,816000172,15450,15450,2450,2450,13000,0,0,0,0,0,0,0,0,0,0,0,0,0,1112,96,10,120,96,3
2020,816000182,80878,878,878,878,0,80000,80000,80000,0,0,0,0,0,0,0,0,0,0,3204,264,1200,200,180,133
2020,816000192,87320,1140,1140,1140,0,86180,86000,86000,0,0,180,180,0,0,13400,13400,10000,3400,3150,240,200,250,120,210
2020,816000312,424,424,324,324,100,0,0,0,0,0,0,0,0,0,200,200,200,0,1110,316,30,13,192,17
2020,816000332,23120,23120,1120,1120,22000,0,0,0,0,0,0,0,0,0,8600,8600,0,0,1798,222,20,100,206,421
2020,816000342,63256,7256,7256,7256,0,56000,55000,55000,0,0,1000,1000,0,0,19800,19800,15800,4000,4000,370,340,270,180,200
2020,816000352,300,300,300,300,0,0,0,0,0,0,0,0,0,0,0,0,0,0,876,300,20,50,36,1
2020,816000382,17460,12460,7460,6860,5000,5000,0,0,0,0,5000,1000,4000,0,100,100,0,100,3430,600,200,400,400,2233
2020,816000392,34247,3947,3947,3947,0,30300,30000,0,30000,0,300,300,0,0,20000,0,0,0,5610,240,600,460,400,346
2020,816600131,7600,7500,500,500,7000,100,0,0,0,0,100,100,0,0,0,0,0,0,1997,120,30,145,78,35
2020,816600151,123039,3939,3939,3939,0,119100,119000,64000,55000,0,100,100,0,0,35500,15000,0,0,2020,300,70,120,120,229
2020,816600171,43122,42422,20422,20422,22000,700,0,0,0,0,700,0,700,0,0,0,0,0,2830,260,300,120,200,47
2020,816600321,41990,40140,5140,5140,35000,1850,0,0,0,0,1850,1400,450,0,15000,15000,15000,0,3120,250,100,300,50,695
2020,816600331,414220,43320,15320,15320,28000,370900,369000,0,369000,0,1900,1900,0,0,221500,206000,198000,8000,5892,371,145,481,245,282
2020,816600351,119600,113400,86400,86400,27000,6200,0,0,0,0,6200,6200,0,0,90,90,0,0,6800,500,200,300,400,3020
2020,816600391,95000,13000,13000,13000,0,82000,80000,80000,0,0,2000,500,1500,0,0,0,0,0,2587,300,120,360,132,3941
2020,816700111,3330,3330,2330,2330,1000,0,0,0,0,0,0,0,0,0,900,900,0,500,2568,372,10,120,96,45
2020,816700121,25000,2500,2500,2500,0,22500,19500,19500,0,0,3000,3000,0,0,3000,3000,0,3000,4012,320,600,360,120,522
2020,816700161,23530,13180,8180,3180,5000,10350,0,0,0,0,10350,350,0,10000,16218,16218,15000,818,3480,1340,120,360,240,34
2020,816700181,35500,35500,500,500,35000,0,0,0,0,0,0,0,0,0,0,0,0,0,1747,180,240,60,15,74
2020,816700191,104880,1820,1820,1820,0,103060,100000,100000,0,0,3060,2500,560,0,33000,33000,33000,0,4470,300,120,260,150,340
2020,816700301,91964,11764,11764,11764,0,80200,79000,41000,38000,0,1200,200,1000,0,700,0,0,0,3920,360,200,144,216,439
2020,816700311,92439,6239,6239,6239,0,86200,80000,80000,0,0,6200,6200,0,0,30166,30166,28900,1266,7060,500,500,280,130,1759
2020,816700321,23085,85,85,85,0,23000,23000,23000,0,0,0,0,0,0,6000,6000,5000,1000,850,360,10,60,60,27
2020,816700341,34250,32450,5450,5450,27000,1800,0,0,0,0,1800,1800,0,0,7000,7000,0,7000,5070,280,300,400,240,503
2020,816700381,6420,1120,120,120,1000,5300,5000,0,5000,0,300,300,0,0,0,0,0,0,1284,480,48,12,60,37
2020,816700391,85070,25770,25770,25770,0,59300,57000,57000,0,0,2300,300,2000,0,4000,4000,4000,0,1871,480,490,150,96,220
2020,816800161,5040,3540,1540,1540,2000,1500,0,0,0,0,1500,1500,0,0,0,0,0,0,1704,90,10,300,156,153
2020,816800181,18974,3974,3974,3974,0,15000,0,0,0,0,15000,15000,0,0,9200,9200,0,0,4200,240,0,120,240,44
2020,816800191,3030,3030,30,30,3000,0,0,0,0,0,0,0,0,0,0,0,0,0,1351,792,180,10,41,1
2020,816800311,245,245,45,45,200,0,0,0,0,0,0,0,0,0,0,0,0,0,504,120,120,0,12,1
2020,816800321,291880,48880,48880,48880,0,243000,240000,90000,150000,0,3000,3000,0,0,80000,60000,60000,0,12224,600,120,360,360,6855
2020,816800331,77496,1706,1706,1706,0,75790,75620,50000,25620,0,170,170,0,0,0,0,0,0,2489,148,60,570,108,97
2020,816800341,3250,3250,350,350,2900,0,0,0,0,0,0,0,0,0,0,0,0,0,1017,432,66,52,42,1
2020,816800351,3220,2270,270,270,2000,950,0,0,0,0,950,950,0,0,0,0,0,0,4348,1020,30,323,336,55
2020,816800361,53175,1275,1275,1275,0,51900,48000,29000,19000,0,3900,3900,0,0,18360,18360,15800,0,3493,300,200,540,240,125
2020,816800371,200,200,200,200,0,0,0,0,0,0,0,0,0,0,0,0,0,0,700,300,50,20,36,1
2020,816800381,14580,13080,3080,2080,10000,1500,0,0,0,0,1500,0,1500,0,3800,3800,0,3000,5430,400,50,1380,200,214
2020,816900101,19776,19776,7776,7776,12000,0,0,0,0,0,0,0,0,0,0,0,0,0,1462,150,10,168,192,12
2020,816900191,96072,95272,36272,36272,59000,800,0,0,0,0,800,800,0,0,0,0,0,0,3336,420,120,180,96,1719
2020,816900301,15020,12020,6620,4620,5400,3000,2000,0,2000,0,1000,1000,0,0,600,600,0,100,5158,528,100,480,240,115
2020,816900311,3000,3000,300,300,2700,0,0,0,0,0,0,0,0,0,0,0,0,0,1891,180,100,300,168,581
2020,816900331,13477,13477,477,477,13000,0,0,0,0,0,0,0,0,0,10450,10450,0,10450,3168,700,40,120,108,5
2020,816900341,47475,5875,5875,5875,0,41600,40000,40000,0,0,1600,1500,100,0,0,0,0,0,4082,240,50,360,192,299
2020,816900361,129038,11338,11338,11338,0,117700,115000,55000,60000,0,2700,2700,0,0,24500,15500,15000,500,7836,360,700,340,216,2751
2020,816900391,19180,1000,1000,1000,0,18180,15200,15200,0,0,2980,2980,0,0,10867,10867,7900,0,2896,360,45,356,300,439
2020,817000102,8700,7700,4700,2200,3000,1000,0,0,0,0,1000,1000,0,0,2500,2500,0,2500,2280,720,0,240,120,10
2020,817000142,48066,36366,4366,4366,32000,11700,10000,0,10000,0,1700,1700,0,0,15800,12800,12800,0,2230,480,60,360,120,128
2020,817000152,72500,67000,31000,31000,36000,5500,0,0,0,0,5500,2500,3000,0,16500,16500,14000,0,1852,220,15,12,145,95
2020,817000172,10600,600,100,100,500,10000,10000,0,10000,0,0,0,0,0,0,0,0,0,2320,400,150,50,120,321
2020,817000182,5150,5150,1650,1650,3500,0,0,0,0,0,0,0,0,0,0,0,0,0,2254,420,0,120,144,79
2020,817000192,6270,3270,1270,1270,2000,3000,0,0,0,0,3000,3000,0,0,1000,1000,0,0,3318,960,120,672,216,89
2020,817000312,44847,1891,1891,1891,0,42956,42000,42000,0,0,956,956,0,0,52,52,0,0,4697,192,447,360,180,231
2020,817000332,15577,4577,4577,2577,0,11000,10000,5000,5000,0,1000,500,500,0,11000,11000,11000,0,1599,192,12,456,84,32
2020,817000342,33700,400,400,400,0,33300,30500,30500,0,0,2800,2700,100,0,5000,5000,5000,0,1720,180,20,360,120,73
2020,817000352,56604,8234,8234,8234,0,48370,45100,30900,14200,0,3270,3270,0,0,14170,14170,13800,0,4270,360,20,300,240,227
2020,817000372,58800,11800,11800,11800,0,47000,46000,46000,0,0,1000,1000,0,0,8000,8000,8000,0,3562,480,12,12,120,254
2020,817000382,35900,1900,1900,1900,0,34000,28000,20000,8000,0,6000,6000,0,0,4780,4780,2100,0,4610,300,50,300,190,442
2020,817000392,48501,3001,1,1,3000,45500,45000,0,45000,0,500,500,0,0,1376,1376,0,1376,1995,996,150,240,156,165
2020,817600101,40196,40096,9096,9096,31000,100,0,0,0,0,100,100,0,0,13000,13000,13000,0,4210,240,50,390,480,364
2020,817600121,70450,450,450,450,0,70000,70000,70000,0,0,0,0,0,0,15000,0,0,0,779,132,180,50,36,46
2020,817600141,19760,18260,8260,8260,10000,1500,0,0,0,0,1500,1500,0,0,0,0,0,0,880,100,30,120,120,76
2020,817600171,201912,34112,10112,10112,24000,167800,165000,0,165000,0,2800,2800,0,0,40000,0,0,0,3754,360,400,300,144,436
2020,817600181,630,630,330,330,300,0,0,0,0,0,0,0,0,0,0,0,0,0,2100,600,60,180,180,5
2020,817600341,61376,21403,21403,21403,0,39973,37260,24000,13260,0,2713,2600,113,0,10150,6550,5850,700,5874,390,500,480,300,2412
2020,817600351,110380,25110,25110,25110,0,85270,73000,42000,31000,0,12270,12000,270,0,12500,12500,10900,0,6640,400,100,1000,280,1113
2020,817600361,64290,8470,8470,8470,0,55820,55000,15000,40000,0,820,0,820,0,0,0,0,0,1206,500,160,40,36,62
2020,817600371,124150,2150,2150,2150,0,122000,122000,47000,75000,0,0,0,0,0,5200,200,0,0,2880,480,20,180,120,213
2020,817600381,81770,4700,4700,4700,0,77070,74000,74000,0,0,3070,2970,100,0,30400,26900,26900,0,2424,450,400,120,144,198
2020,817600391,20700,17200,12200,8700,5000,3500,0,0,0,0,3500,3500,0,0,1250,1250,0,1000,4456,600,700,600,96,119
2020,817700101,2150,2150,1150,1150,1000,0,0,0,0,0,0,0,0,0,0,0,0,0,2485,660,25,120,120,1
2020,817700121,6624,6130,5630,5630,500,494,0,0,0,0,494,0,494,0,430,430,400,0,1156,288,36,36,84,40
2020,817700151,9176,6176,2676,2676,3500,3000,0,0,0,0,3000,3000,0,0,0,0,0,0,1556,356,50,480,144,79
2020,817700311,26400,25700,25700,25700,0,700,0,0,0,0,700,700,0,0,50,50,0,0,2430,500,30,500,100,239
2020,817700321,10,10,10,10,0,0,0,0,0,0,0,0,0,0,0,0,0,0,1140,240,10,120,120,1
2020,817700331,1129,829,329,329,500,300,0,0,0,0,300,300,0,0,1000,1000,0,0,2660,850,30,200,80,88
2020,817700341,3030,30,30,30,0,3000,3000,3000,0,0,0,0,0,0,0,0,0,0,1391,100,500,120,36,4
2020,817700351,7350,7350,3350,3350,4000,0,0,0,0,0,0,0,0,0,0,0,0,0,1284,150,20,40,150,55
2020,817700361,38425,6925,6925,6925,0,31500,31000,31000,0,0,500,500,0,0,0,0,0,0,3370,216,60,150,276,78
2020,817700371,10650,150,150,150,0,10500,10500,0,10500,0,0,0,0,0,2000,0,0,0,880,300,40,132,48,21
2020,817700381,36000,10700,10700,10700,0,25300,25000,25000,0,0,300,300,0,0,3000,3000,3000,0,5020,500,120,500,400,217
2020,817800101,153500,17000,17000,17000,0,136500,135000,100000,35000,0,1500,1500,0,0,30500,0,0,0,3880,180,200,240,360,232
2020,817800111,30600,30000,3000,3000,27000,600,0,0,0,0,600,600,0,0,16000,16000,0,16000,5270,540,500,150,180,362
2020,817800121,276440,19440,19440,19440,0,257000,250000,250000,0,0,7000,7000,0,0,0,0,0,0,6150,600,50,720,360,3030
2020,817800131,186068,6068,6068,6068,0,180000,180000,180000,0,0,0,0,0,0,0,0,0,0,4950,600,100,250,200,3350
2020,817800141,137272,33272,3272,3272,30000,104000,100000,0,100000,0,4000,4000,0,0,40000,40000,38000,2000,4500,1800,100,300,300,2602
2020,817800171,19790,19790,790,790,19000,0,0,0,0,0,0,0,0,0,12000,12000,12000,0,1386,360,20,100,90,12
2020,817800311,24030,530,530,530,0,23500,23500,23500,0,0,0,0,0,0,19679,19679,19679,0,3600,380,350,250,197,50
2020,817800331,31401,12201,12201,12201,0,19200,18000,18000,0,0,1200,1200,0,0,3600,3600,3500,0,5240,200,200,480,360,288
2020,817800341,16618,5818,5818,5818,0,10800,10000,10000,0,0,800,800,0,0,500,500,500,0,3040,300,90,360,240,130
2020,817800361,44138,3638,3638,3638,0,40500,37000,37000,0,0,3500,3300,200,0,24750,24750,23000,1500,5270,290,180,400,360,747
2020,817800371,65630,500,500,500,0,65130,65000,25000,40000,0,130,0,130,0,0,0,0,0,1530,150,300,120,80,25
2020,817800381,25000,22500,13500,8500,9000,2500,0,0,0,0,2500,500,0,2000,10000,10000,0,10000,2105,96,10,240,156,791
2020,817800391,90232,54732,54732,54432,0,35500,33000,33000,0,0,2500,2500,0,0,0,0,0,0,7266,480,80,60,300,6828
2020,817900101,131870,3860,3860,3860,0,128010,128000,68000,60000,0,10,10,0,0,30240,240,0,0,2392,280,100,50,192,465
2020,817900141,5944,5944,2944,1944,3000,0,0,0,0,0,0,0,0,0,0,0,0,0,600,60,24,24,24,8
2020,817900151,1070,570,70,70,500,500,0,0,0,0,500,500,0,0,0,0,0,0,651,280,20,120,12,1
2020,817900161,13679,13329,329,329,13000,350,0,0,0,0,350,350,0,0,0,0,0,0,1863,655,18,220,75,30
2020,817900171,111000,19000,19000,9000,0,92000,90000,90000,0,0,2000,2000,0,0,9000,9000,9000,0,4080,800,1000,120,60,167
2020,817900181,326500,125000,125000,125000,0,201500,200000,100000,100000,0,1500,1500,0,0,0,0,0,0,1413,240,100,120,84,752
2020,817900191,243000,43000,5000,5000,38000,200000,200000,0,200000,0,0,0,0,0,90000,0,0,0,3038,328,15,35,96,909
2020,817900311,12319,2819,2819,2819,0,9500,9500,9500,0,0,0,0,0,0,0,0,0,0,500,95,50,20,20,7
2020,817900321,2001,1961,161,161,1800,40,0,0,0,0,40,40,0,0,0,0,0,0,1318,300,72,96,42,13
2020,817900331,163320,27920,27920,27920,0,135400,135000,35000,100000,0,400,400,0,0,56000,0,0,0,2450,480,100,150,240,493
2020,817900341,61630,13130,13130,12130,0,48500,48000,42000,6000,0,500,200,300,0,0,0,0,0,4390,420,400,450,130,1013
2020,817900361,60080,33580,33580,33580,0,26500,23000,23000,0,0,3500,3500,0,0,0,0,0,0,3760,420,50,360,120,1261
2020,818000132,8605,8605,3605,3605,5000,0,0,0,0,0,0,0,0,0,5000,5000,5000,0,1323,165,120,300,198,12
2020,818000162,31200,31200,2700,2700,28500,0,0,0,0,0,0,0,0,0,0,0,0,0,2585,600,600,200,120,25
2020,818000192,95200,9900,9900,9900,0,85300,85000,85000,0,0,300,300,0,0,0,0,0,0,4385,2807,150,360,156,209
2020,818000302,3896,3096,1096,1096,2000,800,0,0,0,0,800,800,0,0,700,700,0,700,1540,380,150,60,60,2
2020,818000312,18506,976,976,976,0,17530,16500,16500,0,0,1030,1030,0,0,13810,13810,11760,1800,2436,240,36,800,300,213
2020,818000322,88440,6490,6490,6490,0,81950,69000,16000,53000,0,12950,2950,10000,0,14700,14700,12900,1500,2890,300,300,600,120,112
2020,818600101,212800,5000,5000,5000,0,207800,200000,200000,0,0,7800,7800,0,0,0,0,0,0,5500,600,800,500,300,2595
2020,818600111,1146540,99840,59840,59840,40000,1046700,1045000,0,1045000,0,1700,1700,0,0,415400,130000,130000,0,11340,600,800,500,240,4808
2020,818600131,382604,73884,73884,33884,0,308720,303000,270000,33000,0,5720,2420,3300,0,0,0,0,0,11820,600,120,360,420,4971
2020,818600141,43850,13600,3600,3600,10000,30250,30000,0,0,30000,250,250,0,0,12300,12300,12300,0,7500,720,360,360,360,1047
2020,818600181,172020,220,220,220,0,171800,170000,170000,0,0,1800,1800,0,0,0,0,0,0,2310,200,10,200,120,284
2020,818600191,176800,15200,15200,15200,0,161600,160000,160000,0,0,1600,1600,0,0,0,0,0,0,4694,360,20,240,156,1440
2020,818600301,10,10,10,10,0,0,0,0,0,0,0,0,0,0,0,0,0,0,858,156,2,72,48,1
2020,818600311,21620,20,20,20,0,21600,21600,9600,12000,0,0,0,0,0,0,0,0,0,1132,120,84,60,48,17
2020,818600331,35937,3037,3037,3037,0,32900,31000,19000,12000,0,1900,1900,0,0,10036,10036,9536,500,5465,240,740,407,240,372
2020,818600341,15922,8622,8622,8622,0,7300,7000,7000,0,0,300,300,0,0,2050,2050,2000,0,1750,250,30,130,210,18
2020,818700111,922000,667000,620000,620000,47000,255000,250000,0,250000,0,5000,0,5000,0,0,0,0,0,6060,3600,360,360,60,2312
2020,818700121,250,150,150,150,0,100,0,0,0,0,100,0,100,0,0,0,0,0,3690,0,120,120,180,1
2020,818700131,175125,129025,40025,40025,89000,46100,45000,0,45000,0,1100,1000,100,0,10000,0,0,0,6360,1600,200,260,150,200
2020,818700141,100100,100,100,100,0,100000,100000,100000,0,0,0,0,0,0,0,0,0,0,1370,284,100,80,26,108
2020,818700181,83344,2344,2344,2344,0,81000,80000,80000,0,0,1000,1000,0,0,0,0,0,0,2740,360,100,180,180,117
2020,818700191,2550,2550,50,50,2500,0,0,0,0,0,0,0,0,0,0,0,0,0,960,55,120,60,24,1
2020,818700301,21690,2690,2690,2690,0,19000,19000,19000,0,0,0,0,0,0,7262,7262,7262,0,646,194,46,10,16,27
2020,818700311,44100,20100,20100,5100,0,24000,22000,22000,0,0,2000,2000,0,0,11308,11308,11308,0,5794,270,200,1200,144,352
2020,818700321,47859,7120,7120,7120,0,40739,40000,30000,10000,0,739,400,339,0,17000,17000,16000,1000,4876,516,120,520,360,152
2020,818700331,114100,3400,3400,3400,0,110700,105000,30000,70000,5000,5700,5700,0,0,0,0,0,0,4800,920,600,700,180,221
2020,818700391,25100,24600,24600,24600,0,500,0,0,0,0,500,500,0,0,0,0,0,0,1300,50,200,200,250,227
2020,818800141,20870,20020,1020,1020,19000,850,0,0,0,0,850,850,0,0,200,200,200,0,3142,150,100,160,400,11
2020,818800161,32694,32694,2694,2694,30000,0,0,0,0,0,0,0,0,0,23000,23000,20000,3000,4440,700,150,140,150,171
2020,818800171,2980,2980,2480,2480,500,0,0,0,0,0,0,0,0,0,0,0,0,0,2400,816,200,24,180,23
2020,818800181,43000,20000,3000,3000,17000,23000,23000,0,13000,10000,0,0,0,0,23000,12000,12000,0,2127,445,2,180,180,161
2020,818800301,29450,3800,3800,3800,0,25650,25000,25000,0,0,650,650,0,0,0,0,0,0,1090,200,30,100,20,108
2020,818800321,69750,3100,3100,3100,0,66650,65000,15000,50000,0,1650,150,1500,0,0,0,0,0,2150,200,700,300,90,186
2020,818900101,350800,150000,150000,150000,0,200800,200000,200000,0,0,800,800,0,0,12000,12000,12000,0,2772,540,180,300,42,1281
2020,818900111,7040,6140,140,140,6000,900,0,0,0,0,900,900,0,0,9268,9268,5700,2468,5856,888,600,960,360,59
2020,818900121,130,130,10,10,120,0,0,0,0,0,0,0,0,0,0,0,0,0,378,48,20,0,30,1
2020,818900131,5750,5750,4950,4950,800,0,0,0,0,0,0,0,0,0,75,75,0,0,639,72,0,48,18,1
2020,818900171,9610,9610,10,10,9600,0,0,0,0,0,0,0,0,0,0,0,0,0,549,189,24,30,36,1
2020,818900301,51700,100,100,100,0,51600,51600,6600,45000,0,0,0,0,0,0,0,0,0,600,120,50,20,20,34
2020,818900311,15759,12959,7959,6959,5000,2800,0,0,0,0,2800,2800,0,0,170,170,0,0,2130,200,10,50,160,89
2020,819000102,97850,17600,17600,17600,0,80250,80000,80000,0,0,250,250,0,0,100,100,0,0,3714,360,180,240,120,186
2020,819000132,200350,350,350,350,0,200000,200000,200000,0,0,0,0,0,0,0,0,0,0,1210,204,60,15,72,664
2020,819000142,60500,400,400,400,0,60100,60000,42000,18000,0,100,0,100,0,20000,20000,20000,0,2280,100,600,10,20,93
2020,819000152,38810,37410,3410,3410,34000,1400,0,0,0,0,1400,1400,0,0,18000,18000,18000,0,4332,120,60,240,240,836
2020,819000172,114780,21980,21980,20980,0,92800,90000,70000,20000,0,2800,1500,0,1300,3000,0,0,0,5893,70,2260,300,48,71
2020,819000182,5120,5120,120,120,5000,0,0,0,0,0,0,0,0,0,0,0,0,0,964,144,40,100,180,45
2020,819000192,157238,10838,10838,10838,0,146400,145000,60000,85000,0,1400,1400,0,0,60000,0,0,0,5015,310,120,540,360,681
2020,819600191,26840,24540,3540,3540,21000,2300,0,0,0,0,2300,2300,0,0,13200,13200,12000,0,3268,420,20,370,168,216
2020,819700131,28000,27500,5000,5000,22500,500,0,0,0,0,500,500,0,0,10000,10000,0,10000,1940,120,360,180,120,184
2020,819800101,154713,22513,22513,22513,0,132200,132000,120000,12000,0,200,200,0,0,31760,30760,22760,8000,6170,650,110,220,220,524
2020,819800121,26374,25648,3648,3648,22000,726,0,0,0,0,726,500,226,0,10037,10037,10000,0,2246,156,100,200,120,35
2020,819800131,3994,2494,1494,1494,1000,1500,0,0,0,0,1500,1500,0,0,50,50,0,50,1651,720,30,140,108,15
2020,819800151,25265,25065,5065,5065,20000,200,0,0,0,0,200,200,0,0,16000,16000,0,16000,3294,294,100,350,300,480
2020,819800181,17005,14605,605,605,14000,2400,0,0,0,0,2400,2400,0,0,22000,22000,7000,0,1816,240,250,360,240,53
2020,819900121,282800,172000,115000,115000,57000,110800,110000,0,110000,0,800,800,0,0,0,0,0,0,7800,456,10,720,120,1543
2020,819900131,8470,8470,5470,5470,3000,0,0,0,0,0,0,0,0,0,0,0,0,0,1905,720,3,120,72,39
2020,819900151,220,220,220,220,0,0,0,0,0,0,0,0,0,0,0,0,0,0,3700,820,300,360,300,128
2020,819900161,15530,13580,4580,1580,9000,1950,0,0,0,0,1950,300,1650,0,0,0,0,0,1286,180,120,156,108,40
2020,819900171,207940,54840,6840,6840,48000,153100,150000,0,150000,0,3100,3100,0,0,43200,1200,0,1200,8380,650,400,450,400,865
2020,820000202,27470,6470,6470,6470,0,21000,21000,15000,6000,0,0,0,0,0,0,0,0,0,1810,200,240,30,24,63
2020,820000212,25,25,25,25,0,0,0,0,0,0,0,0,0,0,0,0,0,0,529,80,60,10,2,0
2020,820000242,37300,4800,4800,1000,0,32500,26000,26000,0,0,6500,0,6500,0,22670,22670,22300,0,3996,240,5,151,240,101
2020,820000272,95200,7600,7600,7600,0,87600,86000,86000,0,0,1600,1600,0,0,5800,0,0,0,2760,1800,150,110,120,109
2020,820000292,40483,4053,4053,4053,0,36430,32000,32000,0,0,4430,4350,80,0,10490,10490,10360,0,1287,150,15,50,192,134
2020,820000302,2431,2431,31,31,2400,0,0,0,0,0,0,0,0,0,0,0,0,0,902,396,12,24,72,1
2020,820000312,21023,1533,1533,1533,0,19490,18000,18000,0,0,1490,1050,440,0,12100,12100,10100,2000,4942,294,120,1200,300,84
2020,820000322,67063,12063,12063,9063,0,55000,53500,29000,24500,0,1500,1500,0,0,16050,16050,16000,0,3306,240,60,240,252,465
2020,820000332,32120,7110,7110,5110,0,25010,22000,17000,5000,0,3010,3010,0,0,10950,10950,10900,0,3276,1416,50,365,204,337
2020,820000342,64178,28300,28300,28300,0,35878,33000,33000,0,0,2878,2200,678,0,0,0,0,0,6530,240,100,360,180,245
2020,820000352,31800,1500,1500,1500,0,30300,30000,10000,20000,0,300,0,300,0,0,0,0,0,480,120,40,50,20,22
2020,820000362,15530,2450,2450,2450,0,13080,12000,12000,0,0,1080,1080,0,0,7700,7700,700,7000,4667,300,50,450,288,66
2020,820000372,5385,5385,385,385,5000,0,0,0,0,0,0,0,0,0,4000,4000,4000,0,957,156,20,5,156,9
2020,820600211,3268,268,68,68,200,3000,0,0,0,0,3000,3000,0,0,500,500,0,0,2335,472,122,481,121,118
2020,820600221,14472,5012,4012,2012,1000,9460,0,0,0,0,9460,2400,7060,0,9330,9330,0,6500,2950,480,100,360,360,14
2020,820600231,10,10,10,10,0,0,0,0,0,0,0,0,0,0,0,0,0,0,1010,300,60,10,30,1
2020,820600261,55080,21330,21330,21330,0,33750,32000,32000,0,0,1750,1400,350,0,0,0,0,0,4401,280,70,120,150,846
2020,820600291,33514,6494,6494,6494,0,27020,25000,25000,0,0,2020,1000,520,500,185,185,0,0,2640,500,300,270,170,42
2020,820600311,145240,16040,16040,16040,0,129200,127000,43000,80000,4000,2200,2200,0,0,105000,45000,29000,16000,3662,300,24,300,108,1564
2020,820600331,44258,43558,31558,31558,12000,700,0,0,0,0,700,700,0,0,0,0,0,0,1095,235,10,75,140,119
2020,820600351,3059,3059,3059,3059,0,0,0,0,0,0,0,0,0,0,0,0,0,0,1372,270,500,30,12,43
2020,820600371,44324,7964,7964,7964,0,36360,34500,10000,24500,0,1860,1600,260,0,2400,2400,1200,1200,1590,300,200,400,70,149
2020,820600381,37887,12287,12287,12287,0,25600,18000,18000,0,0,7600,5100,0,2500,4600,4600,4500,0,2365,259,10,128,252,58
2020,820600391,17100,100,100,100,0,17000,17000,17000,0,0,0,0,0,0,7560,7560,7560,0,770,180,100,24,36,23
2020,820700211,9065,8990,6290,6290,2700,75,0,0,0,0,75,0,75,0,100,100,0,0,730,160,30,30,80,1
2020,820700221,38185,2185,2185,2185,0,36000,36000,25000,11000,0,0,0,0,0,0,0,0,0,2530,400,200,100,60,586
2020,820700231,86150,900,900,900,0,85250,85000,22000,63000,0,250,250,0,0,0,0,0,0,3515,215,130,360,80,78
2020,820700241,5850,2050,1050,1050,1000,3800,1500,0,1500,0,2300,2300,0,0,3070,3070,0,2000,1544,516,80,190,72,78
2020,820700251,15060,15060,60,60,15000,0,0,0,0,0,0,0,0,0,0,0,0,0,1660,216,600,48,36,15
2020,820700261,64080,2000,2000,2000,0,62080,58000,58000,0,0,4080,3900,180,0,26700,25700,0,0,2940,240,200,220,120,424
2020,820700281,41346,14546,14546,14546,0,26800,24000,24000,0,0,2800,1800,1000,0,100,100,0,0,2646,480,10,150,36,448
2020,820700291,14700,700,700,700,0,14000,14000,14000,0,0,0,0,0,0,0,0,0,0,955,130,150,14,24,13
2020,820700301,51446,1640,1640,1640,0,49806,47300,9300,38000,0,2506,0,2506,0,0,0,0,0,1181,156,300,120,18,81
2020,820700341,40436,6686,6686,6686,0,33750,31800,31800,0,0,1950,1950,0,0,0,0,0,0,4556,360,120,600,240,392
2020,820700361,20570,10740,7740,7740,3000,9830,7000,0,7000,0,2830,2830,0,0,1100,1100,1100,0,1294,203,50,100,156,82
2020,820800201,19500,2000,2000,2000,0,17500,17500,17500,0,0,0,0,0,0,0,0,0,0,3786,120,2500,72,19,20
2020,820800211,820,820,320,320,500,0,0,0,0,0,0,0,0,0,160,160,0,160,4678,840,370,240,288,278
2020,820800231,28346,5346,5346,5346,0,23000,22500,22500,0,0,500,0,500,0,13900,13900,11300,2000,5110,430,60,300,420,21
2020,820800241,6938,6808,3308,3308,3500,130,0,0,0,0,130,0,130,0,250,250,0,0,2376,120,1050,106,100,1
2020,820800251,6326,6216,2216,2216,4000,110,0,0,0,0,110,0,110,0,20,20,0,0,537,108,10,48,36,26
2020,820800281,30410,220,220,220,0,30190,30000,30000,0,0,190,0,190,0,1500,0,0,0,982,200,60,70,72,25
2020,820800291,22806,2306,2306,2306,0,20500,19000,19000,0,0,1500,1500,0,0,10000,10000,10000,0,3008,288,30,360,360,76
2020,820800301,18749,6069,6069,6069,0,12680,12000,8000,4000,0,680,650,30,0,0,0,0,0,2537,216,120,300,240,112
2020,820800321,20618,3268,3268,3268,0,17350,15000,15000,0,0,2350,2300,50,0,5500,5500,5500,0,2248,284,50,360,240,172
2020,820800331,8315,1115,1115,1115,0,7200,7000,7000,0,0,200,200,0,0,3920,3920,3800,0,3105,460,370,200,240,55
2020,820800341,28128,19128,19128,19128,0,9000,7500,7500,0,0,1500,1500,0,0,0,0,0,0,2386,306,60,360,240,54
2020,820800351,137720,30920,30920,30920,0,106800,104000,24000,80000,0,2800,1800,1000,0,19000,19000,17000,2000,3420,240,200,240,240,2111
2020,820800361,36960,7560,7560,7560,0,29400,28500,25000,0,3500,900,800,100,0,5000,5000,0,5000,2484,360,120,150,150,132
2020,820800371,116239,10338,10338,10338,0,105901,105000,70000,35000,0,901,901,0,0,14600,0,0,0,1767,750,174,60,36,465
2020,820800381,57110,19210,19210,16710,0,37900,37000,22000,15000,0,900,900,0,0,1760,1760,1760,0,4366,356,120,600,240,933
2020,820800391,95730,6680,6680,6680,0,89050,87500,15000,68000,4500,1550,200,1350,0,17000,0,0,0,1736,98,400,300,120,99
2020,820900201,507,507,7,7,500,0,0,0,0,0,0,0,0,0,1600,1600,0,0,1144,156,20,50,180,0
2020,820900211,30344,18044,5044,5044,13000,12300,10000,0,10000,0,2300,1300,1000,0,13000,13000,13000,0,2600,300,100,500,100,100
2020,820900221,14220,830,830,830,0,13390,12000,12000,0,0,1390,1390,0,0,400,400,0,400,3546,130,36,240,300,50
2020,820900231,900,900,500,500,400,0,0,0,0,0,0,0,0,0,0,0,0,0,1060,240,20,20,120,0
2020,820900251,2150,550,450,450,100,1600,0,0,0,0,1600,1600,0,0,500,500,0,500,1770,300,200,150,70,16
2020,820900261,12500,500,500,500,0,12000,12000,12000,0,0,0,0,0,0,50,0,0,0,912,220,200,12,20,11
2020,820900271,12296,2296,2296,2296,0,10000,10000,10000,0,0,0,0,0,0,180,150,0,0,1365,280,130,20,15,13
2020,820900281,20830,6080,6080,6080,0,14750,11000,11000,0,0,3750,3600,150,0,1650,1650,0,1500,2030,120,0,400,360,229
2020,820900301,26968,18968,6968,2968,12000,8000,0,0,0,0,8000,0,0,8000,12000,12000,12000,0,2344,360,40,60,84,119
2020,820900321,185916,147464,147464,147464,0,38452,35000,25000,10000,0,3452,3000,452,0,1000,0,0,0,3680,360,200,350,240,640
2020,820900341,23358,1978,1978,1978,0,21380,21000,21000,0,0,380,380,0,0,11020,11020,10520,0,1510,168,10,380,252,90
2020,820900361,89460,9260,9260,9260,0,80200,80000,30000,50000,0,200,200,0,0,21000,20000,20000,0,1560,120,120,250,60,406
2020,820900381,800,800,800,800,0,0,0,0,0,0,0,0,0,0,0,0,0,0,1110,324,270,60,60,19
2020,820900391,29505,755,755,755,0,28750,28000,24000,4000,0,750,750,0,0,17198,17198,17150,0,3765,924,50,140,336,60
2020,821000212,21350,3350,3350,3350,0,18000,16000,0,16000,0,2000,2000,0,0,8000,8000,8000,0,1650,300,200,120,180,75
2020,821000222,10,10,10,10,0,0,0,0,0,0,0,0,0,0,0,0,0,0,613,360,5,36,24,1
2020,821000242,19220,16650,3150,3150,13500,2570,2500,0,2500,0,70,70,0,0,5500,5500,0,0,1163,180,50,110,90,14
2020,821000252,5290,5290,2290,2290,3000,0,0,0,0,0,0,0,0,0,0,0,0,0,1046,136,10,240,240,98
2020,821000262,4318,4018,3718,3718,300,300,0,0,0,0,300,0,300,0,70,70,0,0,1490,450,20,120,180,37
2020,821000272,54280,200,200,200,0,54080,54000,22000,32000,0,80,50,30,0,1000,0,0,0,1615,216,500,54,20,60
2020,821000292,18300,200,200,200,0,18100,16000,16000,0,0,2100,2100,0,0,1100,1100,1000,0,3500,250,100,1000,200,30
2020,821000302,26357,5757,5757,5757,0,20600,17000,17000,0,0,3600,3300,300,0,12000,12000,12000,0,4140,300,800,420,120,112
2020,821000312,27074,5122,5122,5122,0,21952,18000,18000,0,0,3952,3500,452,0,9632,9632,4732,4900,3860,500,30,700,180,184
2020,821000322,17935,2237,2237,2237,0,15698,6000,1000,5000,0,9698,0,9698,0,7000,7000,0,0,1376,234,126,60,96,3
2020,821000332,3451,3451,1351,1351,2100,0,0,0,0,0,0,0,0,0,0,0,0,0,1048,300,60,36,72,1
2020,821000362,5090,90,90,90,0,5000,5000,5000,0,0,0,0,0,0,0,0,0,0,587,125,147,12,20,7
2020,821000372,521,521,21,21,500,0,0,0,0,0,0,0,0,0,0,0,0,0,1140,460,20,60,50,1
2020,821000382,14450,1450,1450,1450,0,13000,13000,13000,0,0,0,0,0,0,550,50,0,0,1986,210,480,60,120,46
2020,821000392,31300,1300,1300,300,0,30000,30000,30000,0,0,0,0,0,0,200,0,0,0,1306,210,180,20,36,130
2020,821600211,73700,350,350,350,0,73350,73000,73000,0,0,350,0,350,0,0,0,0,0,1477,480,50,75,72,80
2020,821600221,35501,2701,2701,2701,0,32800,32000,32000,0,0,800,800,0,0,4000,4000,4000,0,4214,228,360,300,360,222
2020,821600231,70,16,16,16,0,54,0,0,0,0,54,0,54,0,0,0,0,0,600,122,36,14,20,1
2020,821600241,9518,1018,1018,1018,0,8500,8500,8500,0,0,0,0,0,0,0,0,0,0,600,156,70,12,36,8
2020,821600261,7054,6934,1434,1434,5500,120,0,0,0,0,120,0,120,0,0,0,0,0,1628,120,30,150,108,1
2020,821600271,38454,954,954,954,0,37500,32000,32000,0,0,5500,2000,0,3500,12100,10100,10000,100,2472,300,360,380,132,34
2020,821600301,37084,32854,12854,12854,20000,4230,0,0,0,0,4230,550,3680,0,16000,16000,16000,0,4270,360,150,360,300,92
2020,821600311,250,250,20,20,230,0,0,0,0,0,0,0,0,0,0,0,0,0,596,150,0,10,36,1
2020,821600321,161920,30420,30420,30420,0,131500,130000,24000,106000,0,1500,1200,300,0,55750,52000,52000,0,5356,266,60,560,170,340
2020,821600331,54934,30704,30704,30704,0,24230,22000,15000,7000,0,2230,1600,630,0,0,0,0,0,2393,123,100,400,210,496
2020,821600391,40467,31267,31267,31267,0,9200,5000,5000,0,0,4200,4200,0,0,0,0,0,0,7340,240,100,500,300,569
2020,821700201,505,505,505,505,0,0,0,0,0,0,0,0,0,0,0,0,0,0,621,240,18,40,35,0
2020,821700211,3502,3502,1702,1702,1800,0,0,0,0,0,0,0,0,0,100,100,0,100,395,35,20,20,20,1
2020,821700241,103048,19400,19400,19400,0,83648,83000,83000,0,0,648,150,498,0,0,0,0,0,3180,250,280,200,250,968
2020,821700251,84590,38080,38080,33080,0,46510,45500,17000,28500,0,1010,1010,0,0,2000,0,0,0,2549,250,600,200,72,147
2020,821700261,24280,1580,1580,1580,0,22700,20000,20000,0,0,2700,2700,0,0,0,0,0,0,1178,162,30,158,60,61
2020,821700271,27410,2410,2410,2410,0,25000,20000,10000,10000,0,5000,4700,300,0,4141,4141,2311,300,2736,420,240,516,260,808
2020,821700291,22870,3130,3130,3130,0,19740,19500,19500,0,0,240,100,140,0,700,0,0,0,2154,300,120,200,180,141
2020,821700301,26717,4467,4467,4467,0,22250,22000,22000,0,0,250,250,0,0,15000,15000,15000,0,2463,288,35,450,240,364
2020,821700311,13196,9146,4146,2646,5000,4050,0,0,0,0,4050,1050,1000,2000,300,300,0,0,2791,456,580,420,165,98
2020,821700321,3050,20,20,20,0,3030,3000,3000,0,0,30,0,30,0,0,0,0,0,1275,138,360,264,43,3
2020,821700341,20573,5947,5947,5947,0,14626,10900,6500,4400,0,3726,3500,226,0,3056,3056,1200,0,3286,184,50,530,240,66
2020,821700351,23600,11100,11100,11100,0,12500,12500,6500,6000,0,0,0,0,0,0,0,0,0,942,150,80,30,50,26
2020,821700361,200,200,200,200,0,0,0,0,0,0,0,0,0,0,0,0,0,0,609,105,36,12,36,2
2020,821700371,17810,3810,3810,3810,0,14000,14000,10000,4000,0,0,0,0,0,30,30,0,0,1670,300,150,80,60,66
2020,821700381,39129,30593,30593,30593,0,8536,8000,8000,0,0,536,400,136,0,0,0,0,0,3770,260,130,270,180,551
2020,821700391,30134,17834,17834,17834,0,12300,9000,9000,0,0,3300,3300,0,0,3680,3680,1200,0,760,100,100,100,80,35
2020,821800201,10128,2168,2168,2168,0,7960,7710,7710,0,0,250,0,250,0,95,95,0,0,783,82,168,22,86,6
2020,821800211,18825,16190,2690,2690,13500,2635,0,0,0,0,2635,2500,135,0,11500,11500,10000,1500,1890,200,50,300,120,81
2020,821800241,5300,5300,300,300,5000,0,0,0,0,0,0,0,0,0,2801,2801,0,400,2186,856,10,60,180,516
2020,821800251,28656,3800,3800,3800,0,24856,24000,20000,4000,0,856,630,226,0,3632,3632,1532,2100,1760,200,60,300,120,24
2020,821800261,31197,31129,4629,4629,26500,68,0,0,0,0,68,0,68,0,3525,3525,0,500,3710,360,50,360,240,10
2020,821800281,17338,2038,2038,2038,0,15300,15000,10000,5000,0,300,0,300,0,0,0,0,0,1900,130,180,50,100,16
2020,821800291,92520,15100,15100,15100,0,77420,75000,75000,0,0,2420,2200,220,0,16440,16440,16200,0,2780,600,200,300,120,608
2020,821800301,60815,3415,3415,3415,0,57400,45600,2000,43600,0,11800,1500,10300,0,10000,10000,5000,5000,2558,230,650,392,264,43
2020,821800311,13570,2920,2920,2920,0,10650,10400,8000,2400,0,250,250,0,0,0,0,0,0,1586,276,300,280,90,34
2020,821800321,88653,33803,33803,20803,0,54850,35000,20000,15000,0,19850,4000,5850,10000,11200,11200,6000,5000,6130,2100,240,720,360,341
2020,821800331,26565,19665,3765,3765,15900,6900,0,0,0,0,6900,6900,0,0,13900,13900,12200,0,4704,216,10,768,480,29
2020,821800341,16346,2596,2596,2596,0,13750,12600,0,12600,0,1150,900,250,0,2000,2000,2000,0,1790,192,146,300,162,58
2020,821800361,1172,1172,1172,1172,0,0,0,0,0,0,0,0,0,0,0,0,0,0,860,60,230,10,20,3
2020,821800371,300,300,100,100,200,0,0,0,0,0,0,0,0,0,0,0,0,0,748,224,12,12,15,1
2020,821800381,12834,11834,3834,3834,8000,1000,0,0,0,0,1000,1000,0,0,150,150,0,0,1880,150,50,240,180,268
2020,821800391,9166,5666,5666,5166,0,3500,0,0,0,0,3500,3000,0,500,3000,3000,3000,0,3310,600,100,300,130,82
2020,821900201,17680,4080,4080,4080,0,13600,12500,11500,1000,0,1100,600,500,0,0,0,0,0,2151,180,57,375,144,95
2020,821900211,175470,9670,9670,9670,0,165800,158000,80000,78000,0,7800,3600,4200,0,24699,19099,19000,0,5004,600,120,540,300,2558
2020,821900241,400,400,100,100,300,0,0,0,0,0,0,0,0,0,0,0,0,0,1390,450,5,100,50,21
2020,821900251,184480,68280,68280,68280,0,116200,115000,115000,0,0,1200,1000,200,0,50,50,0,0,6080,480,400,500,300,1890
2020,821900261,64445,15013,15013,15013,0,49432,38000,38000,0,0,11432,1332,10100,0,32500,32500,32500,0,2345,200,20,240,140,163
2020,821900291,18250,250,250,250,0,18000,17800,17800,0,0,200,0,200,0,0,0,0,0,1710,70,400,360,30,14
2020,821900311,12740,1734,1734,1734,0,11006,7000,7000,0,0,4006,3780,226,0,1500,1500,0,0,2424,180,620,300,144,150
2020,821900331,28431,9681,9681,8681,0,18750,15000,6000,9000,0,3750,2820,930,0,8000,8000,7000,0,2132,156,72,336,312,61
2020,821900341,16810,1510,1510,1510,0,15300,15000,15000,0,0,300,300,0,0,0,0,0,0,2440,220,60,180,100,16
2020,821900351,14040,140,140,140,0,13900,13000,7000,6000,0,900,900,0,0,8232,3232,3200,0,4740,260,100,150,130,102
2020,821900361,5015,15,15,15,0,5000,0,0,0,0,5000,0,5000,0,2500,2500,2500,0,1760,200,300,100,30,1
2020,821900371,27645,19932,19932,19932,0,7713,4000,4000,0,0,3713,3600,113,0,8000,8000,8000,0,5960,350,400,480,480,185
2020,821900381,5944,2444,2444,2444,0,3500,3500,3500,0,0,0,0,0,0,700,700,700,0,643,70,30,10,43,4
2020,821900391,23900,3900,3900,3900,0,20000,20000,7000,13000,0,0,0,0,0,0,0,0,0,835,95,350,30,20,11
2020,822000222,104191,2250,2250,2250,0,101941,80000,50000,30000,0,21941,4441,17500,0,44800,44800,19800,10000,5440,360,100,300,180,1933
2020,822000232,41613,25557,5557,3557,20000,16056,4900,0,4900,0,11156,3767,7389,0,5000,5000,0,5000,3536,296,65,610,240,308
2020,822000242,28986,86,86,86,0,28900,27000,27000,0,0,1900,1900,0,0,7000,7000,7000,0,4640,300,30,1200,130,299
2020,822000262,430,430,30,30,400,0,0,0,0,0,0,0,0,0,0,0,0,0,926,204,6,10,29,1
2020,822000272,2140,2140,1860,1860,280,0,0,0,0,0,0,0,0,0,0,0,0,0,813,96,12,50,60,4
2020,822000282,28000,12500,12500,12500,0,15500,13000,13000,0,0,2500,2500,0,0,0,0,0,0,4585,360,1120,970,320,338
2020,822000292,16836,3336,3336,3336,0,13500,13000,13000,0,0,500,500,0,0,0,0,0,0,2311,180,120,36,72,50
2020,822000302,8010,2010,2010,2010,0,6000,6000,6000,0,0,0,0,0,0,0,0,0,0,399,70,40,30,24,3
2020,822000312,84480,2330,2330,1330,0,82150,80700,35000,45700,0,1450,450,1000,0,4800,4800,3500,1300,3674,224,300,600,400,41
2020,822000342,46302,8752,8752,8752,0,37550,37000,7000,30000,0,550,550,0,0,0,0,0,0,796,120,48,240,108,307
2020,822000352,19700,580,580,580,0,19120,18780,7500,11280,0,340,340,0,0,0,0,0,0,2181,160,90,216,170,101
2020,822600211,23540,190,190,190,0,23350,23000,23000,0,0,350,280,70,0,16126,16126,14276,1832,1610,130,60,240,144,41
2020,822600251,25120,120,120,120,0,25000,25000,25000,0,0,0,0,0,0,9000,4500,4500,0,1955,1000,300,50,40,9
2020,822600261,14620,14500,14500,14500,0,120,0,0,0,0,120,0,120,0,0,0,0,0,3226,420,1300,36,80,205
2020,822600281,48400,8500,8500,6900,0,39900,39000,29000,10000,0,900,400,500,0,20760,20760,18500,200,2010,360,120,240,200,151
2020,822600301,2747,747,747,747,0,2000,2000,2000,0,0,0,0,0,0,0,0,0,0,1290,160,180,120,90,3
2020,822600311,4100,4100,100,100,4000,0,0,0,0,0,0,0,0,0,0,0,0,0,351,59,48,10,14,1
2020,822600321,2130,2130,2130,2130,0,0,0,0,0,0,0,0,0,0,0,0,0,0,459,103,36,4,25,8
2020,822600331,17486,1233,1233,1233,0,16253,16000,9000,7000,0,253,40,213,0,0,0,0,0,1140,112,400,120,38,22
2020,822600341,9354,2354,2354,2354,0,7000,7000,2000,5000,0,0,0,0,0,200,200,200,0,741,150,24,60,36,2
2020,822600351,34640,640,640,640,0,34000,32500,2500,30000,0,1500,1500,0,0,500,500,500,0,1030,120,240,180,60,95
2020,822700231,376400,8900,8900,8900,0,367500,350000,150000,200000,0,17500,5000,12500,0,163620,147120,142000,5000,4900,1000,300,400,200,2245
2020,822700351,7037,37,37,37,0,7000,7000,7000,0,0,0,0,0,0,1284,1284,900,0,1084,143,60,50,46,5
2020,822800261,40460,1160,1160,1160,0,39300,38000,38000,0,0,1300,1300,0,0,17406,17406,12156,5000,4900,250,80,300,120,1318
2020,822800271,420,420,200,200,220,0,0,0,0,0,0,0,0,0,0,0,0,0,822,108,42,100,12,0
2020,822800281,62606,3006,3006,3006,0,59600,59000,29000,30000,0,600,600,0,0,2000,0,0,0,1540,240,130,200,60,99
2020,822800301,36128,9800,9800,7800,0,26328,26000,11000,15000,0,328,260,68,0,2000,2000,0,2000,2650,300,60,600,300,215
2020,822800321,5686,2780,2780,2780,0,2906,2500,2500,0,0,406,180,226,0,0,0,0,0,1755,700,100,480,50,17
2020,822800341,20091,6461,6461,6461,0,13630,12000,12000,0,0,1630,1405,225,0,120,120,0,0,2760,360,50,100,300,32
2020,822800351,161350,350,350,350,0,161000,160000,20000,140000,0,1000,0,1000,0,60700,60700,60700,0,1909,277,420,30,100,151
2020,822900201,2450,1700,700,700,1000,750,0,0,0,0,750,750,0,0,0,0,0,0,1978,640,12,120,156,21
2020,822900211,65341,7541,7541,7541,0,57800,55000,55000,0,0,2800,2800,0,0,13500,13500,13500,0,5390,360,120,400,200,1122
2020,822900221,9678,9228,6228,6228,3000,450,0,0,0,0,450,450,0,0,150,150,0,150,2850,300,100,480,240,86
2020,822900231,3475,3040,2740,2740,300,435,0,0,0,0,435,400,35,0,0,0,0,0,1336,480,10,120,36,31
2020,822900251,1020,480,180,180,300,540,0,0,0,0,540,540,0,0,0,0,0,0,2948,500,240,180,144,17
2020,822900261,6160,6040,6040,6040,0,120,0,0,0,0,120,0,120,0,20,20,0,0,820,150,200,40,30,2
2020,822900271,34026,4926,4926,4926,0,29100,28000,28000,0,0,1100,1000,100,0,18733,18733,15000,3653,4000,350,100,400,250,231
2020,822900281,24527,3997,3997,3997,0,20530,17000,17000,0,0,3530,3500,30,0,1370,1370,0,0,3980,250,140,120,230,87
2020,822900301,195186,8586,8586,8586,0,186600,156900,5000,151900,0,29700,5700,24000,0,13750,13750,9750,4000,4381,400,300,900,250,189
2020,822900311,9848,3606,3606,3606,0,6242,5500,5500,0,0,742,700,42,0,200,200,0,0,2020,150,250,230,240,40
2020,822900321,21290,3890,3890,3890,0,17400,15000,15000,0,0,2400,2400,0,0,9769,9769,8269,200,3710,840,700,368,324,88
2020,822900331,30263,10163,10163,10163,0,20100,18800,14000,4800,0,1300,1300,0,0,9000,9000,6000,3000,2210,140,10,400,240,119
2020,822900341,73230,9590,9590,9590,0,63640,60840,9000,51840,0,2800,2300,500,0,4700,4700,2700,2000,4013,192,900,660,186,54
2020,822900351,15922,11422,11422,11422,0,4500,4100,3000,1100,0,400,200,200,0,0,0,0,0,1407,192,85,120,100,99
2020,823000212,30350,15750,15750,15750,0,14600,13000,13000,0,0,1600,1400,200,0,5000,5000,5000,0,2532,300,120,120,96,53
2020,823000222,24720,6965,6965,6965,0,17755,16000,16000,0,0,1755,1400,355,0,15,15,0,0,3008,236,72,720,360,554
2020,823000242,18375,75,75,75,0,18300,15000,15000,0,0,3300,3300,0,0,12855,12855,8685,2720,7540,520,450,600,520,82
2020,823600211,43420,2530,2530,2530,0,40890,40000,40000,0,0,890,730,160,0,0,0,0,0,2580,440,100,190,100,2327
2020,823600241,9570,50,50,50,0,9520,9500,9500,0,0,20,20,0,0,6214,6214,5900,300,861,120,10,48,81,9
2020,823700201,46061,2912,2912,2912,0,43149,42000,11000,31000,0,1149,1080,69,0,30000,12000,0,0,2800,300,600,300,300,360
2020,823700211,29320,13320,13320,13320,0,16000,15000,15000,0,0,1000,1000,0,0,0,0,0,0,7256,580,500,600,276,673
2020,823700251,27948,17348,17348,17348,0,10600,10000,10000,0,0,600,600,0,0,0,0,0,0,2516,350,120,360,36,102
2020,823800201,15765,2015,2015,2015,0,13750,12500,12500,0,0,1250,1250,0,0,0,0,0,0,1703,240,200,150,96,69
2020,823800211,23500,3250,3250,1250,0,20250,18000,18000,0,0,2250,1800,450,0,10232,10232,9000,1232,2254,190,100,400,144,32
2020,823800221,28436,7786,7786,7786,0,20650,20000,18000,0,2000,650,550,100,0,1500,1500,0,1000,4200,160,100,430,280,48
2020,823900201,42780,4530,4530,4530,0,38250,38000,38000,0,0,250,0,250,0,18275,18275,18275,0,1517,264,13,20,240,50
2020,823900211,565,265,5,5,260,300,0,0,0,0,300,300,0,0,0,0,0,0,1440,336,180,240,24,0
2020,823900221,4687,4624,624,624,4000,63,0,0,0,0,63,0,63,0,0,0,0,0,681,55,108,10,18,2
2020,830000212,27270,5530,5530,5530,0,21740,21500,21500,0,0,240,240,0,0,2300,2300,2300,0,2912,204,18,480,180,325
2020,830000232,48306,21442,21442,21442,0,26864,24500,24500,0,0,2364,1500,864,0,0,0,0,0,6460,240,120,700,300,539
2020,830000242,706,478,278,278,200,228,0,0,0,0,228,0,228,0,25,25,0,0,733,107,40,100,36,0
2020,830000262,600,600,100,100,500,0,0,0,0,0,0,0,0,0,0,0,0,0,255,60,30,0,20,6
2020,830000272,69610,15900,15900,15900,0,53710,53000,23000,30000,0,710,710,0,0,0,0,0,0,2593,300,150,540,150,98
2020,830000282,48076,47078,5078,5078,42000,998,0,0,0,0,998,998,0,0,10050,10050,10000,0,6971,500,40,360,120,898
2020,830000292,58450,1150,1150,350,0,57300,50000,50000,0,0,7300,7300,0,0,33200,33200,26000,0,8040,600,100,300,240,765
2020,830000302,58628,3328,3328,3328,0,55300,55000,50000,5000,0,300,300,0,0,4000,0,0,0,2264,374,400,72,86,70
2020,830000322,10955,805,805,805,0,10150,9000,9000,0,0,1150,1150,0,0,1230,1230,1000,0,1759,698,12,389,180,49
2020,830000332,13232,130,130,130,0,13102,13000,9000,4000,0,102,102,0,0,3800,0,0,0,1198,288,120,245,36,16
2020,830000352,4932,4282,782,782,3500,650,0,0,0,0,650,650,0,0,0,0,0,0,2060,110,20,350,120,43
2020,830000382,27900,10500,10500,10500,0,17400,15000,15000,0,0,2400,2400,0,0,0,0,0,0,1880,250,100,250,180,262
2020,830000392,88130,15480,1480,1480,14000,72650,68600,0,68600,0,4050,4050,0,0,10700,10700,0,10000,3312,276,50,720,336,310
2020,830600231,38146,2420,2420,2420,0,35726,35000,35000,0,0,726,500,226,0,8000,8000,8000,0,1798,180,0,450,228,138
2020,830600261,8035,7535,5535,5535,2000,500,0,0,0,0,500,500,0,0,2000,2000,0,2000,2394,240,24,240,240,131
2020,830600291,34142,7738,7738,7738,0,26404,25000,25000,0,0,1404,1404,0,0,16487,16487,16000,0,3082,432,150,250,550,782
2020,830600311,21431,18381,18381,13381,0,3050,0,0,0,0,3050,50,0,3000,0,0,0,0,1510,120,30,120,120,37
2020,830600321,66976,15576,15576,10576,0,51400,45000,30000,15000,0,6400,3400,3000,0,19000,5000,0,5000,3290,360,60,510,390,320
2020,830600331,8428,3178,3178,3178,0,5250,5000,5000,0,0,250,250,0,0,0,0,0,0,2020,156,80,360,144,28
2020,830600351,2611,2543,1543,1543,1000,68,0,0,0,0,68,0,68,0,280,280,0,280,666,240,30,10,36,1
2020,830600361,7208,7008,6908,6908,100,200,0,0,0,0,200,200,0,0,0,0,0,0,2245,360,20,180,180,142
2020,830600371,45635,17585,17585,17585,0,28050,27000,17000,10000,0,1050,1050,0,0,0,0,0,0,4050,250,150,200,300,829
2020,830700201,4721,4721,2721,2721,2000,0,0,0,0,0,0,0,0,0,0,0,0,0,574,60,6,48,88,60
2020,830700221,1450,1450,50,50,1400,0,0,0,0,0,0,0,0,0,931,931,0,0,684,156,1,10,96,1
2020,830700231,21230,1000,1000,1000,0,20230,20000,20000,0,0,230,0,230,0,0,0,0,0,750,240,10,20,0,21
2020,830700251,27891,11691,2191,2191,9500,16200,16000,0,16000,0,200,200,0,0,11000,11000,11000,0,2875,222,177,390,366,63
2020,830700261,12625,3725,3725,3725,0,8900,8000,8000,0,0,900,900,0,0,5784,5784,5580,204,1970,180,50,250,180,66
2020,830700281,32025,11125,11125,11125,0,20900,20000,20000,0,0,900,900,0,0,0,0,0,0,2840,210,140,130,220,92
2020,830700291,36030,11830,11830,11830,0,24200,24000,24000,0,0,200,200,0,0,0,0,0,0,3430,300,250,120,200,444
2020,830700301,8170,6370,6370,6370,0,1800,1800,0,1800,0,0,0,0,0,0,0,0,0,782,120,250,16,36,2
2020,830700331,3000,3000,3000,3000,0,0,0,0,0,0,0,0,0,0,0,0,0,0,1420,244,720,24,59,2
2020,830700341,92835,21495,21495,21495,0,71340,70000,10000,60000,0,1340,1300,40,0,0,0,0,0,2030,240,150,150,120,61
2020,830700351,143720,56720,56720,56720,0,87000,85000,25000,60000,0,2000,2000,0,0,8150,8150,0,8000,1486,300,10,130,36,127
2020,830700371,58230,5230,5230,5230,0,53000,50000,10000,40000,0,3000,3000,0,0,21000,8000,8000,0,1313,268,5,240,80,70
2020,830700381,145206,5806,5806,5806,0,139400,135000,35000,100000,0,4400,500,3900,0,76500,71000,71000,0,1694,180,360,180,84,343
2020,830800201,22155,18655,2655,2655,16000,3500,0,0,0,0,3500,3500,0,0,15152,15152,12000,2000,3812,360,120,360,240,154
2020,830800211,9639,8040,8040,8040,0,1599,0,0,0,0,1599,1599,0,0,0,0,0,0,1668,156,24,180,168,217
2020,830800221,2700,2700,200,200,2500,0,0,0,0,0,0,0,0,0,0,0,0,0,245,70,0,0,19,1
2020,830800231,38730,3340,3340,3340,0,35390,35000,35000,0,0,390,390,0,0,0,0,0,0,2705,156,210,274,157,245
2020,830800251,72999,20408,20408,20408,0,52591,50000,50000,0,0,2591,2363,228,0,0,0,0,0,4641,264,150,280,163,147
2020,830800271,225547,157074,157074,157074,0,68473,57000,57000,0,0,11473,4000,7473,0,0,0,0,0,9160,450,40,100,150,24708
2020,830800291,253820,38320,38320,38320,0,215500,215000,65000,150000,0,500,0,500,0,31800,28800,28800,0,7770,840,200,440,420,1061
2020,830800311,49410,8310,8310,8310,0,41100,40000,40000,0,0,1100,1100,0,0,2000,0,0,0,6020,600,600,480,300,938
2020,830800321,106224,43290,43290,43290,0,62934,61528,16000,45528,0,1406,1293,113,0,300,0,0,0,3523,220,1440,580,79,429
2020,830800331,33401,13051,13051,10051,0,20350,15000,0,15000,0,5350,5350,0,0,8000,500,0,500,6020,240,120,580,390,318
2020,830800341,17035,6085,6085,6085,0,10950,10000,10000,0,0,950,600,350,0,4602,4602,4352,0,5080,420,100,400,600,61
2020,830800351,686,586,86,86,500,100,0,0,0,0,100,0,100,0,0,0,0,0,1290,480,10,80,160,0
2020,830800361,5,5,5,5,0,0,0,0,0,0,0,0,0,0,2300,2300,2300,0,450,70,60,12,18,0
2020,830800371,20260,7760,7760,7760,0,12500,9000,9000,0,0,3500,3500,0,0,5260,5260,5260,0,1739,204,60,220,228,136
2020,830800381,48683,48283,48283,48283,0,400,0,0,0,0,400,200,200,0,0,0,0,0,1800,100,80,200,100,142
2020,830800391,15111,12161,161,161,12000,2950,0,0,0,0,2950,2950,0,0,12576,12576,12000,0,2705,300,800,650,90,128
2020,830900211,2500,2300,1900,1900,400,200,0,0,0,0,200,200,0,0,2442,2442,2142,300,3988,458,750,900,240,31
2020,830900221,710,460,160,160,300,250,0,0,0,0,250,250,0,0,0,0,0,0,1908,600,30,120,120,29
2020,830900241,55700,22600,22600,20600,0,33100,28000,28000,0,0,5100,3400,200,1500,12000,12000,12000,0,3080,300,30,420,360,236
2020,830900271,132945,8860,5860,5860,3000,124085,118000,0,118000,0,6085,6085,0,0,80400,80400,80000,0,5264,1980,200,740,124,212
2020,830900281,39494,4794,4794,4794,0,34700,33000,33000,0,0,1700,1700,0,0,0,0,0,0,2190,240,150,150,240,166
2020,830900301,28550,1950,1950,1950,0,26600,26000,21000,5000,0,600,600,0,0,0,0,0,0,1958,824,180,120,60,77
2020,830900311,30840,3290,3290,3190,0,27550,23000,23000,0,0,4550,3550,1000,0,5000,5000,5000,0,1528,130,96,140,162,43
2020,830900321,59260,4260,4260,4260,0,55000,55000,15000,40000,0,0,0,0,0,2860,160,0,0,1993,300,780,200,48,152
2020,830900331,21122,7722,1222,1222,6500,13400,10500,0,10500,0,2900,2900,0,0,2500,2500,2500,0,1734,100,10,179,85,270
2020,830900341,11886,11386,4386,4386,7000,500,0,0,0,0,500,500,0,0,0,0,0,0,2662,300,50,500,300,134
2020,830900371,17160,7360,7360,7360,0,9800,7500,7500,0,0,2300,2300,0,0,2130,2130,0,0,2381,180,505,420,84,88
2020,830900381,18950,15150,13550,13550,1600,3800,0,0,0,0,3800,3800,0,0,0,0,0,0,2302,492,180,200,120,115
2020,830900391,2727,2027,1827,1827,200,700,0,0,0,0,700,700,0,0,1400,1400,0,1300,2362,360,30,240,360,37
2020,831000202,239278,16100,16100,16100,0,223178,218000,70000,148000,0,5178,4500,678,0,100,100,0,0,6392,480,50,240,372,7436
2020,831000222,67250,6110,6110,6110,0,61140,60000,45000,15000,0,1140,0,1140,0,9929,9929,9729,0,7510,360,550,210,600,703
2020,831000232,28300,28200,200,200,28000,100,0,0,0,0,100,100,0,0,18500,18500,18000,0,4550,360,500,660,300,329
2020,831000252,31122,5122,5122,5122,0,26000,25200,15200,10000,0,800,800,0,0,16200,10200,9500,650,3182,180,60,120,120,157
2020,831000262,57009,9743,7743,7743,2000,47266,46700,0,46700,0,566,566,0,0,5300,300,0,0,1891,600,12,96,98,479
2020,831000272,33198,288,288,288,0,32910,32000,32000,0,0,910,910,0,0,0,0,0,0,2206,240,318,324,174,323
2020,831000282,60904,2404,2404,2404,0,58500,55000,30000,25000,0,3500,1000,0,2500,2700,2700,2700,0,1908,252,40,60,96,235
2020,831000292,22797,5092,5092,5092,0,17705,17500,17500,0,0,205,150,55,0,5300,5300,5300,0,2044,216,220,94,120,40
2020,831000302,30780,280,280,280,0,30500,28000,14000,14000,0,2500,2500,0,0,26700,14700,12000,2700,5215,360,85,960,480,453
2020,831000332,12859,59,59,59,0,12800,12000,12000,0,0,800,800,0,0,10419,10419,9440,979,1285,340,25,190,120,105
2020,831000352,24314,2314,2314,2314,0,22000,20000,20000,0,0,2000,2000,0,0,2900,2900,0,0,4172,360,200,240,200,318
2020,831000362,21150,50,50,50,0,21100,19000,19000,0,0,2100,2100,0,0,0,0,0,0,2314,444,100,300,150,544
2020,831000372,18444,16944,12944,12944,4000,1500,0,0,0,0,1500,1500,0,0,0,0,0,0,1389,300,24,240,96,508
2020,831000382,9559,5159,3659,3659,1500,4400,3500,0,3500,0,900,900,0,0,2280,2280,2280,0,2478,288,30,480,240,80
2020,831000392,11923,5423,4123,4123,1300,6500,6000,0,0,6000,500,500,0,0,10000,10000,10000,0,1754,264,10,100,240,15
2020,831600221,54340,10940,10940,10940,0,43400,42000,42000,0,0,1400,1400,0,0,13000,13000,8000,2000,5090,240,100,200,150,522
2020,831600251,7561,4561,4061,61,500,3000,0,0,0,0,3000,0,2000,1000,1300,1300,0,1300,3000,840,400,150,240,65
2020,831600261,164,50,50,50,0,114,0,0,0,0,114,0,114,0,0,0,0,0,719,192,200,12,60,1
2020,831600271,5300,200,200,200,0,5100,5000,5000,0,0,100,100,0,0,0,0,0,0,1333,180,360,108,60,20
2020,831600281,10150,150,150,150,0,10000,10000,10000,0,0,0,0,0,0,1288,1288,1288,0,1069,122,96,120,128,52
2020,831600301,68521,9421,9421,8421,0,59100,53500,18500,35000,0,5600,4100,1000,500,13500,13000,12000,1000,6464,225,970,1330,312,459
2020,831600321,2070,2020,2020,2020,0,50,0,0,0,0,50,50,0,0,1500,1500,1000,500,878,132,240,60,36,10
2020,831600331,3250,250,250,250,0,3000,3000,3000,0,0,0,0,0,0,0,0,0,0,1731,300,84,120,72,6
2020,831700211,70800,7100,7100,7100,0,63700,63000,30000,33000,0,700,700,0,0,1000,0,0,0,1341,130,36,180,86,167
2020,831700221,5253,5253,4553,4553,700,0,0,0,0,0,0,0,0,0,830,830,200,0,2391,284,2,320,192,2
2020,831700231,24773,11960,11960,11960,0,12813,7500,7500,0,0,5313,5200,113,0,0,0,0,0,2149,144,90,420,170,401
2020,831700241,500,500,250,250,250,0,0,0,0,0,0,0,0,0,0,0,0,0,570,140,72,36,42,0
2020,831700291,57130,5170,5170,4870,0,51960,50000,50000,0,0,1960,960,1000,0,0,0,0,0,2100,240,270,252,120,164
2020,831700311,6434,6334,5334,5334,1000,100,0,0,0,0,100,0,100,0,0,0,0,0,2420,480,30,360,360,34
2020,831700331,577,577,300,300,277,0,0,0,0,0,0,0,0,0,0,0,0,0,632,120,36,120,24,1
2020,831700341,10794,3794,3794,3794,0,7000,7000,7000,0,0,0,0,0,0,0,0,0,0,1310,180,10,96,156,102
2020,831700371,82553,27188,27188,17188,0,55365,9000,9000,0,0,46365,1190,25175,20000,4515,4515,4515,0,6404,240,500,960,480,1669
2020,831700381,19082,6082,6082,4082,0,13000,13000,13000,0,0,0,0,0,0,0,0,0,0,720,100,350,60,30,26
2020,831700391,28322,4192,4192,4192,0,24130,24000,11000,13000,0,130,130,0,0,0,0,0,0,1496,120,150,240,96,140
2020,831800201,35200,200,200,200,0,35000,35000,35000,0,0,0,0,0,0,0,0,0,0,1230,264,200,15,36,42
2020,831800221,25785,4860,4860,4860,0,20925,20000,20000,0,0,925,750,175,0,0,0,0,0,2184,228,30,150,180,207
2020,831800241,20,20,20,20,0,0,0,0,0,0,0,0,0,0,0,0,0,0,727,204,154,12,20,8
2020,831800261,2015,2015,1515,1515,500,0,0,0,0,0,0,0,0,0,1030,1030,0,1000,1138,456,20,12,66,1
2020,831800271,12414,10614,1614,1614,9000,1800,0,0,0,0,1800,1800,0,0,5400,5400,4000,0,3876,432,140,360,204,74
2020,831800281,35898,5748,5748,5748,0,30150,30000,17000,13000,0,150,150,0,0,0,0,0,0,4330,480,40,720,300,424
2020,831800291,710,710,210,210,500,0,0,0,0,0,0,0,0,0,3000,3000,3000,0,701,190,20,20,67,1
2020,831800301,86080,230,230,230,0,85850,82000,23000,59000,0,3850,3850,0,0,12900,11400,8000,1000,3915,318,250,250,240,172
2020,831800311,51980,30980,980,980,30000,21000,20000,0,20000,0,1000,0,1000,0,32119,12119,12119,0,3530,600,10,360,360,2275
2020,831800321,1010,10,10,10,0,1000,1000,1000,0,0,0,0,0,0,0,0,0,0,870,150,100,30,20,2
2020,831800331,38400,9870,9870,9870,0,28530,25000,25000,0,0,3530,3530,0,0,2437,2437,0,0,3740,700,150,600,300,1984
2020,831800341,59090,42390,42390,42390,0,16700,16000,16000,0,0,700,700,0,0,0,0,0,0,2336,250,100,200,96,131
2020,831800351,39958,7658,7658,7658,0,32300,32000,32000,0,0,300,300,0,0,1832,1832,1832,0,2340,260,120,240,220,237
2020,831800371,11808,1268,1268,1268,0,10540,8700,8700,0,0,1840,1800,40,0,0,0,0,0,890,70,50,240,30,34
2020,831800381,33352,30302,18302,18302,12000,3050,0,0,0,0,3050,3050,0,0,0,0,0,0,3289,980,100,340,72,55
2020,831900231,5320,5320,1120,1120,4200,0,0,0,0,0,0,0,0,0,0,0,0,0,1186,144,100,60,96,1
2020,831900241,5730,5030,2130,2130,2900,700,0,0,0,0,700,700,0,0,2470,2470,2400,0,2050,420,60,150,150,21
2020,831900261,19593,5993,5993,5993,0,13600,10000,10000,0,0,3600,3600,0,0,0,0,0,0,2180,220,60,480,330,303
2020,831900291,40820,800,800,800,0,40020,32000,26000,6000,0,8020,1020,0,7000,0,0,0,0,1834,252,360,400,72,87
2020,831900301,19670,4520,4520,4520,0,15150,15000,15000,0,0,150,150,0,0,0,0,0,0,2300,190,110,280,250,269
2020,831900311,8200,200,200,200,0,8000,8000,8000,0,0,0,0,0,0,0,0,0,0,288,58,30,15,20,13
2020,831900331,12708,2708,2708,2708,0,10000,10000,10000,0,0,0,0,0,0,0,0,0,0,726,156,70,30,60,81
2020,831900341,15752,2852,2852,2852,0,12900,10000,10000,0,0,2900,2500,400,0,7184,7184,7184,0,4080,312,80,300,60,249
2020,831900361,48660,13660,13660,13660,0,35000,33500,23000,10500,0,1500,1500,0,0,4135,4135,0,4135,6430,360,500,600,300,1183
2020,831900381,11445,3800,3800,3800,0,7645,7500,7500,0,0,145,0,145,0,0,0,0,0,715,130,40,35,30,4
2020,832000202,87708,70708,70708,70708,0,17000,17000,17000,0,0,0,0,0,0,0,0,0,0,1981,96,22,84,129,275
2020,832000212,5840,2930,2930,2930,0,2910,0,0,0,0,2910,2560,350,0,500,500,500,0,1570,216,20,120,168,13
2020,832000222,9225,3925,3925,825,0,5300,5300,5000,300,0,0,0,0,0,0,0,0,0,615,67,200,120,0,10
2020,832000232,11746,11386,11386,11386,0,360,0,0,0,0,360,360,0,0,0,0,0,0,1251,280,10,280,72,296
2020,832000252,4188,4188,4188,4088,0,0,0,0,0,0,0,0,0,0,0,0,0,0,1260,84,36,36,84,2
2020,832000262,13880,880,880,880,0,13000,13000,13000,0,0,0,0,0,0,0,0,0,0,900,60,360,12,36,17
2020,832000272,578,578,278,278,300,0,0,0,0,0,0,0,0,0,0,0,0,0,1158,372,70,84,127,0
2020,832000282,1100,500,200,200,300,600,0,0,0,0,600,600,0,0,200,200,0,200,1682,396,72,180,144,52
2020,832000302,50,50,50,50,0,0,0,0,0,0,0,0,0,0,0,0,0,0,590,60,160,20,18,1
2020,832000312,53530,1200,1200,1200,0,52330,52330,15730,36600,0,0,0,0,0,0,0,0,0,785,204,116,60,60,8
2020,832000322,3030,30,30,30,0,3000,3000,3000,0,0,0,0,0,0,0,0,0,0,507,307,30,1,6,4
2020,832000332,63660,22860,22860,22560,0,40800,30000,30000,0,0,10800,5800,0,5000,0,0,0,0,4830,380,100,800,400,88
2020,832600201,77700,1700,1700,1700,0,76000,76000,45000,31000,0,0,0,0,0,3790,1790,1790,0,1432,240,110,40,52,91
2020,832600211,55328,12630,12630,11970,0,42698,34500,24500,10000,0,8198,1972,6226,0,1000,1000,1000,0,2820,300,50,500,120,199
2020,832600231,6324,6224,3224,3224,3000,100,0,0,0,0,100,100,0,0,1019,1019,1000,0,1222,276,36,84,36,26
2020,832600281,7310,7160,160,160,7000,150,0,0,0,0,150,150,0,0,6326,6326,5000,1326,2360,360,20,280,240,161
2020,832600291,107890,3890,3890,3890,0,104000,104000,0,104000,0,0,0,0,0,5970,5970,5970,0,1820,420,50,60,180,101
2020,832600301,49558,17258,17258,17258,0,32300,30500,5500,25000,0,1800,0,1800,0,0,0,0,0,1990,100,200,85,96,34
2020,832600311,10950,2150,2150,2150,0,8800,8200,2700,5500,0,600,500,100,0,0,0,0,0,770,70,50,100,80,20
2020,832600321,16436,6166,6166,6166,0,10270,10000,10000,0,0,270,200,70,0,0,0,0,0,1468,156,300,75,72,14
2020,832600341,51558,21758,21758,21058,0,29800,28000,9000,19000,0,1800,1800,0,0,3010,3010,2900,110,3602,450,80,200,240,1586
2020,832700221,29014,7014,7014,7014,0,22000,21000,21000,0,0,1000,1000,0,0,13780,13780,13680,0,3042,312,410,364,156,135
2020,832700231,2100,1900,900,900,1000,200,0,0,0,0,200,200,0,0,100,100,0,0,3050,720,300,600,250,52
2020,832700241,1750,1670,170,170,1500,80,0,0,0,0,80,80,0,0,900,900,0,0,3982,704,120,280,288,14
2020,832700271,4010,10,10,10,0,4000,4000,4000,0,0,0,0,0,0,0,0,0,0,324,50,1,5,18,6
2020,832700281,25810,510,510,510,0,25300,25000,25000,0,0,300,300,0,0,600,0,0,0,2894,204,460,150,50,41
2020,832700291,17695,2195,2195,2195,0,15500,13000,13000,0,0,2500,2500,0,0,4329,4329,4326,0,4366,154,330,520,132,352
2020,832700301,18610,1510,1510,1510,0,17100,15500,2500,13000,0,1600,600,1000,0,1300,1300,0,1300,2160,190,180,200,140,13
2020,832700311,300,300,300,300,0,0,0,0,0,0,0,0,0,0,0,0,0,0,447,160,50,20,5,1
2020,832700321,12370,4800,4800,4800,0,7570,7500,1000,6500,0,70,0,70,0,0,0,0,0,1100,150,550,20,20,6
2020,832700331,55668,26888,26888,26888,0,28780,18000,6000,12000,0,10780,450,10330,0,3000,0,0,0,2137,300,180,184,156,82
2020,832800211,42255,1905,1905,1905,0,40350,38500,28500,10000,0,1850,1850,0,0,6000,6000,3100,2900,4621,248,1000,440,244,136
2020,832800231,60285,7968,7968,7968,0,52317,50000,50000,0,0,2317,2317,0,0,0,0,0,0,4756,360,60,120,36,684
2020,832800241,2410,10,10,10,0,2400,0,0,0,0,2400,2400,0,0,1800,1800,0,0,1160,360,5,180,60,94
2020,832800251,2067,2059,59,59,2000,8,0,0,0,0,8,0,8,0,2200,2200,0,0,3438,1020,194,181,330,1
2020,832800261,4820,4730,4730,4730,0,90,0,0,0,0,90,90,0,0,0,0,0,0,2518,936,300,240,132,52
2020,832800291,32110,7110,110,110,7000,25000,24000,0,24000,0,1000,1000,0,0,0,0,0,0,3374,336,50,420,324,42
2020,832800311,47660,11000,11000,11000,0,36660,36560,7000,29560,0,100,0,100,0,0,0,0,0,1252,174,300,60,48,30
2020,832800321,24725,2220,2220,2220,0,22505,22000,10000,12000,0,505,500,5,0,7000,7000,7000,0,1584,130,272,120,32,74
2020,832900201,25300,300,300,300,0,25000,25000,25000,0,0,0,0,0,0,0,0,0,0,1584,290,48,84,60,26
2020,832900211,46276,12566,12566,12566,0,33710,33600,25600,8000,0,110,110,0,0,500,0,0,0,2486,420,250,180,139,72
2020,832900221,1380,1380,80,80,1300,0,0,0,0,0,0,0,0,0,0,0,0,0,601,360,36,10,36,1
2020,832900241,172440,82440,82440,82440,0,90000,90000,0,90000,0,0,0,0,0,0,0,0,0,5016,240,4000,150,36,590
2020,832900251,157900,63000,63000,40000,0,94900,75000,30000,45000,0,19900,4500,400,15000,5000,0,0,0,5950,480,70,1000,250,13495
2020,832900261,23140,19240,7240,6240,12000,3900,0,0,0,0,3900,3400,500,0,12800,12800,9000,1400,4570,180,10,870,420,246
2020,832900281,2508,2508,1508,1508,1000,0,0,0,0,0,0,0,0,0,11,11,0,0,2831,444,200,420,180,1
2020,832900301,6880,180,180,180,0,6700,6300,1000,5300,0,400,400,0,0,7000,7000,7000,0,1156,100,180,180,36,35
2020,832900321,19824,3754,3754,3754,0,16070,15200,0,15200,0,870,190,680,0,0,0,0,0,1323,156,112,235,108,29
2020,832900331,78403,8473,8473,8473,0,69930,67100,25000,42100,0,2830,1830,1000,0,31800,31800,20000,11800,2689,354,200,495,158,471
2020,833000212,73060,800,800,800,0,72260,71400,15000,56400,0,860,800,60,0,2000,2000,2000,0,916,150,30,60,36,25
2020,833000222,14700,600,600,600,0,14100,13500,3000,10500,0,600,600,0,0,1300,1300,1300,0,1200,140,170,150,150,66
2020,833600201,47800,7100,7100,7100,0,40700,39000,26000,13000,0,1700,1700,0,0,19929,19429,14600,4829,6278,228,781,440,241,430
2020,833600211,50,50,50,50,0,0,0,0,0,0,0,0,0,0,0,0,0,0,565,200,30,10,15,1
2020,833900201,1866,6,6,6,0,1860,1560,1560,0,0,300,300,0,0,0,0,0,0,1680,150,600,120,70,6
2020,840000202,23527,7795,7795,7795,0,15732,14300,14300,0,0,1432,1350,82,0,9235,9235,9100,0,1697,216,110,240,216,400
2020,840000212,120116,28730,28730,22730,0,91386,90000,75000,15000,0,1386,1160,226,0,39250,29250,29000,250,5310,830,280,510,174,297
2020,840000222,74667,10163,10163,10163,0,64504,60100,20100,40000,0,4404,3952,452,0,6000,6000,5000,1000,5265,365,48,546,276,1107
2020,840000242,59744,1944,1944,1944,0,57800,57000,27000,3000,27000,800,800,0,0,17900,17900,17700,0,3780,153,101,182,201,220
2020,840000252,227,227,27,27,200,0,0,0,0,0,0,0,0,0,400,400,0,0,1494,120,960,67,48,0
2020,840000262,3838,3805,305,305,3500,33,0,0,0,0,33,0,33,0,60,60,0,0,3131,180,48,252,180,39
2020,840000272,7040,6940,6940,6940,0,100,0,0,0,0,100,0,100,0,0,0,0,0,1123,221,15,135,96,26
2020,840000292,145466,63596,42596,42596,21000,81870,80000,0,80000,0,1870,1870,0,0,11200,10000,10000,0,4723,192,124,365,182,390
2020,840000302,64012,44812,20812,20812,24000,19200,3500,0,0,3500,15700,11700,0,4000,0,0,0,0,5860,480,300,480,300,124
2020,840000312,21550,50,50,50,0,21500,20000,20000,0,0,1500,1500,0,0,9557,9557,9557,0,1510,240,10,130,180,70
2020,840000362,25000,23600,600,600,23000,1400,0,0,0,0,1400,1400,0,0,4000,4000,0,0,5230,450,400,400,80,225
2020,840000372,32059,4370,4370,3870,0,27689,27000,27000,0,0,689,350,339,0,18400,18400,18400,0,3010,800,20,180,240,125
2020,840000382,2810,2360,2260,2260,100,450,0,0,0,0,450,450,0,0,1200,1200,0,1200,1826,444,20,60,180,32
2020,840000392,27370,4400,900,900,3500,22970,22000,0,0,22000,970,900,70,0,3000,3000,0,3000,664,85,5,144,60,37
2020,840600201,87706,23712,23712,23712,0,63994,60000,60000,0,0,3994,3599,395,0,0,0,0,0,4107,426,313,421,144,14199
2020,840600281,25076,1965,1965,1965,0,23111,10000,8000,2000,0,13111,1030,81,12000,2200,0,0,0,1867,228,298,245,93,48
2020,840600301,42024,13484,13484,13484,0,28540,23000,7000,16000,0,5540,3600,1940,0,0,0,0,0,2670,270,200,270,260,438
2020,840600311,12340,2040,2040,40,0,10300,10000,10000,0,0,300,0,300,0,0,0,0,0,679,180,250,10,19,286
2020,840600321,15632,932,932,932,0,14700,10000,10000,0,0,4700,4700,0,0,5420,5420,2900,0,5525,455,170,360,468,967
2020,840600331,17008,688,688,688,0,16320,16000,16000,0,0,320,0,320,0,320,320,0,0,1400,350,100,150,100,15
2020,840600361,16320,6220,6220,6220,0,10100,10000,10000,0,0,100,100,0,0,50,50,0,0,1998,240,180,190,234,62
2020,840600371,28937,4212,4212,4212,0,24725,24000,24000,0,0,725,550,175,0,16000,16000,15000,1000,3000,360,240,300,240,238
2020,840600381,15300,150,150,150,0,15150,15000,15000,0,0,150,150,0,0,0,0,0,0,628,192,40,40,36,22
2020,840700201,15674,674,674,674,0,15000,15000,15000,0,0,0,0,0,0,0,0,0,0,808,144,156,72,47,16
2020,840700221,86641,29021,29021,9021,0,57620,56200,56200,0,0,1420,1420,0,0,45794,21794,21794,0,7490,1380,50,720,100,503
2020,840700231,12082,82,82,82,0,12000,12000,12000,0,0,0,0,0,0,0,0,0,0,405,84,55,15,15,9
2020,840700241,24855,6987,6987,6987,0,17868,17800,11000,6800,0,68,0,68,0,1500,0,0,0,1573,183,54,95,66,31
2020,840700251,1058,130,130,130,0,928,0,0,0,0,928,610,318,0,0,0,0,0,1336,95,132,55,54,21
2020,840700271,59461,7261,7261,7011,0,52200,50000,50000,0,0,2200,2200,0,0,19990,19990,0,17810,5551,984,90,570,276,581
2020,840700291,14965,2065,2065,2065,0,12900,12200,12200,0,0,700,700,0,0,2885,2885,2200,650,885,162,34,225,58,77
2020,840700311,30015,8815,8815,5815,0,21200,16000,16000,0,0,5200,2200,3000,0,10530,10530,9530,1000,1240,240,40,120,60,256
2020,840700321,62453,7453,7453,7453,0,55000,55000,25000,30000,0,0,0,0,0,400,0,0,0,2592,810,720,72,45,199
2020,840700331,10200,1610,1610,1610,0,8590,8100,8100,0,0,490,90,400,0,0,0,0,0,2246,350,180,204,132,69
2020,840700361,5620,5120,5120,5120,0,500,0,0,0,0,500,500,0,0,0,0,0,0,2100,480,50,200,150,365
2020,840700371,112258,4258,4258,4258,0,108000,105000,64000,41000,0,3000,3000,0,0,51450,27450,26600,800,6400,360,200,400,280,954
2020,840700381,4394,274,274,274,0,4120,4000,4000,0,0,120,0,120,0,0,0,0,0,895,92,10,54,15,1
2020,840700391,12700,200,200,200,0,12500,12000,12000,0,0,500,500,0,0,5000,5000,5000,0,875,96,10,126,96,74
2020,840800211,17070,5237,5237,5237,0,11833,11800,11000,800,0,33,0,33,0,0,0,0,0,1239,84,80,90,95,26
2020,840800231,2040,2005,1805,1805,200,35,0,0,0,0,35,0,35,0,0,0,0,0,1403,264,10,180,144,16
2020,840800241,12378,11844,4844,1544,7000,534,0,0,0,0,534,300,234,0,4980,4980,0,4900,4626,730,15,512,285,44
2020,840800251,163305,2505,2505,2505,0,160800,160000,160000,0,0,800,450,350,0,17800,9800,9800,0,1960,165,85,280,110,583
2020,840800261,24960,5715,5715,5715,0,19245,18000,18000,0,0,1245,1200,45,0,9138,9138,9138,0,2805,300,200,490,180,268
2020,840800291,14991,14765,2765,2765,12000,226,0,0,0,0,226,0,226,0,0,0,0,0,1059,168,180,119,59,14
2020,840800311,177540,18640,18640,18640,0,158900,153000,10000,143000,0,5900,100,3500,2300,0,0,0,0,1910,180,200,200,150,342
2020,840800321,42896,6696,6696,696,0,36200,30000,30000,0,0,6200,200,6000,0,18660,18660,17760,300,4570,200,170,300,300,186
2020,840800341,41620,8820,8820,8820,0,32800,32000,20000,12000,0,800,800,0,0,4940,3440,3440,0,4230,450,300,400,360,1948
2020,840800361,7800,2000,2000,2000,0,5800,5800,0,5800,0,0,0,0,0,0,0,0,0,1460,240,250,360,60,1
2020,840800371,7850,50,50,50,0,7800,5800,5800,0,0,2000,2000,0,0,5620,5620,3700,0,2490,240,200,240,190,47
2020,840800381,127534,38969,38969,38969,0,88565,85000,15000,70000,0,3565,3000,565,0,0,0,0,0,6650,300,200,400,250,2034
2020,840900201,15523,15139,15139,15139,0,384,0,0,0,0,384,0,384,0,0,0,0,0,1683,135,588,93,82,50
2020,840900211,33058,13724,13724,13724,0,19334,16100,16100,0,0,3234,2650,584,0,11000,9000,0,9000,5984,361,771,602,408,641
2020,840900231,28031,7510,7510,6010,0,20521,20300,20300,0,0,221,80,141,0,0,0,0,0,1524,72,13,22,144,35
2020,840900261,2354,1604,1604,1604,0,750,0,0,0,0,750,700,50,0,0,0,0,0,2782,264,250,840,88,37
2020,840900271,17876,1876,1876,1876,0,16000,16000,16000,0,0,0,0,0,0,0,0,0,0,588,156,25,48,30,20
2020,840900281,34868,1856,1856,1856,0,33012,32000,17000,15000,0,1012,930,82,0,0,0,0,0,4752,420,207,600,340,1318
2020,840900301,8150,1150,1150,150,0,7000,7000,7000,0,0,0,0,0,0,0,0,0,0,632,100,150,20,62,7
2020,840900311,2761,2761,2261,2261,500,0,0,0,0,0,0,0,0,0,0,0,0,0,2038,768,20,20,80,25
2020,840900321,30449,8749,8749,8749,0,21700,20000,20000,0,0,1700,1700,0,0,12400,12400,12400,0,4620,400,70,500,250,736
2020,840900331,23060,410,410,410,0,22650,22000,22000,0,0,650,650,0,0,17700,17700,17500,0,3310,400,60,400,300,341
2020,840900351,3360,2910,2610,2610,300,450,0,0,0,0,450,450,0,0,0,0,0,0,2270,400,20,300,100,29
2020,840900371,12960,10160,160,160,10000,2800,0,0,0,0,2800,2800,0,0,11780,11780,0,9500,3140,240,80,220,400,105
2020,841000202,85,85,25,25,60,0,0,0,0,0,0,0,0,0,0,0,0,0,771,238,12,12,27,1
2020,841000212,1533,1533,1533,1533,0,0,0,0,0,0,0,0,0,0,0,0,0,0,1238,348,48,72,120,0
2020,841000232,11920,4441,4441,4441,0,7479,7380,7380,0,0,99,99,0,0,575,575,575,0,3148,102,147,141,85,316
2020,841000242,41275,2275,2275,2275,0,39000,38000,12000,26000,0,1000,1000,0,0,0,0,0,0,1024,115,105,241,61,166
2020,841000252,53155,11115,11115,11115,0,42040,36900,30000,6900,0,5140,5100,40,0,11990,11990,11490,0,2524,280,100,300,240,97
2020,841000262,57400,8100,8100,8100,0,49300,40000,40000,0,0,9300,8300,1000,0,0,0,0,0,6559,362,360,720,362,753
2020,841000292,29669,349,349,349,0,29320,29000,29000,0,0,320,320,0,0,0,0,0,0,1100,216,10,240,108,65
2020,841000332,1185,1185,1085,1085,100,0,0,0,0,0,0,0,0,0,0,0,0,0,1118,450,100,84,84,7
2020,841000342,34440,3240,3240,3240,0,31200,29000,11000,18000,0,2200,2200,0,0,0,0,0,0,3600,360,100,360,288,115
2020,841000352,21154,754,754,754,0,20400,0,0,0,0,20400,20400,0,0,21100,21100,0,2600,4048,240,100,600,420,255
2020,841000362,11148,6248,6248,6248,0,4900,3500,3500,0,0,1400,1400,0,0,1000,1000,0,1000,3622,180,120,780,190,395
2020,841000372,11800,7300,7300,7300,0,4500,4500,4500,0,0,0,0,0,0,0,0,0,0,720,190,180,0,20,13
2020,841000382,6890,390,390,390,0,6500,6500,6500,0,0,0,0,0,0,0,0,0,0,1387,230,150,100,27,9
2020,841000392,617,467,467,467,0,150,0,0,0,0,150,0,150,0,0,0,0,0,595,120,50,60,55,1
2020,841600201,19617,4097,4097,4097,0,15520,15520,15520,0,0,0,0,0,0,300,0,0,0,1440,227,203,105,154,33
2020,841600211,2894,2574,2574,2574,0,320,0,0,0,0,320,100,220,0,0,0,0,0,5529,254,2368,342,96,29
2020,841600231,26400,5518,5518,5518,0,20882,17800,17800,0,0,3082,2900,182,0,800,800,0,800,4629,204,72,361,301,377
2020,841600281,6086,5186,3686,3186,1500,900,0,0,0,0,900,900,0,0,0,0,0,0,2112,252,54,243,181,55
2020,841600321,31105,4705,4705,2705,0,26400,23000,23000,0,0,3400,3250,150,0,12000,12000,9000,2000,5788,636,100,400,252,104
2020,841600331,22088,17486,4486,4486,13000,4602,0,0,0,0,4602,4602,0,0,20,20,0,0,3279,241,400,150,258,347
2020,841600341,70090,19590,19590,19590,0,50500,50000,25000,25000,0,500,300,200,0,2400,2400,2400,0,2290,300,50,240,120,118
2020,841600361,29055,2970,2970,2970,0,26085,25000,500,24500,0,1085,750,335,0,0,0,0,0,2118,204,100,450,154,26
2020,841600391,45637,14010,14010,14010,0,31627,29000,22000,7000,0,2627,1500,1127,0,1500,1500,1500,0,3800,300,60,360,240,141
2020,841700201,30,30,30,30,0,0,0,0,0,0,0,0,0,0,0,0,0,0,1011,422,115,64,35,0
2020,841700211,383,383,140,140,243,0,0,0,0,0,0,0,0,0,0,0,0,0,1143,180,282,40,245,1
2020,841700231,5666,5666,266,266,5400,0,0,0,0,0,0,0,0,0,0,0,0,0,932,517,45,48,36,1
2020,841700241,6168,3335,2835,1635,500,2833,0,0,0,0,2833,2800,33,0,780,780,0,0,2129,194,68,300,240,51
2020,841700261,3250,1150,850,550,300,2100,0,0,0,0,2100,400,1700,0,3923,3923,0,3923,1715,420,30,300,180,18
2020,841700271,30510,1297,1297,1297,0,29213,29100,11100,18000,0,113,0,113,0,0,0,0,0,1281,102,62,43,48,17
2020,841700291,21873,1710,1710,1710,0,20163,18000,18000,0,0,2163,2000,163,0,4600,4600,2400,2200,3408,192,50,380,240,342
2020,841700331,16890,7890,7890,7690,0,9000,6000,6000,0,0,3000,3000,0,0,0,0,0,0,2170,180,20,240,120,459
2020,841700341,740,740,640,640,100,0,0,0,0,0,0,0,0,0,0,0,0,0,1045,420,60,0,24,8
2020,841700351,3650,3650,150,150,3500,0,0,0,0,0,0,0,0,0,0,0,0,0,192,60,20,0,12,1
2020,841700361,4050,50,50,50,0,4000,4000,4000,0,0,0,0,0,0,0,0,0,0,586,65,80,25,16,3
2020,841700371,3407,1207,1207,1207,0,2200,0,0,0,0,2200,2200,0,0,2560,2560,0,500,1752,150,550,210,204,44
2020,841700381,29810,3010,3010,3010,0,26800,26800,4000,22800,0,0,0,0,0,0,0,0,0,440,240,41,60,36,22
2020,841800201,74241,32948,32948,32948,0,41293,40000,27000,13000,0,1293,900,393,0,0,0,0,0,3000,300,120,240,180,110
2020,841800211,29220,6207,6207,6207,0,23013,19400,19000,400,0,3613,3500,113,0,0,0,0,0,2255,296,409,258,182,83
2020,841800221,110945,5225,5225,5225,0,105720,101500,65500,36000,0,4220,2570,1650,0,60000,45000,40000,5000,5880,690,300,950,125,520
2020,841800231,71336,4603,4603,4603,0,66733,64369,50000,14369,0,2364,576,788,1000,32000,32000,32000,0,1916,166,122,284,76,85
2020,841800251,12052,11252,5252,5252,6000,800,0,0,0,0,800,800,0,0,1470,1470,0,1300,2699,180,66,600,300,21
2020,841800261,6511,511,511,511,0,6000,6000,0,0,6000,0,0,0,0,14,14,0,0,682,120,42,20,60,25
2020,841800271,3176,2996,1496,1496,1500,180,0,0,0,0,180,0,180,0,0,0,0,0,319,102,5,24,26,1
2020,841800281,76602,17602,17602,17602,0,59000,57000,40000,17000,0,2000,2000,0,0,16200,16200,16000,0,3642,240,150,600,210,104
2020,841800291,74082,2,2,2,0,74080,74000,74000,0,0,80,0,80,0,60140,60140,54840,0,2273,360,96,144,220,0
2020,841800311,1770,1700,1700,1700,0,70,0,0,0,0,70,0,70,0,0,0,0,0,595,128,144,18,25,1
2020,841800321,33250,550,550,550,0,32700,30000,30000,0,0,2700,700,0,2000,0,0,0,0,1900,300,550,300,100,58
2020,841800351,26391,5576,5576,5576,0,20815,18200,17100,1100,0,2615,1400,1215,0,9080,9080,7600,960,4538,111,50,506,300,402
2020,841800371,930,830,830,830,0,100,0,0,0,0,100,100,0,0,0,0,0,0,1600,200,10,240,170,0
2020,841900201,2323,2158,158,158,2000,165,0,0,0,0,165,120,45,0,0,0,0,0,2614,306,164,204,216,9
2020,841900211,33352,2797,2797,2797,0,30555,30000,30000,0,0,555,500,55,0,16640,16640,13000,3600,5213,233,458,919,348,1046
2020,841900221,37085,11725,11725,11725,0,25360,25000,25000,0,0,360,0,360,0,0,0,0,0,1703,180,309,48,60,30
2020,841900241,339,39,39,39,0,300,0,0,0,0,300,300,0,0,0,0,0,0,861,600,5,35,72,37
2020,841900281,5242,5162,3600,3600,1562,80,0,0,0,0,80,80,0,0,0,0,0,0,594,180,10,130,39,32
2020,841900311,31750,150,150,150,0,31600,28000,28000,0,0,3600,3600,0,0,16756,16756,13756,0,1180,240,20,100,200,92
2020,841900321,15880,9380,9380,9380,0,6500,6000,6000,0,0,500,400,100,0,150,150,0,150,1670,100,260,370,180,52
2020,841900331,24,24,24,24,0,0,0,0,0,0,0,0,0,0,0,0,0,0,467,78,80,12,24,1
2020,841900341,11500,8100,1600,1600,6500,3400,0,0,0,0,3400,3400,0,0,2500,2500,2500,0,2762,80,150,600,132,300
2020,841900371,60626,6126,6126,6126,0,54500,49000,15000,34000,0,5500,3500,2000,0,33423,14423,9895,3700,3370,600,120,300,300,163
2020,841900391,1601,1601,401,401,1200,0,0,0,0,0,0,0,0,0,0,0,0,0,1589,252,940,10,72,1
2020,842000202,43336,2695,2695,2695,0,40641,37800,29800,0,8000,2841,2750,91,0,6000,6000,0,6000,1932,204,60,144,60,90
2020,842000222,17512,9012,9012,7011,0,8500,8500,8500,0,0,0,0,0,0,0,0,0,0,1850,181,501,121,192,12
2020,842000232,785,785,685,685,100,0,0,0,0,0,0,0,0,0,0,0,0,0,1718,360,2,120,120,86
2020,842000242,10390,9890,7390,7390,2500,500,0,0,0,0,500,500,0,0,0,0,0,0,2260,100,200,100,100,149
2020,842000312,28030,3191,3191,3191,0,24839,24389,3600,20789,0,450,400,50,0,2000,2000,0,2000,1657,56,40,500,150,29
2020,842000332,24465,425,425,425,0,24040,13690,1690,12000,0,10350,0,10350,0,2000,0,0,0,1765,173,630,100,102,13
2020,842000342,3216,3216,1216,1216,2000,0,0,0,0,0,0,0,0,0,1400,1400,0,400,2630,960,50,300,240,2
2020,842000372,23930,22120,20020,20020,2100,1810,0,0,0,0,1810,310,1500,0,20,20,0,0,3034,435,200,420,504,49
2020,842000382,27700,3400,3400,3400,0,24300,24300,24300,0,0,0,0,0,0,0,0,0,0,752,320,60,12,84,108
2020,842000392,30350,6310,6310,6310,0,24040,24000,24000,0,0,40,40,0,0,4000,4000,4000,0,1420,360,30,120,140,35
2020,842600201,26625,5675,5675,5675,0,20950,19000,19000,0,0,1950,1950,0,0,200,200,0,0,1655,336,115,134,108,56
2020,842600211,29598,4383,4383,4383,0,25215,25000,25000,0,0,215,0,215,0,0,0,0,0,2026,276,223,142,53,24
2020,842600221,81602,22702,22202,12202,500,58900,52000,0,52000,0,6900,1900,5000,0,10040,10040,10000,0,5727,1016,15,450,216,1542
2020,842600301,6010,2310,2310,310,0,3700,3500,2500,1000,0,200,0,200,0,0,0,0,0,1167,125,500,52,20,29
2020,842600311,50,50,50,50,0,0,0,0,0,0,0,0,0,0,0,0,0,0,583,94,130,50,14,0
2020,842600321,2600,1200,1200,1200,0,1400,1400,1400,0,0,0,0,0,0,0,0,0,0,1292,110,670,30,30,3
2020,842600331,9716,500,500,500,0,9216,9116,5000,4116,0,100,0,0,100,0,0,0,0,2067,260,1250,60,47,7
2020,842600341,77536,4036,4036,4036,0,73500,72000,12000,60000,0,1500,1400,100,0,13000,13000,0,13000,1290,190,120,100,120,47
2020,842600351,16530,6130,6130,6130,0,10400,9000,9000,0,0,1400,1400,0,0,23669,23669,9069,14600,2480,250,200,400,240,471
2020,842700201,22768,1202,1202,1202,0,21566,21000,16000,5000,0,566,250,316,0,2187,2187,1617,0,2177,220,80,110,177,62
2020,842700211,60620,13357,13357,13357,0,47263,46500,16500,30000,0,763,600,163,0,20000,0,0,0,3050,180,30,400,180,143
2020,842700311,5500,1500,1500,1500,0,4000,4000,4000,0,0,0,0,0,0,35,35,0,0,1448,240,240,100,60,31
2020,842700321,128762,90412,90412,90412,0,38350,37000,4000,33000,0,1350,550,800,0,0,0,0,0,2316,275,520,310,212,375
2020,842700331,34785,17785,17785,17785,0,17000,17000,7000,10000,0,0,0,0,0,500,0,0,0,861,150,240,75,60,159
2020,842700341,8004,2004,2004,2004,0,6000,6000,6000,0,0,0,0,0,0,0,0,0,0,760,98,30,48,49,61
2020,842800201,28152,900,900,900,0,27252,25000,25000,0,0,2252,2200,52,0,5900,5900,0,5900,5770,300,400,300,270,1274
2020,842800311,3070,70,70,70,0,3000,3000,1500,1500,0,0,0,0,0,0,0,0,0,508,90,120,36,30,4
2020,842800321,2484,2384,2184,1834,200,100,0,0,0,0,100,100,0,0,354,354,0,54,1745,216,39,110,180,9
2020,842800331,59304,12145,12145,12145,0,47159,41500,6500,35000,0,5659,300,5359,0,0,0,0,0,1430,360,12,120,76,27
2020,842800341,13961,411,411,411,0,13550,13500,5500,8000,0,50,0,50,0,0,0,0,0,642,102,60,10,24,3
2020,842800361,273778,14528,14528,14528,0,259250,115200,10000,105200,0,144050,3550,140500,0,24000,24000,24000,0,3552,180,100,310,372,280
2020,842800371,4001,1,1,1,0,4000,4000,4000,0,0,0,0,0,0,0,0,0,0,426,120,90,10,36,5
2020,842800381,9898,5872,5872,5872,0,4026,0,0,0,0,4026,3800,226,0,1240,1240,150,0,1884,232,120,240,240,15
2020,842900211,21423,10993,10993,10993,0,10430,9000,9000,0,0,1430,1430,0,0,3263,3263,3200,0,3413,220,65,264,346,36
2020,842900221,221722,43150,31350,31350,11800,178572,178000,0,178000,0,572,120,452,0,6000,0,0,0,2698,401,1001,184,124,352
2020,842900231,22213,16876,5876,5876,11000,5337,0,0,0,0,5337,5300,37,0,130,130,0,0,4972,180,50,960,360,406
2020,842900241,26713,6463,6463,6463,0,20250,20000,16000,4000,0,250,250,0,0,4030,4030,4030,0,3395,180,10,500,200,229
2020,842900311,9715,5900,5900,5900,0,3815,3800,3800,0,0,15,0,15,0,0,0,0,0,640,80,70,60,10,12
2020,842900321,400,400,400,400,0,0,0,0,0,0,0,0,0,0,0,0,0,0,260,100,10,5,10,1
2020,842900331,20815,12700,12700,12700,0,8115,7000,7000,0,0,1115,1000,115,0,400,400,0,0,2210,216,300,254,180,172
2020,842900341,11730,1030,1030,1030,0,10700,10500,10500,0,0,200,200,0,0,2500,2500,2500,0,1173,228,30,240,120,12
2020,842900361,51569,4047,4047,4047,0,47522,46500,5000,41500,0,1022,570,452,0,5000,5000,5000,0,1161,172,120,240,36,51
2020,842900371,2510,2510,2510,2510,0,0,0,0,0,0,0,0,0,0,0,0,0,0,842,103,400,30,48,4
2020,842900381,6249,5749,2449,2449,3300,500,0,0,0,0,500,500,0,0,700,700,0,0,990,193,24,84,134,24
2020,843000312,920,920,920,920,0,0,0,0,0,0,0,0,0,0,0,0,0,0,1471,76,1048,12,24,1
2020,850000202,15180,3080,3080,3080,0,12100,10000,10000,0,0,2100,2100,0,0,9200,9200,6700,0,1484,240,30,48,144,111
2020,850000212,818,818,318,318,500,0,0,0,0,0,0,0,0,0,0,0,0,0,842,480,12,18,36,1
2020,850000222,29485,8455,7455,6455,1000,21030,21000,0,21000,0,30,0,30,0,13460,4460,4400,0,814,180,120,20,72,7
2020,850000242,528,528,528,528,0,0,0,0,0,0,0,0,0,0,0,0,0,0,442,120,60,10,10,1
2020,850000252,101,101,1,1,100,0,0,0,0,0,0,0,0,0,0,0,0,0,255,80,5,10,15,1
2020,850000262,9222,212,212,212,0,9010,9000,9000,0,0,10,10,0,0,60,60,0,0,824,114,240,36,44,28
2020,850000272,520,520,20,20,500,0,0,0,0,0,0,0,0,0,0,0,0,0,1468,420,690,10,18,1
2020,850000282,4700,200,200,200,0,4500,4500,4500,0,0,0,0,0,0,0,0,0,0,616,75,10,90,36,4
2020,850000292,23940,440,440,440,0,23500,23000,23000,0,0,500,500,0,0,0,0,0,0,4276,550,10,300,204,329
2020,850000302,13345,3845,3845,2785,0,9500,9300,9300,0,0,200,200,0,0,5488,5488,5488,0,5236,1560,12,660,420,37
2020,850000312,32699,9531,9531,9531,0,23168,21868,14000,530,7338,1300,1300,0,0,8000,8000,0,8000,2770,300,200,400,150,170
2020,850000332,1144,1144,944,944,200,0,0,0,0,0,0,0,0,0,1500,1500,1500,0,833,180,200,20,48,1
2020,850000352,28750,7800,7800,7800,0,20950,20000,20000,0,0,950,950,0,0,0,0,0,0,2384,396,240,240,108,102
2020,850000362,60,60,60,60,0,0,0,0,0,0,0,0,0,0,0,0,0,0,780,240,50,50,60,1
2020,850000372,21930,21330,6330,6330,15000,600,0,0,0,0,600,600,0,0,0,0,0,0,2514,288,160,156,120,60
2020,850000382,88800,9600,9600,9600,0,79200,76000,50000,26000,0,3200,3200,0,0,30800,11800,9800,2000,6550,480,600,520,140,780
2020,850600201,8001,1,1,1,0,8000,8000,0,8000,0,0,0,0,0,0,0,0,0,488,150,50,10,18,24
2020,850600221,270,240,10,10,230,30,0,0,0,0,30,0,30,0,2300,2300,0,0,480,144,0,24,16,0
2020,850600231,23864,6964,6964,6964,0,16900,15000,15000,0,0,1900,1900,0,0,3900,3900,0,900,2593,168,60,480,150,81
2020,850600241,46242,8842,8842,8842,0,37400,35000,35000,0,0,2400,1900,500,0,5580,5580,5400,0,4050,300,400,400,450,980
2020,850600251,60350,200,200,200,0,60150,60000,60000,0,0,150,150,0,0,40950,4950,4700,0,3670,300,800,600,300,52
2020,850600271,10003,3,3,3,0,10000,10000,10000,0,0,0,0,0,0,0,0,0,0,1673,48,0,0,60,40
2020,850600291,3370,2520,1520,1520,1000,850,0,0,0,0,850,850,0,0,496,496,0,0,3048,600,60,300,180,32
2020,850600301,4900,100,100,100,0,4800,4500,4500,0,0,300,300,0,0,0,0,0,0,958,192,136,30,48,13
2020,850600311,62810,11720,11720,11720,0,51090,50000,28000,22000,0,1090,900,190,0,26000,18000,18000,0,6360,480,250,600,360,134
2020,850600321,19040,4490,4490,3490,0,14550,14000,8000,6000,0,550,0,550,0,0,0,0,0,1117,134,35,12,31,16
2020,850600331,8020,20,20,20,0,8000,8000,8000,0,0,0,0,0,0,0,0,0,0,766,118,50,28,60,9
2020,850600371,164980,15780,15780,15780,0,149200,140000,80000,60000,0,9200,2700,500,6000,94667,89667,69667,0,6391,600,120,600,480,246
2020,850600381,28896,8296,8296,8296,0,20600,20000,19000,1000,0,600,600,0,0,13844,13844,13844,0,3724,300,240,420,288,662
2020,850600391,52382,37632,37632,37632,0,14750,14000,14000,0,0,750,450,300,0,0,0,0,0,6950,360,120,600,360,930
2020,850700231,7450,7300,4300,4300,3000,150,0,0,0,0,150,150,0,0,0,0,0,0,2060,400,200,280,120,25
2020,850700241,4775,4775,275,275,4500,0,0,0,0,0,0,0,0,0,0,0,0,0,1153,163,72,70,78,48
2020,850700251,1830,1330,1030,1030,300,500,0,0,0,0,500,500,0,0,1160,1160,960,0,1300,400,10,50,120,9
2020,850700261,9750,3450,3450,3450,0,6300,5000,5000,0,0,1300,1300,0,0,6996,6996,1700,1000,4080,240,150,540,360,62
2020,850700281,40572,7472,7472,4472,0,33100,30000,20000,10000,0,3100,1600,500,1000,2800,2800,2000,0,3780,360,120,240,360,81
2020,850700291,5393,2763,2763,2763,0,2630,0,0,0,0,2630,2500,130,0,560,560,0,0,2048,174,190,250,360,86
2020,850700331,85784,32674,12674,12674,20000,53110,50000,0,50000,0,3110,2310,800,0,5100,5100,5000,0,4088,250,64,520,366,208
2020,850700351,16604,1104,1104,1104,0,15500,13000,13000,0,0,2500,2500,0,0,7000,7000,7000,0,1486,336,150,150,200,6
2020,850700371,3345,155,155,155,0,3190,2970,0,2970,0,220,220,0,0,1000,1000,0,1000,2980,300,50,450,230,62
2020,850700381,32060,11760,11760,11760,0,20300,20000,20000,0,0,300,300,0,0,0,0,0,0,2947,930,85,180,192,71
2020,850800211,5160,3110,3110,3110,0,2050,0,0,0,0,2050,50,2000,0,0,0,0,0,1066,120,6,144,96,36
2020,850800221,248,248,5,5,243,0,0,0,0,0,0,0,0,0,0,0,0,0,764,120,10,36,48,0
2020,850800231,300,300,10,10,290,0,0,0,0,0,0,0,0,0,0,0,0,0,560,120,100,60,20,1
2020,850800261,98938,8338,8338,8338,0,90600,90000,40000,50000,0,600,600,0,0,800,800,0,800,3150,360,450,300,200,70
2020,850800271,95820,14320,14320,14320,0,81500,76800,45000,31800,0,4700,3200,1500,0,8600,7300,0,7300,4300,400,250,600,200,549
2020,850800291,22281,1851,1851,1851,0,20430,20000,20000,0,0,430,430,0,0,9800,9800,9800,0,2851,324,480,120,41,68
2020,850800301,16110,2720,2220,2220,500,13390,0,0,0,0,13390,390,13000,0,4900,4900,4900,0,2099,422,30,360,60,72
2020,850800311,25128,5528,5528,5528,0,19600,17000,17000,0,0,2600,2600,0,0,11800,11800,9800,2000,3150,350,200,400,200,444
2020,850800321,10350,350,350,350,0,10000,10000,10000,0,0,0,0,0,0,0,0,0,0,658,100,100,36,22,15
2020,850800341,18941,461,461,461,0,18480,18000,18000,0,0,480,480,0,0,3560,3560,3560,0,4682,352,400,240,324,43
2020,850800361,88350,18400,18400,13400,0,69950,63000,27000,36000,0,6950,1450,500,5000,20800,20800,11200,9600,6267,600,120,600,240,953
2020,850800381,7520,20,20,20,0,7500,7500,7500,0,0,0,0,0,0,3400,3400,3400,0,886,156,30,60,60,73
2020,850900221,12553,12303,1303,1303,11000,250,0,0,0,0,250,250,0,0,3454,3454,3000,454,3065,370,50,536,215,46
2020,850900251,1050,1050,550,550,500,0,0,0,0,0,0,0,0,0,0,0,0,0,1164,308,36,120,90,1
2020,850900261,730,730,230,230,500,0,0,0,0,0,0,0,0,0,600,600,0,600,2074,480,12,120,90,1
2020,850900271,60660,23660,23660,23660,0,37000,35000,35000,0,0,2000,2000,0,0,0,0,0,0,1717,265,240,120,48,161
2020,850900281,16382,102,102,102,0,16280,13000,13000,0,0,3280,3100,180,0,5600,5600,4000,0,4366,1780,30,240,116,90
2020,850900291,980,980,730,230,250,0,0,0,0,0,0,0,0,0,300,300,300,0,2290,420,100,250,150,1
2020,850900311,35920,3420,3420,3420,0,32500,21000,21000,0,0,11500,11500,0,0,0,0,0,0,7200,500,200,1200,300,2126
2020,850900341,98400,34950,34950,34950,0,63450,63000,28000,35000,0,450,450,0,0,0,0,0,0,3950,200,100,1900,200,919
2020,850900351,20734,614,614,614,0,20120,20000,20000,0,0,120,120,0,0,26059,26059,13734,1825,2960,400,10,300,200,92
2020,850900381,18490,10090,6090,6090,4000,8400,7000,0,7000,0,1400,1400,0,0,6150,2150,0,2150,4300,1000,100,400,300,69
2020,850900391,8506,1906,1906,1906,0,6600,5000,5000,0,0,1600,1600,0,0,0,0,0,0,1420,150,50,100,70,10
2020,851000212,337,145,145,145,0,192,0,0,0,0,192,192,0,0,2100,2100,500,0,1684,180,10,240,144,11
2020,851000232,29000,23600,20600,10600,3000,5400,3000,0,0,3000,2400,2400,0,0,12000,12000,0,2000,2990,400,50,120,120,647
2020,851000242,78390,31920,31920,31920,0,46470,46000,36000,10000,0,470,470,0,0,0,0,0,0,6510,400,100,500,140,1185
2020,851000252,11315,15,15,15,0,11300,11000,11000,0,0,300,300,0,0,3000,3000,3000,0,3520,240,30,240,250,166
2020,851000262,14980,180,180,180,0,14800,11000,11000,0,0,3800,3800,0,0,0,0,0,0,2755,240,36,120,246,483
2020,851000292,108018,54218,13218,13218,41000,53800,50000,0,50000,0,3800,3800,0,0,20000,0,0,0,6536,420,240,360,204,1831
2020,851000302,680,530,30,30,500,150,0,0,0,0,150,150,0,0,0,0,0,0,1710,540,20,100,20,33
2020,851000312,37736,7736,7736,7736,0,30000,29000,12000,17000,0,1000,1000,0,0,11200,1200,0,1200,3960,210,20,350,300,124
2020,851000322,11292,10092,602,602,9490,1200,0,0,0,0,1200,1200,0,0,12650,12650,9000,3350,4430,350,350,1080,300,33
2020,851000342,15105,14925,425,425,14500,180,0,0,0,0,180,0,180,0,11500,11500,11500,0,2438,120,300,120,120,1
2020,851000352,19410,10,10,10,0,19400,19400,5000,14400,0,0,0,0,0,0,0,0,0,271,100,12,12,15,6
2020,851000372,6330,3730,730,730,3000,2600,2000,0,2000,0,600,600,0,0,1700,1700,0,1700,3478,648,30,520,180,48
2020,851000382,9040,40,40,40,0,9000,9000,9000,0,0,0,0,0,0,4000,4000,4000,0,1367,220,60,30,24,8
2020,851000392,104020,8120,8120,7320,0,95900,89000,9000,80000,0,6900,800,6100,0,10100,10100,10000,0,3764,252,20,360,240,96
2020,851600201,48000,3000,3000,3000,0,45000,45000,45000,0,0,0,0,0,0,21516,9516,9516,0,1641,240,144,120,52,69
2020,851600231,31173,6083,6083,6083,0,25090,25000,25000,0,0,90,90,0,0,0,0,0,0,1520,360,400,150,60,41
2020,851600251,2562,1762,1262,1262,500,800,0,0,0,0,800,800,0,0,1000,1000,1000,0,2710,660,0,150,120,1
2020,851600261,44948,4448,4448,3448,0,40500,38000,38000,0,0,2500,2500,0,0,0,0,0,0,3500,300,100,400,100,109
2020,851600291,225,225,25,25,200,0,0,0,0,0,0,0,0,0,0,0,0,0,585,144,150,36,60,0
2020,851600311,26725,4625,4625,4625,0,22100,21000,21000,0,0,1100,1100,0,0,1238,1238,1238,0,2310,430,30,190,130,96
2020,851600331,15660,2560,2560,2560,0,13100,11000,5000,6000,0,2100,800,1300,0,0,0,0,0,1420,150,100,240,180,20
2020,851600341,5030,30,30,30,0,5000,5000,5000,0,0,0,0,0,0,0,0,0,0,538,120,5,10,18,2
2020,851600351,23360,15360,15360,15360,0,8000,6000,6000,0,0,2000,1800,200,0,30,30,0,0,1200,240,150,300,60,14
2020,851600371,27710,1850,1850,1850,0,25860,25500,19000,6500,0,360,360,0,0,2500,1000,1000,0,2320,320,60,280,200,96
2020,851600391,5498,5368,3568,3068,1800,130,0,0,0,0,130,100,30,0,0,0,0,0,3179,324,60,125,260,77
2020,851700231,21760,6560,6560,6560,0,15200,14000,14000,0,0,1200,1200,0,0,8000,8000,7000,1000,2798,290,60,348,300,142
2020,851700261,81007,10007,10007,10007,0,71000,68000,31000,10000,27000,3000,2200,800,0,5100,5100,3300,0,6105,330,90,480,285,589
2020,851700271,19356,17256,3256,3040,14000,2100,0,0,0,0,2100,1800,300,0,150,150,0,0,5150,300,600,200,200,262
2020,851700291,36744,6444,3444,3444,3000,30300,30300,0,30300,0,0,0,0,0,11962,11962,10190,612,3125,350,187,30,300,393
2020,851700301,36793,8543,8543,8543,0,28250,25000,20000,5000,0,3250,1250,2000,0,5577,5577,5577,0,3600,700,100,500,200,92
2020,851700311,25552,14002,14002,14002,0,11550,10000,10000,0,0,1550,1200,350,0,0,0,0,0,3826,740,70,480,96,839
2020,851700331,970,720,420,420,300,250,0,0,0,0,250,250,0,0,100,100,0,100,2630,450,50,350,280,67
2020,851700341,276,116,66,66,50,160,0,0,0,0,160,90,70,0,0,0,0,0,1190,110,60,130,70,19
2020,851700351,56190,23740,23740,23740,0,32450,29000,4000,25000,0,3450,3100,350,0,19240,6240,6240,0,2210,490,140,350,190,131
2020,851700361,49425,13225,13225,1225,0,36200,35000,0,35000,0,1200,1200,0,0,21468,9468,4698,3000,4393,360,280,480,168,85
2020,851700371,10700,2500,2500,2500,0,8200,8000,7000,1000,0,200,0,200,0,0,0,0,0,892,160,240,100,36,9
2020,851700391,35446,7266,7266,7266,0,28180,10500,10000,500,0,17680,9180,0,8500,5500,5500,5500,0,2522,138,10,960,270,204
2020,851800211,31540,2540,2540,2540,0,29000,29000,25000,4000,0,0,0,0,0,200,0,0,0,1514,588,54,48,84,32
2020,851800251,6055,3305,105,105,3200,2750,0,0,0,0,2750,2750,0,0,0,0,0,0,1350,120,20,80,100,147
2020,851800271,98522,26270,26270,24270,0,72252,68000,68000,0,0,4252,3800,452,0,12500,0,0,0,4041,240,60,720,360,169
2020,851800281,32630,9780,9780,5780,0,22850,22000,22000,0,0,850,650,200,0,1750,1750,0,1000,2400,360,100,600,240,580
2020,851800291,107135,18535,18535,18535,0,88600,82000,19000,63000,0,6600,6500,100,0,2000,2000,0,2000,6270,750,100,460,260,1835
2020,851800301,7320,5220,5220,5220,0,2100,1800,0,1800,0,300,0,300,0,0,0,0,0,955,250,90,35,40,7
2020,851800311,3347,3347,2847,2847,500,0,0,0,0,0,0,0,0,0,0,0,0,0,1670,240,40,120,120,1
2020,851800321,1451,1451,891,891,560,0,0,0,0,0,0,0,0,0,1495,1495,0,1280,1976,210,10,120,156,2
2020,851800331,8100,2000,2000,2000,0,6100,6000,6000,0,0,100,100,0,0,0,0,0,0,1188,264,120,180,34,9
2020,851800341,52872,22972,22972,22972,0,29900,27000,10000,17000,0,2900,2900,0,0,500,0,0,0,7360,540,480,600,360,1838
2020,851800351,6904,6624,5424,5424,1200,280,0,0,0,0,280,280,0,0,0,0,0,0,1272,300,10,60,150,18
2020,851800361,114180,22980,22980,17980,0,91200,89000,12000,77000,0,2200,2200,0,0,32180,32180,29000,2600,5620,360,600,1200,300,145
2020,851800371,32620,18120,18120,18120,0,14500,13500,4500,9000,0,1000,1000,0,0,0,0,0,0,2710,240,300,480,180,441
2020,851800391,8125,5125,2125,2125,3000,3000,0,0,0,0,3000,3000,0,0,1600,1600,1600,0,2690,240,50,300,200,263
2020,851900201,10984,2984,2984,2984,0,8000,8000,4000,4000,0,0,0,0,0,2000,500,0,500,1342,120,60,72,120,10
2020,851900221,43850,350,350,350,0,43500,43500,21000,22500,0,0,0,0,0,10000,10000,10000,0,1510,360,60,96,84,50
2020,851900231,12385,260,260,260,0,12125,12000,12000,0,0,125,0,125,0,0,0,0,0,2118,300,1500,60,48,9
2020,851900241,43080,630,630,630,0,42450,42000,19000,23000,0,450,450,0,0,8400,8300,8300,0,2160,360,300,240,120,48
2020,851900271,20020,20,20,20,0,20000,20000,20000,0,0,0,0,0,0,7000,7000,7000,0,665,156,60,48,36,11
2020,851900281,66890,17690,1690,1690,16000,49200,43000,0,43000,0,6200,6200,0,0,0,0,0,0,3346,240,120,240,126,54
2020,851900291,26180,430,430,430,0,25750,25000,25000,0,0,750,750,0,0,13000,13000,13000,0,2946,360,500,200,270,368
2020,851900301,25942,5803,5803,5803,0,20139,16000,6000,10000,0,4139,3800,339,0,0,0,0,0,3223,220,18,400,180,165
2020,851900311,11500,1500,1500,1500,0,10000,10000,10000,0,0,0,0,0,0,6000,6000,6000,0,820,240,50,80,50,22
2020,851900321,3720,220,220,220,0,3500,3500,3500,0,0,0,0,0,0,0,0,0,0,580,150,50,30,25,2
2020,851900341,20024,18024,14024,9024,4000,2000,0,0,0,0,2000,1000,1000,0,0,0,0,0,1400,120,10,180,120,37
2020,851900351,2400,2200,1750,1750,450,200,0,0,0,0,200,200,0,0,0,0,0,0,800,160,50,100,60,55
2020,851900361,18232,5780,5780,5780,0,12452,12000,11000,1000,0,452,0,452,0,4680,4680,4680,0,2490,240,30,360,240,25
2020,851900371,1680,380,380,380,0,1300,1200,1200,0,0,100,100,0,0,3000,3000,0,0,2930,350,10,250,250,26
2020,851900381,210,210,110,110,100,0,0,0,0,0,0,0,0,0,0,0,0,0,538,180,3,20,20,0
2020,851900391,24035,1085,1085,1085,0,22950,21000,3000,18000,0,1950,1500,450,0,13000,13000,10000,2000,2178,404,750,240,120,56
2020,852000202,179370,18520,18520,18520,0,160850,160000,70000,90000,0,850,600,250,0,30000,0,0,0,3990,600,100,420,360,2179
2020,852000212,22500,16700,4700,1200,12000,5800,4000,0,0,4000,1800,1800,0,0,9000,9000,9000,0,2290,180,10,300,100,28
2020,852000222,113650,26050,50,50,26000,87600,85000,0,85000,0,2600,1800,100,700,53900,8900,6000,2900,3780,450,50,360,220,88
2020,852000232,74660,1660,1660,1660,0,73000,68000,68000,0,0,5000,5000,0,0,7000,7000,7000,0,4360,240,60,780,240,98
2020,852000242,139292,44192,25192,25192,19000,95100,95000,0,95000,0,100,100,0,0,28716,5716,5716,0,2426,396,130,300,120,372
2020,852000252,4960,4660,4660,4660,0,300,0,0,0,0,300,300,0,0,0,0,0,0,1822,72,10,360,60,283
2020,852000262,56196,4666,4666,3166,0,51530,50500,50500,0,0,1030,880,150,0,18600,18600,18600,0,4200,360,100,960,240,312
2020,852000282,72335,1335,1335,1335,0,71000,67000,45000,0,22000,4000,4000,0,0,26200,26200,15000,11200,5750,360,400,360,180,492
2020,852000292,42766,2516,2516,2516,0,40250,39000,39000,0,0,1250,1250,0,0,5600,5600,5600,0,2150,264,100,250,156,1023
2020,852000302,4120,4120,120,120,4000,0,0,0,0,0,0,0,0,0,0,0,0,0,685,250,30,100,15,1
2020,852000312,28420,8020,8020,8020,0,20400,20000,20000,0,0,400,400,0,0,0,0,0,0,1908,480,20,180,108,85
2020,852000322,62300,10500,10500,10500,0,51800,48500,41500,7000,0,3300,1100,2200,0,0,0,0,0,3460,540,120,180,120,204
2020,852000332,29802,8376,8376,7876,0,21426,18000,2000,16000,0,3426,2850,576,0,5000,5000,0,0,3538,162,1200,360,216,82
2020,852000342,13051,1051,1051,1051,0,12000,12000,12000,0,0,0,0,0,0,300,300,0,300,2440,320,60,150,240,18
2020,852000362,10,10,10,10,0,0,0,0,0,0,0,0,0,0,0,0,0,0,794,242,50,24,30,0
2020,852000372,2180,180,180,180,0,2000,1900,1700,200,0,100,0,100,0,0,0,0,0,1058,150,200,30,18,4
2020,852000382,47954,10954,10954,10954,0,37000,32000,20000,12000,0,5000,0,5000,0,0,0,0,0,1510,284,60,24,72,32
2020,852600211,64020,12020,12020,12020,0,52000,50000,50000,0,0,2000,2000,0,0,12500,12500,12500,0,3748,220,100,300,158,942
2020,852600231,40000,700,700,700,0,39300,36000,28000,8000,0,3300,3300,0,0,0,0,0,0,1212,300,42,370,50,67
2020,852600241,24773,2878,2878,2784,0,21895,18095,11000,0,7095,3800,3500,300,0,15400,15400,3467,7933,2614,240,24,180,150,212
2020,852600261,33538,2870,2870,2870,0,30668,28600,23000,0,5600,2068,2068,0,0,385,85,0,0,3058,120,10,600,240,93
2020,852600281,19870,1770,1770,1770,0,18100,18000,18000,0,0,100,100,0,0,60,60,0,0,2770,360,20,120,120,35
2020,852600291,11113,6793,3793,3793,3000,4320,2920,0,0,2920,1400,1200,200,0,1000,1000,0,0,2394,120,10,300,264,42
2020,852600301,13176,1061,1061,1061,0,12115,12000,12000,0,0,115,0,115,0,0,0,0,0,557,216,20,10,20,18
2020,852600311,3866,66,66,66,0,3800,3200,3200,0,0,600,600,0,0,0,0,0,0,1150,140,360,100,40,8
2020,852600331,18020,1080,280,280,800,16940,14000,0,14000,0,2940,2940,0,0,2540,2540,0,540,1430,150,40,200,70,52
2020,852600341,46556,25456,25456,25456,0,21100,18000,5000,13000,0,3100,3100,0,0,11108,11108,11108,0,5890,880,800,360,300,1010
2020,852600361,8100,600,600,600,0,7500,7500,7500,0,0,0,0,0,0,0,0,0,0,355,100,80,15,30,6
2020,852700211,650,650,150,150,500,0,0,0,0,0,0,0,0,0,0,0,0,0,1614,480,10,84,120,31
2020,852700221,118182,6382,6382,6382,0,111800,111500,87000,24500,0,300,300,0,0,2050,2050,0,2000,3404,276,1000,360,108,223
2020,852700231,101530,60830,60830,53830,0,40700,32000,32000,0,0,8700,5200,3500,0,0,0,0,0,5639,300,10,720,144,1210
2020,852700251,114900,47600,47600,47600,0,67300,66000,40000,26000,0,1300,1300,0,0,0,0,0,0,3820,480,240,360,180,2579
2020,852700311,52492,1742,1742,1742,0,50750,50000,5000,45000,0,750,550,200,0,0,0,0,0,1510,300,300,180,70,81
2020,852700321,24050,7950,7950,7950,0,16100,12000,12000,0,0,4100,3900,200,0,2900,2900,0,0,3975,225,300,500,300,528
2020,852700331,12509,9709,5109,5109,4600,2800,0,0,0,0,2800,2800,0,0,4016,4016,1300,800,1972,462,150,300,130,44
2020,852700351,15145,3700,3700,3700,0,11445,8000,3000,5000,0,3445,3245,200,0,0,0,0,0,2224,372,180,420,142,61
2020,852700361,1720,1520,1520,1520,0,200,0,0,0,0,200,200,0,0,0,0,0,0,1901,164,360,240,132,45
2020,852800211,27543,4463,4463,4463,0,23080,23000,23000,0,0,80,80,0,0,200,200,0,0,1463,446,150,300,77,37
2020,852800231,68864,9364,9364,3364,0,59500,48000,43000,0,5000,11500,11500,0,0,41911,41911,19711,1200,7800,240,200,600,360,105
2020,852800261,168400,87300,87300,75300,0,81100,60000,60000,0,0,21100,2000,11100,8000,0,0,0,0,4820,300,200,480,240,5262
2020,852800281,17540,9460,3460,2960,6000,8080,0,0,0,0,8080,1700,4880,1500,4530,4530,0,4400,1442,127,10,300,240,212
2020,852800311,29060,760,760,760,0,28300,25100,5100,20000,0,3200,2300,900,0,10000,0,0,0,1810,120,40,180,160,57
2020,852800321,28777,4777,4777,4777,0,24000,24000,14000,10000,0,0,0,0,0,13600,13600,13100,500,2510,204,300,100,276,29
2020,852800331,2080,80,80,80,0,2000,2000,0,2000,0,0,0,0,0,0,0,0,0,487,144,72,36,42,2
2020,852800341,2300,2300,300,300,2000,0,0,0,0,0,0,0,0,0,0,0,0,0,604,270,150,10,24,1
2020,852800361,14900,720,720,720,0,14180,14000,11000,3000,0,180,0,180,0,0,0,0,0,1426,200,720,12,60,17
2020,852900241,72950,150,150,150,0,72800,72000,49000,23000,0,800,800,0,0,8026,4026,3850,0,5775,300,150,480,240,689
2020,852900251,370,370,370,370,0,0,0,0,0,0,0,0,0,0,0,0,0,0,689,150,35,24,50,0
2020,852900261,31494,7494,7494,7494,0,24000,24000,24000,0,0,0,0,0,0,16160,16160,16000,0,2280,600,10,120,120,313
2020,852900271,96884,21084,12084,12084,9000,75800,75000,0,75000,0,800,800,0,0,18800,800,800,0,4504,240,300,220,144,489
2020,852900291,100780,15280,15280,15280,0,85500,80000,80000,0,0,5500,5000,500,0,14300,14300,14300,0,3472,300,30,360,192,625
2020,852900311,16024,124,124,124,0,15900,15700,3700,12000,0,200,200,0,0,6000,6000,0,6000,3090,500,80,120,600,37
2020,852900321,89210,8760,8760,8760,0,80450,38300,6800,31500,0,42150,4000,38150,0,30000,30000,30000,0,4760,240,150,1200,180,60
2020,852900331,10322,3460,3460,3160,0,6862,6800,6800,0,0,62,62,0,0,5100,5100,5100,0,1900,140,200,210,240,507
2020,852900341,62556,8306,8306,8306,0,54250,52800,4800,48000,0,1450,1450,0,0,13000,0,0,0,2136,180,10,360,156,109
2020,852900351,10150,150,150,150,0,10000,10000,10000,0,0,0,0,0,0,0,0,0,0,420,70,50,30,25,4
2020,852900361,40130,3800,3800,3800,0,36330,33000,18000,15000,0,3330,1300,2030,0,0,0,0,0,1180,180,80,280,80,48
2020,853000212,5300,1600,1600,100,0,3700,0,0,0,0,3700,1700,0,2000,2000,2000,0,0,3533,257,350,102,480,812
2020,853000222,290,290,290,290,0,0,0,0,0,0,0,0,0,0,3000,3000,0,3000,846,120,10,36,120,2
2020,853600201,21642,2192,2192,2192,0,19450,19000,19000,0,0,450,450,0,0,1600,1600,1600,0,1195,312,20,36,108,29
2020,853900211,33660,8560,8560,8560,0,25100,24000,24000,0,0,1100,1100,0,0,3820,3820,3000,820,4074,204,1550,420,260,83
2020,860000202,1648,1398,898,898,500,250,0,0,0,0,250,250,0,0,300,300,0,0,1820,600,50,200,80,95
2020,860000212,23170,8170,8170,8170,0,15000,15000,15000,0,0,0,0,0,0,0,0,0,0,2232,516,100,30,156,36
2020,860000232,58145,20045,20045,15045,0,38100,37000,37000,0,0,1100,800,300,0,0,0,0,0,3034,360,150,180,144,226
2020,860000252,301,301,1,1,300,0,0,0,0,0,0,0,0,0,0,0,0,0,997,528,5,10,84,3
2020,860000262,143647,7037,7037,7037,0,136610,135000,55000,80000,0,1610,800,810,0,36023,32023,31700,0,5532,732,530,500,420,1711
2020,860000272,59670,4470,4470,4300,0,55200,55000,55000,0,0,200,200,0,0,10100,10100,10100,0,2793,295,130,246,198,505
2020,860000282,30280,15480,1480,1480,14000,14800,13000,0,0,13000,1800,1800,0,0,12600,12600,12600,0,5580,300,1500,400,360,276
2020,860000292,40417,5337,5337,5337,0,35080,35000,35000,0,0,80,0,80,0,0,0,0,0,1112,360,300,16,36,24
2020,860000302,25038,12588,12588,11588,0,12450,10000,10000,0,0,2450,1150,1300,0,1000,1000,0,1000,4483,252,240,480,360,80
2020,860000322,13710,6150,6150,6150,0,7560,7500,7000,500,0,60,0,60,0,0,0,0,0,1986,156,1360,50,36,6
2020,860000332,12864,864,864,864,0,12000,12000,12000,0,0,0,0,0,0,500,0,0,0,920,101,138,12,52,7
2020,860000352,28050,550,550,550,0,27500,25000,25000,0,0,2500,2500,0,0,8494,7894,7800,0,1758,190,100,360,72,125
2020,860000362,34578,20478,20478,20478,0,14100,11000,11000,0,0,3100,2800,300,0,249,249,0,0,4488,276,1150,530,102,275
2020,860000372,54680,5180,5180,5180,0,49500,47000,27000,20000,0,2500,2500,0,0,24669,14669,14669,0,1776,188,10,120,120,958
2020,860000382,109834,35008,25008,25008,10000,74826,70000,0,70000,0,4826,2600,2226,0,500,0,0,0,6170,480,60,480,300,3570
2020,860000392,988,988,988,988,0,0,0,0,0,0,0,0,0,0,0,0,0,0,292,24,75,10,20,1
2020,860600201,760,760,60,60,700,0,0,0,0,0,0,0,0,0,20,20,0,0,1311,420,40,10,66,4
2020,860600211,49674,5174,5174,5174,0,44500,42000,42000,0,0,2500,2400,100,0,7340,7340,7340,0,4865,286,120,120,132,879
2020,860600221,50160,6860,6860,6860,0,43300,40000,40000,0,0,3300,3300,0,0,7900,7900,7900,0,3142,240,60,240,360,624
2020,860600241,110,110,10,10,100,0,0,0,0,0,0,0,0,0,0,0,0,0,563,180,30,18,15,3
2020,860600251,83630,9030,9030,9030,0,74600,74000,74000,0,0,600,600,0,0,20400,20400,15400,5000,6980,300,500,500,180,1288
2020,860600261,25330,23390,18390,18390,5000,1940,0,0,0,0,1940,1340,600,0,2400,2400,0,2400,6210,1920,150,600,300,137
2020,860600281,80806,17306,17306,17306,0,63500,55000,55000,0,0,8500,8100,400,0,34000,24000,24000,0,5240,450,100,450,320,2074
2020,860600291,36064,11828,11828,11828,0,24236,23000,23000,0,0,1236,1010,226,0,0,0,0,0,3042,312,40,240,300,380
2020,860600301,20300,10300,10300,10300,0,10000,10000,10000,0,0,0,0,0,0,0,0,0,0,1072,288,600,10,44,14
2020,860600311,2910,1410,1410,1410,0,1500,0,0,0,0,1500,1500,0,0,100,100,0,0,947,135,144,200,54,61
2020,860600331,4350,4350,150,150,4200,0,0,0,0,0,0,0,0,0,0,0,0,0,870,180,20,90,60,11
2020,860600351,15102,602,602,602,0,14500,14500,6000,8500,0,0,0,0,0,8200,8200,1200,2000,564,160,50,60,24,10
2020,860600361,3880,880,880,880,0,3000,3000,3000,0,0,0,0,0,0,0,0,0,0,769,120,90,30,48,2
2020,860600371,17418,4468,4468,4468,0,12950,11300,11300,0,0,1650,1650,0,0,0,0,0,0,726,78,10,70,100,14
2020,860600381,11868,2200,2200,2200,0,9668,9600,9000,600,0,68,0,68,0,45,45,0,0,1043,181,320,50,34,24
2020,860600391,39646,6394,6394,6394,0,33252,32000,32000,0,0,1252,900,352,0,18366,18366,14306,4000,3416,261,35,210,203,498
2020,860700221,537,537,37,37,500,0,0,0,0,0,0,0,0,0,0,0,0,0,706,320,180,36,42,1
2020,860700231,58323,13915,13915,13915,0,44408,42000,42000,0,0,2408,1700,708,0,0,0,0,0,4940,360,50,480,300,257
2020,860700241,31282,12252,6252,6252,6000,19030,18000,0,18000,0,1030,950,80,0,12000,0,0,0,2500,150,120,250,200,498
2020,860700251,25266,9566,9566,9566,0,15700,14700,13000,1700,0,1000,1000,0,0,0,0,0,0,4350,440,100,480,300,1724
2020,860700271,53841,10841,10841,10841,0,43000,41000,24000,17000,0,2000,2000,0,0,8000,0,0,0,1670,200,200,200,100,118
2020,860700281,40324,15974,15974,15974,0,24350,22000,22000,0,0,2350,2100,250,0,0,0,0,0,3510,250,50,280,180,1317
2020,860700291,21005,5,5,5,0,21000,21000,21000,0,0,0,0,0,0,0,0,0,0,617,186,65,20,26,16
2020,860700301,8030,30,30,30,0,8000,8000,8000,0,0,0,0,0,0,0,0,0,0,537,300,60,10,3,3
2020,860700321,3971,3971,771,771,3200,0,0,0,0,0,0,0,0,0,3200,3200,3200,0,2093,378,70,80,258,1
2020,860700331,23070,1130,1130,1130,0,21940,21000,21000,0,0,940,940,0,0,500,500,0,500,4240,300,200,300,480,479
2020,860700351,9630,130,130,130,0,9500,9500,9500,0,0,0,0,0,0,0,0,0,0,811,120,60,20,36,19
2020,860700361,61144,11444,11444,11444,0,49700,49000,16000,33000,0,700,700,0,0,11300,11100,11000,100,6602,558,1312,360,360,630
2020,860700371,44052,4602,4602,4602,0,39450,38000,38000,0,0,1450,750,700,0,0,0,0,0,2710,260,80,250,180,85
2020,860700391,10362,1362,1362,1362,0,9000,9000,9000,0,0,0,0,0,0,0,0,0,0,486,174,10,6,30,10
2020,860800201,2130,2130,130,130,2000,0,0,0,0,0,0,0,0,0,0,0,0,0,1888,120,800,70,48,4
2020,860800211,28841,2041,2041,2041,0,26800,23000,23000,0,0,3800,3800,0,0,10925,10925,7525,0,3060,250,70,240,120,378
2020,860800221,152720,75200,75200,75200,0,77520,77000,65000,12000,0,520,0,520,0,800,0,0,0,1448,228,100,120,60,93
2020,860800241,4360,2360,1860,1860,500,2000,2000,0,2000,0,0,0,0,0,0,0,0,0,1336,450,100,120,96,3
2020,860800261,20214,3764,3764,3764,0,16450,16000,16000,0,0,450,450,0,0,8000,8000,5000,3000,1490,100,50,300,120,170
2020,860800271,40276,11176,11176,11176,0,29100,26000,26000,0,0,3100,3100,0,0,9500,9500,9500,0,4910,300,250,780,300,380
2020,860800291,72934,6434,6434,6104,0,66500,62000,33000,29000,0,4500,200,300,4000,9500,7000,7000,0,4480,300,30,400,230,80
2020,860800301,10100,100,100,100,0,10000,10000,10000,0,0,0,0,0,0,500,500,0,500,1314,704,72,36,72,8
2020,860800311,24020,1920,1920,1920,0,22100,22000,11000,11000,0,100,100,0,0,118,118,0,0,1619,216,600,120,84,45
2020,860800321,282968,25668,25668,23168,0,257300,254000,30000,209000,15000,3300,3300,0,0,77970,68970,68440,300,3650,760,10,600,300,672
2020,860800351,11230,230,230,230,0,11000,11000,3500,7500,0,0,0,0,0,0,0,0,0,1550,180,200,60,200,23
2020,860800361,9810,1110,1110,1110,0,8700,8500,6000,2500,0,200,200,0,0,0,0,0,0,977,112,190,120,36,31
2020,860800371,29505,4405,4405,4405,0,25100,25000,15000,10000,0,100,100,0,0,2100,2100,0,1000,4932,312,180,160,720,154
2020,860800391,75320,33320,33320,32820,0,42000,23000,23000,0,0,19000,17500,1500,0,13140,13140,9050,1590,4724,340,1000,760,180,266
2020,860900221,82510,11610,11610,8610,0,70900,49000,49000,0,0,21900,4900,10000,7000,9650,9650,0,9600,4293,420,80,124,430,146
2020,860900231,62360,15360,15360,15360,0,47000,38000,18000,20000,0,9000,8800,200,0,5000,0,0,0,4430,300,100,720,180,3641
2020,860900241,37350,16700,16700,16700,0,20650,18000,0,18000,0,2650,2550,100,0,0,0,0,0,3210,420,50,600,240,429
2020,860900251,25050,4180,4180,4180,0,20870,20000,20000,0,0,870,870,0,0,0,0,0,0,1852,192,400,300,60,51
2020,860900261,1160,1160,860,860,300,0,0,0,0,0,0,0,0,0,0,0,0,0,1872,280,246,216,60,1
2020,860900271,46252,14752,14752,9752,0,31500,28000,28000,0,0,3500,3100,400,0,0,0,0,0,3200,400,200,300,100,200
2020,860900291,20431,19031,2031,1531,17000,1400,0,0,0,0,1400,700,0,700,15620,15620,15400,0,1571,243,20,240,228,190
2020,860900321,55900,1200,1200,1200,0,54700,51750,45000,6750,0,2950,2950,0,0,0,0,0,0,3470,800,300,500,120,1199
2020,860900361,33694,2881,2881,2881,0,30813,28000,28000,0,0,2813,2700,113,0,4000,4000,4000,0,1724,180,24,240,144,238
2020,860900371,80103,19168,19168,19168,0,60935,56000,31000,25000,0,4935,4750,185,0,25150,10150,8500,1500,3313,216,300,520,84,1558
2020,860900381,51628,11248,11248,11248,0,40380,38900,12500,26400,0,1480,1300,180,0,3000,0,0,0,1051,108,70,96,48,25
2020,860900391,8639,2579,2579,2579,0,6060,4000,4000,0,0,2060,1900,160,0,1800,1800,0,1500,1545,200,380,240,150,6
2020,861000202,35610,250,250,250,0,35360,35000,35000,0,0,360,360,0,0,0,0,0,0,1110,200,10,150,70,57
2020,861000212,23350,20500,1500,1500,19000,2850,0,0,0,0,2850,2800,50,0,9200,9200,9000,0,3330,184,300,192,264,529
2020,861000222,4004,4,4,4,0,4000,4000,4000,0,0,0,0,0,0,1820,1820,1440,0,980,80,70,10,20,6
2020,861000232,155,55,55,55,0,100,0,0,0,0,100,0,100,0,0,0,0,0,1870,160,130,200,130,2
2020,861000252,32660,19660,19660,19660,0,13000,9800,9800,0,0,3200,3200,0,0,360,360,0,0,3143,192,30,90,342,1208
2020,861000262,200,200,150,150,50,0,0,0,0,0,0,0,0,0,0,0,0,0,2338,468,20,120,120,55
2020,861000272,16864,5364,5164,4164,200,11500,11000,0,11000,0,500,500,0,0,7200,7200,6000,1200,1381,390,20,240,60,176
2020,861000282,20100,100,100,100,0,20000,20000,20000,0,0,0,0,0,0,0,0,0,0,292,60,36,24,16,11
2020,861000302,9581,2540,2540,2540,0,7041,7000,7000,0,0,41,0,41,0,0,0,0,0,1420,170,200,96,53,9
2020,861000312,18831,9248,9248,9248,0,9583,7000,7000,0,0,2583,2500,83,0,1448,1448,500,0,2201,216,20,180,120,272
2020,861000322,3511,11,11,11,0,3500,3500,3500,0,0,0,0,0,0,0,0,0,0,876,295,240,21,16,5
2020,861000332,40667,2127,2127,2127,0,38540,38200,22100,16100,0,340,340,0,0,7542,7542,7542,0,1970,276,36,276,96,535
2020,861000342,25740,17540,2590,2590,14950,8200,5000,0,5000,0,3200,3200,0,0,30,30,0,0,3986,392,24,240,240,130
2020,861000352,27869,22130,7180,7180,14950,5739,2500,0,2500,0,3239,600,2339,300,4800,4800,4800,0,4052,216,400,280,240,419
2020,861000362,11396,4396,4396,4396,0,7000,7000,7000,0,0,0,0,0,0,0,0,0,0,1225,120,240,96,24,6
2020,861000372,7380,550,550,550,0,6830,630,0,630,0,6200,1700,4500,0,1300,1300,0,0,762,86,50,80,96,11
2020,861000382,70834,3134,3134,3134,0,67700,22400,8400,14000,0,45300,1300,44000,0,0,0,0,0,1806,460,180,240,130,57
2020,861000392,8242,892,892,892,0,7350,6930,6630,300,0,420,400,20,0,150,150,0,0,1033,186,45,248,31,38
2020,861600201,84720,12450,12450,12450,0,72270,69000,29000,40000,0,3270,3270,0,0,44100,36100,36000,0,2220,480,100,500,170,138
2020,861600221,3209,2459,1959,1959,500,750,0,0,0,0,750,750,0,0,680,680,0,0,2680,480,20,600,180,61
2020,861600231,100,100,100,100,0,0,0,0,0,0,0,0,0,0,0,0,0,0,441,50,120,15,6,0
2020,861600241,174200,23200,23200,23200,0,151000,150000,40000,110000,0,1000,1000,0,0,4500,0,0,0,2160,380,450,360,240,986
2020,861600251,36862,19462,19462,19462,0,17400,14000,14000,0,0,3400,3400,0,0,0,0,0,0,1211,120,200,144,120,269
2020,861600271,440,440,240,40,200,0,0,0,0,0,0,0,0,0,4000,4000,0,0,2543,590,10,180,195,1
2020,861600301,41847,8532,8532,8532,0,33315,32000,32000,0,0,1315,1200,115,0,756,756,600,0,5900,268,36,372,363,1210
2020,861600311,55687,20004,20004,20004,0,35683,32000,32000,0,0,3683,3570,113,0,0,0,0,0,5351,288,20,515,144,1016
2020,861600321,52563,4363,4363,4363,0,48200,45000,25000,20000,0,3200,3200,0,0,8200,8200,7900,300,3425,400,50,310,300,102
2020,861600331,200780,17380,17380,17380,0,183400,180000,45000,135000,0,3400,3400,0,0,53400,0,0,0,5867,420,1000,240,120,381
2020,861600341,25306,9860,9860,9860,0,15446,15000,15000,0,0,446,250,196,0,0,0,0,0,1601,240,10,100,153,44
2020,861600361,21525,728,728,728,0,20797,16100,5500,10600,0,4697,497,4200,0,100,100,0,0,1686,162,180,144,66,72
2020,861600371,7155,5135,5135,5135,0,2020,2000,2000,0,0,20,0,20,0,0,0,0,0,982,90,477,95,24,3
2020,861700201,52905,6605,6605,6605,0,46300,46000,23000,23000,0,300,200,100,0,0,0,0,0,3182,252,400,360,240,409
2020,861700231,30320,12170,12170,12170,0,18150,17000,12000,5000,0,1150,1150,0,0,2000,2000,0,2000,1700,200,300,300,200,53
2020,861700251,2340,2340,1380,1380,960,0,0,0,0,0,0,0,0,0,1200,1200,1200,0,919,144,100,15,120,1
2020,861700261,1030,1030,50,50,980,0,0,0,0,0,0,0,0,0,0,0,0,0,615,156,60,15,24,13
2020,861700271,34047,21427,21427,21427,0,12620,12000,12000,0,0,620,550,70,0,0,0,0,0,1086,240,0,120,96,92
2020,861700281,10165,55,55,55,0,10110,10000,10000,0,0,110,0,110,0,4300,4300,4300,0,1181,120,45,56,90,13
2020,861700301,18015,7902,7902,7902,0,10113,9000,9000,0,0,1113,1000,113,0,0,0,0,0,1880,162,300,240,180,135
2020,861700321,45970,14670,14670,14670,0,31300,31000,16000,15000,0,300,250,50,0,14000,14000,10000,4000,3860,240,64,390,150,241
2020,861700331,8674,7174,3074,3074,4100,1500,0,0,0,0,1500,1500,0,0,2204,2204,1120,0,3110,240,120,240,360,269
2020,861700351,39149,13796,13796,13796,0,25353,24200,11000,13200,0,1153,250,903,0,0,0,0,0,1364,52,360,270,71,20
2020,861700361,28526,5262,5262,5262,0,23264,22000,8500,13500,0,1264,0,1264,0,0,0,0,0,785,94,56,108,36,12
2020,861700381,86864,9150,9150,9150,0,77714,37950,6000,31950,0,39764,500,39264,0,8500,8500,8400,20,2310,130,20,200,150,88
2020,861700391,98543,1113,1113,1113,0,97430,96000,50000,46000,0,1430,1350,80,0,42205,40205,24105,2000,2858,625,198,340,280,235
2020,861800201,11730,11680,6680,6680,5000,50,0,0,0,0,50,0,50,0,0,0,0,0,1560,90,450,40,120,5
2020,861800211,16453,16253,3253,3253,13000,200,0,0,0,0,200,200,0,0,10400,10400,10000,400,2140,300,150,60,150,149
2020,861800231,25948,6681,6681,3581,0,19267,15000,10000,5000,0,4267,1267,0,3000,9150,9150,7000,2150,2758,240,32,480,420,148
2020,861800241,500,500,500,500,0,0,0,0,0,0,0,0,0,0,0,0,0,0,570,180,120,10,15,1
2020,861800251,3600,1200,700,500,500,2400,0,0,0,0,2400,2400,0,0,0,0,0,0,3160,720,120,360,300,36
2020,861800261,27080,8930,8930,8930,0,18150,17000,17000,0,0,1150,650,500,0,0,0,0,0,1731,280,60,100,96,69
2020,861800271,43337,35437,19437,15237,16000,7900,7200,0,0,7200,700,700,0,0,8000,8000,8000,0,4050,400,50,350,300,807
2020,861800301,24413,7300,3300,3300,4000,17113,17000,0,17000,0,113,0,113,0,500,0,0,0,914,180,120,120,24,9
2020,861800311,4442,2262,2262,2262,0,2180,0,0,0,0,2180,2000,180,0,0,0,0,0,1839,804,123,141,126,15
2020,861800321,35000,10000,10000,10000,0,25000,25000,25000,0,0,0,0,0,0,0,0,0,0,2544,234,600,60,120,32
2020,861800331,2519,2169,769,769,1400,350,0,0,0,0,350,350,0,0,0,0,0,0,1082,204,120,230,48,42
2020,861800341,11851,596,596,596,0,11255,11000,11000,0,0,255,200,55,0,0,0,0,0,491,180,40,84,20,11
2020,861800351,8546,3510,3510,3510,0,5036,4076,4076,0,0,960,800,160,0,0,0,0,0,1644,240,84,360,360,43
2020,861800361,90227,31745,31745,31375,0,58482,46000,28000,18000,0,12482,5482,4000,3000,9320,9320,4500,4300,3888,314,228,432,264,267
2020,861800371,30722,19322,19322,19322,0,11400,10100,10100,0,0,1300,1300,0,0,84,84,0,0,2353,200,50,240,363,460
2020,861800391,4602,669,669,669,0,3933,0,0,0,0,3933,3900,33,0,3160,3160,0,200,1467,364,60,240,360,112
2020,861900201,2000,1800,100,100,1700,200,0,0,0,0,200,200,0,0,0,0,0,0,680,200,70,70,60,32
2020,861900211,5286,3306,2806,1806,500,1980,0,0,0,0,1980,730,250,1000,3000,3000,0,3000,3148,1608,40,150,230,17
2020,861900221,11356,2156,2156,2156,0,9200,9200,9200,0,0,0,0,0,0,190,190,0,0,1740,120,120,100,190,15
2020,861900241,24600,6600,6600,6600,0,18000,18000,18000,0,0,0,0,0,0,0,0,0,0,1460,240,600,30,36,42
2020,861900251,4020,4020,20,20,4000,0,0,0,0,0,0,0,0,0,0,0,0,0,482,120,120,12,20,1
2020,861900261,1216,1016,1016,1016,0,200,0,0,0,0,200,200,0,0,800,800,0,0,1870,480,10,80,150,13
2020,861900281,45800,11950,11950,11950,0,33850,33000,33000,0,0,850,550,300,0,9060,9060,9000,0,4206,360,120,620,240,187
2020,861900311,14124,3124,3124,3124,0,11000,11000,11000,0,0,0,0,0,0,0,0,0,0,583,69,180,19,37,15
2020,861900321,37,37,37,37,0,0,0,0,0,0,0,0,0,0,0,0,0,0,507,116,120,16,26,1
2020,861900331,30385,15985,15985,15985,0,14400,14400,5000,9400,0,0,0,0,0,0,0,0,0,594,52,74,96,24,51
2020,861900341,29106,6430,6430,930,0,22676,21000,18000,3000,0,1676,1450,226,0,12670,12670,11020,0,4402,324,600,240,240,120
2020,861900361,36860,2060,2060,2060,0,34800,34500,1500,33000,0,300,300,0,0,5550,3550,3550,0,1131,124,50,300,38,42
2020,861900371,4920,4282,4282,4282,0,638,0,0,0,0,638,550,88,0,0,0,0,0,1536,180,254,330,150,27
2020,861900391,44600,5400,5400,5400,0,39200,35500,0,35500,0,3700,3700,0,0,1330,30,0,0,677,70,20,200,60,117
2020,862000302,2926,426,426,426,0,2500,2500,2000,500,0,0,0,0,0,0,0,0,0,426,65,120,30,11,2
2020,862000312,4685,2285,2285,2285,0,2400,2400,2000,400,0,0,0,0,0,0,0,0,0,295,32,30,15,48,2
2020,862000322,9708,2008,2008,2008,0,7700,7400,6000,0,1400,300,300,0,0,0,0,0,0,1567,101,150,120,156,40
2020,862000332,3910,510,510,510,0,3400,3400,2500,900,0,0,0,0,0,0,0,0,0,932,160,30,24,48,2
2020,862000342,17582,2652,2652,2652,0,14930,14400,2400,12000,0,530,480,50,0,0,0,0,0,1233,181,30,34,56,59
2020,862000352,1783,583,583,583,0,1200,500,500,0,0,700,700,0,0,300,300,0,300,866,252,24,120,40,6
2020,862000362,4600,1000,1000,1000,0,3600,3600,700,2900,0,0,0,0,0,0,0,0,0,779,92,180,93,24,14
2020,862000372,29340,240,240,240,0,29100,29000,20000,9000,0,100,0,100,0,11000,11000,10000,1000,770,97,20,10,3,4
2020,862600301,2600,1259,1259,1259,0,1341,1250,1250,0,0,91,0,91,0,0,0,0,0,785,96,120,45,54,3
2020,862600321,6526,58,58,58,0,6468,6400,1200,5200,0,68,0,68,0,0,0,0,0,762,76,365,30,36,5
2020,862600341,550,250,250,250,0,300,0,0,0,0,300,300,0,0,0,0,0,0,486,60,20,72,36,1
2020,862600351,31050,11700,11700,11700,0,19350,18200,8000,10200,0,1150,1150,0,0,1800,1800,0,1800,2225,180,150,400,220,57
2020,862700301,33359,9659,9659,9659,0,23700,15800,7000,8800,0,7900,700,7200,0,500,500,0,0,1402,142,70,130,110,11
2020,862700311,6500,600,600,600,0,5900,5900,5000,900,0,0,0,0,0,0,0,0,0,312,52,48,15,20,4
2020,862700321,2060,310,310,310,0,1750,1750,1000,750,0,0,0,0,0,0,0,0,0,381,122,35,25,25,3
2020,862700341,4800,200,200,200,0,4600,4600,600,4000,0,0,0,0,0,500,500,0,500,512,152,50,40,0,8
2020,862700351,43,43,43,43,0,0,0,0,0,0,0,0,0,0,0,0,0,0,495,84,10,24,36,1
2020,862700361,4355,595,595,595,0,3760,3700,3700,0,0,60,0,60,0,0,0,0,0,500,100,30,10,30,3
2020,862800301,31286,7366,7366,7366,0,23920,12400,10000,2400,0,11520,1020,10500,0,45000,45000,45000,0,2160,250,150,480,180,67
2020,862800311,15078,4287,4287,4287,0,10791,6500,6200,300,0,4291,4200,91,0,4104,4104,2304,0,3474,158,180,660,296,68
2020,862800321,147282,7932,7932,7932,0,139350,130000,5000,125000,0,9350,1250,8100,0,50000,0,0,0,1579,110,340,360,54,192
2020,862800331,16975,11025,3025,2725,8000,5950,5000,0,5000,0,950,900,50,0,0,0,0,0,3027,840,10,450,264,85
2020,862800351,26518,818,818,818,0,25700,9000,9000,0,0,16700,4150,9050,3500,6724,6724,5000,0,4364,710,170,600,204,46
2020,862800361,7720,1720,1720,1720,0,6000,6000,6000,0,0,0,0,0,0,0,0,0,0,823,78,120,60,24,4
2020,862900301,420,30,30,30,0,390,0,0,0,0,390,150,240,0,1250,1250,1000,250,880,116,60,60,51,13
2020,862900321,26147,7067,7067,7067,0,19080,17000,17000,0,0,2080,1660,420,0,5503,5503,5462,0,2830,227,49,630,243,71
2020,862900351,750,200,200,200,0,550,550,550,0,0,0,0,0,0,0,0,0,0,1354,928,10,12,24,3
2020,862900361,8404,3266,3266,3266,0,5138,2600,2600,0,0,2538,450,2088,0,0,0,0,0,1516,115,150,369,60,30
2020,870000312,17805,505,505,505,0,17300,17000,17000,0,0,300,300,0,0,0,0,0,0,1106,56,240,240,72,71
2020,870000322,5010,10,10,10,0,5000,5000,5000,0,0,0,0,0,0,0,0,0,0,373,28,120,3,12,4
2020,870000342,63110,22492,22492,21992,0,40618,34000,22000,12000,0,6618,4618,2000,0,16610,16610,16460,0,9020,960,240,840,480,1624
2020,870000392,148566,23216,23216,23216,0,125350,90600,16000,74600,0,34750,2850,31900,0,10500,6500,6500,0,3034,150,50,720,144,163
2020,870600301,57270,19170,19170,19170,0,38100,28000,28000,0,0,10100,10000,100,0,800,800,300,0,6740,600,500,800,480,448
2020,870600311,49296,15796,15796,15796,0,33500,32900,25000,7900,0,600,600,0,0,0,0,0,0,2044,300,320,240,84,167
2020,870600321,61072,30872,30872,30872,0,30200,29000,17000,12000,0,1200,800,400,0,0,0,0,0,4300,200,70,280,150,84
2020,870600351,128,128,128,128,0,0,0,0,0,0,0,0,0,0,0,0,0,0,892,120,300,40,72,1
2020,870600361,732,732,732,732,0,0,0,0,0,0,0,0,0,0,0,0,0,0,765,312,36,24,72,18
2020,870600371,3380,840,840,840,0,2540,2500,2500,0,0,40,0,40,0,0,0,0,0,1486,138,320,75,36,7
2020,870600381,13240,230,230,230,0,13010,13000,13000,0,0,10,0,10,0,0,0,0,0,520,80,120,45,35,21
2020,870700301,20010,4640,4640,4640,0,15370,11000,8000,3000,0,4370,4350,20,0,5000,5000,5000,0,2290,180,10,420,120,52
2020,870700341,26095,3839,3839,3839,0,22256,19000,19000,0,0,3256,2500,756,0,8968,8968,8968,0,3086,360,50,240,200,191
2020,870700351,46756,29056,5556,1556,23500,17700,5000,0,5000,0,12700,450,8250,4000,5000,5000,5000,0,2390,240,60,240,150,461
2020,870700371,40290,6840,6840,6840,0,33450,27000,17000,10000,0,6450,2900,3550,0,8100,8100,5000,1600,2110,320,100,620,120,372
2020,870700381,3718,518,518,518,0,3200,3000,3000,0,0,200,0,200,0,3200,3200,1200,2000,663,60,280,20,38,3
2020,870700391,1,1,1,1,0,0,0,0,0,0,0,0,0,0,0,0,0,0,708,120,60,30,10,0
2020,870800301,18920,17320,320,320,17000,1600,0,0,0,0,1600,1300,300,0,10600,10600,10000,600,2938,340,80,250,288,88
2020,870800311,51878,15678,15678,15678,0,36200,33500,33500,0,0,2700,700,2000,0,0,0,0,0,2870,380,160,400,220,543
2020,870800331,33878,4148,4148,4148,0,29730,29000,23000,6000,0,730,600,130,0,0,0,0,0,3125,280,50,400,120,44
2020,870800351,48013,14613,14613,14613,0,33400,20000,20000,0,0,13400,4400,0,9000,0,0,0,0,2812,150,120,960,180,87
2020,870800361,68470,6270,6270,6270,0,62200,60000,0,60000,0,2200,2200,0,0,30000,0,0,0,6830,600,10,960,180,1101
2020,870800371,24801,18501,18501,16401,0,6300,5000,5000,0,0,1300,1300,0,0,0,0,0,0,1251,132,250,265,42,170
2020,870800381,12900,11400,5600,5600,5800,1500,0,0,0,0,1500,1500,0,0,4000,4000,4000,0,1300,150,100,100,200,267
2020,870800391,69501,9401,9401,9401,0,60100,55000,33000,22000,0,5100,5100,0,0,16100,1100,1100,0,3286,636,300,150,300,1525
2020,870900321,145222,14922,7422,7422,7500,130300,130000,0,130000,0,300,300,0,0,86500,36500,35000,1500,4650,240,370,290,130,219
2020,870900331,2300,2300,300,300,2000,0,0,0,0,0,0,0,0,0,0,0,0,0,886,240,60,12,36,1
2020,870900341,2542,2292,292,292,2000,250,0,0,0,0,250,250,0,0,0,0,0,0,685,180,60,120,30,46
2020,870900351,15792,1742,1742,1742,0,14050,14000,14000,0,0,50,0,50,0,0,0,0,0,869,228,6,60,42,21
2020,870900361,765,765,265,265,500,0,0,0,0,0,0,0,0,0,0,0,0,0,1865,408,20,65,132,1
2020,870900371,119746,41920,41920,26920,0,77826,76000,8000,68000,0,1826,1500,326,0,43640,43640,43640,0,2382,420,10,300,144,104
2020,871000312,57660,1900,1900,1900,0,55760,54100,12000,42100,0,1660,1660,0,0,3560,3560,0,3500,4013,180,1580,245,148,2010
2020,871000322,7992,3942,3942,3942,0,4050,4000,4000,0,0,50,50,0,0,3300,3300,2800,0,2290,180,50,240,360,405
2020,871000352,20490,2000,2000,2000,0,18490,13790,3290,10500,0,4700,4700,0,0,0,0,0,0,2680,360,50,150,120,99
2020,871000362,86928,10438,10438,6438,0,76490,75000,14000,61000,0,1490,1240,250,0,554,554,450,0,2900,300,125,300,150,898
2020,871000372,15400,5200,5200,5200,0,10200,10000,10000,0,0,200,200,0,0,0,0,0,0,1340,400,100,10,30,69
2020,871000392,7200,100,100,100,0,7100,7000,5000,2000,0,100,50,50,0,0,0,0,0,1485,205,240,240,0,22
2020,871600301,10580,10080,4080,4080,6000,500,0,0,0,0,500,500,0,0,0,0,0,0,1660,130,10,300,100,8
2020,871600311,2735,2535,535,535,2000,200,0,0,0,0,200,200,0,0,0,0,0,0,1400,150,30,200,20,8
2020,871600321,2650,1500,1000,1000,500,1150,0,0,0,0,1150,1150,0,0,2360,2360,0,2360,4256,696,792,620,780,792
2020,871600331,300,300,200,200,100,0,0,0,0,0,0,0,0,0,1700,1700,0,1000,905,396,20,120,144,1
2020,871600351,19378,5978,5978,5978,0,13400,10000,10000,0,0,3400,3000,400,0,57,57,0,0,3583,210,10,320,263,64
2020,871600361,34972,5272,5272,5272,0,29700,27000,27000,0,0,2700,2700,0,0,9529,9529,9529,0,4300,300,100,500,400,941
2020,871700301,15000,1500,1500,1500,0,13500,13000,13000,0,0,500,500,0,0,3000,3000,3000,0,1905,300,900,120,45,54
2020,871700311,21320,6050,6050,6050,0,15270,15000,15000,0,0,270,270,0,0,9000,9000,9000,0,2750,240,50,480,240,29
2020,871700331,73210,660,660,660,0,72550,54000,6000,48000,0,18550,300,18250,0,6000,2000,0,2000,1526,186,350,270,180,99
2020,871700351,64500,1500,1500,1500,0,63000,62000,17000,45000,0,1000,1000,0,0,52300,37300,37300,0,2260,700,50,100,200,125
2020,871700361,5280,280,280,280,0,5000,5000,5000,0,0,0,0,0,0,0,0,0,0,1205,130,55,25,24,16
2020,871700381,8240,3200,3200,3200,0,5040,5000,5000,0,0,40,0,40,0,0,0,0,0,796,100,100,10,36,4
2020,871700391,38,38,38,38,0,0,0,0,0,0,0,0,0,0,0,0,0,0,638,96,120,0,12,1
2020,871800301,33535,735,735,735,0,32800,28000,11000,17000,0,4800,3900,900,0,150,150,0,0,3387,100,200,300,57,106
2020,871800321,510,510,10,10,500,0,0,0,0,0,0,0,0,0,0,0,0,0,650,180,10,10,15,1
2020,871800331,5800,3500,3500,3500,0,2300,2000,0,2000,0,300,0,300,0,0,0,0,0,840,80,400,50,40,38
2020,871800341,1007,7,7,7,0,1000,1000,1000,0,0,0,0,0,0,0,0,0,0,495,150,160,40,18,4
2020,871800361,300,300,300,300,0,0,0,0,0,0,0,0,0,0,0,0,0,0,332,70,60,10,20,1
2020,871800371,58090,19290,5790,5790,13500,38800,27000,0,27000,0,11800,8600,3200,0,18870,18870,18600,0,5660,350,50,250,350,436
2020,871800381,69691,21891,8891,8891,13000,47800,45000,0,45000,0,2800,2300,500,0,47800,21800,19200,2600,5540,250,200,250,240,463
2020,871800391,3784,3784,1784,1784,2000,0,0,0,0,0,0,0,0,0,0,0,0,0,669,173,48,60,48,1
2020,871900321,11932,11782,2782,2782,9000,150,0,0,0,0,150,150,0,0,5500,5500,5500,0,2890,120,250,250,480,62
2020,871900331,9990,4990,4990,4990,0,5000,5000,5000,0,0,0,0,0,0,0,0,0,0,1030,240,240,50,110,5
2020,871900361,24440,9460,9460,9460,0,14980,14800,6800,8000,0,180,0,180,0,0,0,0,0,1132,100,70,20,42,11
2020,872000302,114842,4542,4542,4542,0,110300,110000,10000,100000,0,300,0,300,0,59500,1500,1500,0,1410,276,72,50,32,181
2020,872000312,58146,5820,5820,5820,0,52326,48000,28000,20000,0,4326,4100,226,0,14050,14050,12000,2000,4006,314,200,240,276,163
2020,872000332,9953,1853,1853,1853,0,8100,8000,8000,0,0,100,100,0,0,0,0,0,0,1420,312,42,284,152,83
2020,872000342,15250,150,150,150,0,15100,15000,5000,10000,0,100,0,100,0,0,0,0,0,890,200,120,70,30,5
2020,872000352,6982,1932,1932,1932,0,5050,3630,3630,0,0,1420,1300,120,0,0,0,0,0,657,120,28,115,45,48
2020,872000372,9392,2392,2392,2392,0,7000,7000,7000,0,0,0,0,0,0,1050,1050,0,1050,667,67,10,20,90,19
2020,872000382,79850,11800,11800,11800,0,68050,55000,35000,20000,0,13050,3050,10000,0,10000,10000,10000,0,1814,134,60,360,100,825
2020,872600301,7210,700,700,700,0,6510,6500,6500,0,0,10,0,10,0,0,0,0,0,436,210,36,24,6,8
2020,872600321,34096,9846,9846,9846,0,24250,21000,16000,5000,0,3250,3250,0,0,6500,3000,3000,0,5910,280,500,500,230,132
2020,872600331,42798,3998,3998,3998,0,38800,36000,36000,0,0,2800,2500,300,0,7000,7000,7000,0,3014,204,100,300,150,167
2020,872600341,17608,2308,2308,2308,0,15300,12000,2000,10000,0,3300,1500,1800,0,300,300,0,300,1315,150,20,300,60,11
2020,872600351,5400,3400,3400,3400,0,2000,2000,2000,0,0,0,0,0,0,0,0,0,0,1138,92,60,86,120,11
2020,872600371,2130,130,130,130,0,2000,2000,2000,0,0,0,0,0,0,0,0,0,0,561,76,160,30,25,3
2020,872700301,468,468,200,200,268,0,0,0,0,0,0,0,0,0,0,0,0,0,399,120,0,0,24,0
2020,872700311,54446,11216,11216,11216,0,43230,39000,9000,30000,0,4230,4000,230,0,0,0,0,0,1300,180,20,180,120,302
2020,872700331,52350,5450,5450,5450,0,46900,40000,8000,32000,0,6900,50,6850,0,0,0,0,0,1630,100,500,50,50,83
2020,872700351,22030,7580,7580,7580,0,14450,13000,5000,8000,0,1450,1200,250,0,0,0,0,0,743,86,15,240,24,10
2020,872700361,5248,48,48,48,0,5200,5000,3000,2000,0,200,0,200,0,600,600,0,0,1658,100,1200,50,43,8
2020,872800301,856,726,526,526,200,130,0,0,0,0,130,80,50,0,9800,9800,0,6300,1566,360,200,180,10,14
2020,872800311,22850,2400,2400,2400,0,20450,20000,10000,10000,0,450,450,0,0,0,0,0,0,2170,276,130,240,240,41
2020,872800321,30208,2956,2956,2756,0,27252,25030,5530,19500,0,2222,1800,422,0,2980,2680,2600,0,2775,78,250,480,277,68
2020,872800331,8200,1200,1200,1200,0,7000,7000,7000,0,0,0,0,0,0,0,0,0,0,480,50,3,10,17,5
2020,872800341,21542,142,142,142,0,21400,21000,3400,17600,0,400,100,300,0,300,300,300,0,959,60,5,216,18,29
2020,872900321,7,7,7,7,0,0,0,0,0,0,0,0,0,0,0,0,0,0,393,180,50,5,18,1
2020,872900331,19600,1000,1000,1000,0,18600,13900,4000,9900,0,4700,200,4500,0,0,0,0,0,978,200,300,72,36,17
2020,872900341,1768,200,200,200,0,1568,1500,1500,0,0,68,0,68,0,0,0,0,0,451,76,250,10,15,1
2020,872900351,9690,150,150,150,0,9540,9000,9000,0,0,540,500,40,0,0,0,0,0,665,180,10,15,20,68
2020,880000302,16020,7310,7310,7310,0,8710,8000,8000,0,0,710,710,0,0,0,0,0,0,2555,270,350,360,150,172
2020,880000312,3530,2590,2090,2090,500,940,0,0,0,0,940,940,0,0,2405,2405,0,2405,2034,700,5,200,84,62
2020,880000322,29198,4098,4098,3098,0,25100,25000,17000,8000,0,100,100,0,0,4500,500,0,500,2545,790,360,245,180,81
2020,880000332,22063,4563,4563,4563,0,17500,16000,15000,1000,0,1500,1000,500,0,3000,3000,2000,1000,2602,360,350,150,240,121
2020,880000342,25548,6818,6818,6818,0,18730,17000,17000,0,0,1730,1680,50,0,11840,11840,11150,420,2806,234,20,445,180,295
2020,880000352,1900,1900,900,900,1000,0,0,0,0,0,0,0,0,0,0,0,0,0,1491,632,400,70,24,44
2020,880000362,29000,19000,19000,19000,0,10000,10000,10000,0,0,0,0,0,0,0,0,0,0,1360,196,72,36,36,22
2020,880000382,142225,2825,2825,2825,0,139400,99000,19000,80000,0,40400,400,40000,0,80000,80000,80000,0,2134,240,240,192,84,347
2020,880000392,31842,210,210,210,0,31632,27000,22000,5000,0,4632,4632,0,0,8490,8490,3500,750,2828,360,50,360,180,92
2020,880600311,9170,170,170,170,0,9000,9000,9000,0,0,0,0,0,0,0,0,0,0,266,69,15,10,26,8
2020,880600321,21610,2360,2360,2360,0,19250,19000,19000,0,0,250,250,0,0,9000,9000,8900,0,1286,170,360,60,72,45
2020,880600331,1616,1516,1316,1316,200,100,0,0,0,0,100,100,0,0,0,0,0,0,1866,560,12,180,84,33
2020,880600341,24010,2210,2210,1910,0,21800,20000,20000,0,0,1800,300,1500,0,4300,4300,2500,0,3114,620,800,240,244,31
2020,880600381,24067,6667,6667,6517,0,17400,15000,11000,4000,0,2400,1500,900,0,10103,10103,6536,2660,4257,235,50,240,400,87
2020,880700301,4355,2255,2255,2255,0,2100,0,0,0,0,2100,900,0,1200,13,13,0,0,2840,100,100,480,180,18
2020,880700311,40651,5451,5451,5451,0,35200,35100,14600,20500,0,100,100,0,0,0,0,0,0,1606,170,150,280,96,76
2020,880700321,2258,328,328,328,0,1930,0,0,0,0,1930,1930,0,0,1500,1500,0,1200,2689,180,220,387,211,40
2020,880700331,2010,2010,10,10,2000,0,0,0,0,0,0,0,0,0,0,0,0,0,625,220,36,16,42,1
2020,880700341,27442,12742,12742,12742,0,14700,14000,10000,4000,0,700,700,0,0,0,0,0,0,5686,360,50,240,180,2610
2020,880700381,98690,11240,11240,8240,0,87450,81000,30000,51000,0,6450,1000,2250,3200,62870,42870,41700,1000,2062,432,60,240,180,124
2020,880800301,16431,1431,1431,1431,0,15000,15000,15000,0,0,0,0,0,0,200,0,0,0,2063,232,1090,45,29,11
2020,880800311,26875,2180,2180,2180,0,24695,24500,15000,9500,0,195,0,195,0,500,0,0,0,869,177,20,16,64,54
2020,880800331,7667,2667,2667,1667,0,5000,5000,5000,0,0,0,0,0,0,0,0,0,0,1354,310,234,72,100,5
2020,880800341,854,854,554,554,300,0,0,0,0,0,0,0,0,0,1700,1700,0,0,818,388,10,5,48,1
2020,880800361,23170,17570,6570,3570,11000,5600,0,0,0,0,5600,500,100,5000,6160,6160,5000,600,4297,276,125,276,480,181
2020,880800381,30709,1909,1909,1909,0,28800,26500,14000,12500,0,2300,2300,0,0,12800,3500,3500,0,1193,168,36,98,72,84
2020,880800391,15100,1000,1000,1000,0,14100,14000,6000,8000,0,100,100,0,0,0,0,0,0,597,75,10,120,72,21
2020,880900301,40143,2493,2493,2493,0,37650,37000,37000,0,0,650,650,0,0,21000,21000,21000,0,3125,276,170,368,180,552
2020,880900331,9067,779,779,779,0,8288,7900,7900,0,0,388,300,88,0,300,0,0,0,1542,228,388,96,82,46
2020,880900341,2050,1050,1050,1050,0,1000,1000,1000,0,0,0,0,0,0,0,0,0,0,533,100,72,36,15,2
2020,880900351,7096,5596,5596,5596,0,1500,0,0,0,0,1500,1500,0,0,6600,6600,0,4300,3550,240,50,300,240,40
2020,880900361,31087,2397,2397,1897,0,28690,21500,21500,0,0,7190,190,7000,0,4000,4000,4000,0,1363,320,160,149,108,53
2020,880900371,7395,300,300,300,0,7095,7000,7000,0,0,95,0,95,0,6000,6000,6000,0,2600,240,200,300,204,10
2020,880900391,11345,1275,1275,1275,0,10070,10000,10000,0,0,70,70,0,0,0,0,0,0,665,210,67,30,18,11
2020,881000312,62150,17100,17100,17100,0,45050,43700,35000,8700,0,1350,1300,50,0,500,0,0,0,2247,127,50,120,110,114
2020,881000322,7150,150,150,150,0,7000,7000,7000,0,0,0,0,0,0,0,0,0,0,1172,120,330,10,72,7
2020,881000352,3692,3342,2842,2842,500,350,0,0,0,0,350,200,150,0,455,455,0,0,2290,480,40,170,96,27
2020,881000362,19730,2950,2950,2950,0,16780,15900,6400,9500,0,880,800,80,0,12820,11820,11820,0,1879,204,100,300,105,45
2020,881000382,13639,153,153,153,0,13486,11500,11500,0,0,1986,1790,196,0,4980,4980,4000,700,2391,210,120,170,204,66
2020,881000392,64470,220,220,220,0,64250,63000,33000,30000,0,1250,1250,0,0,4000,0,0,0,2574,480,132,240,120,144
2020,881600301,35801,16101,16101,16101,0,19700,17000,17000,0,0,2700,2700,0,0,0,0,0,0,3060,320,1030,360,180,161
2020,881600311,9457,2007,2007,2007,0,7450,7000,7000,0,0,450,450,0,0,4820,4820,4820,0,3030,310,80,220,250,37
2020,881600351,10852,770,770,770,0,10082,10000,10000,0,0,82,0,82,0,5492,5492,2992,2500,1908,220,100,168,120,1
2020,881600381,19370,4690,4690,4690,0,14680,14000,14000,0,0,680,680,0,0,4000,0,0,0,1670,210,300,240,80,320
2020,881600391,62639,2626,2626,2626,0,60013,59000,39000,20000,0,1013,900,113,0,44072,33322,32392,930,1600,150,150,400,92,486
2020,881700311,9047,47,47,47,0,9000,9000,9000,0,0,0,0,0,0,0,0,0,0,1129,108,180,96,60,15
2020,881700351,25796,3096,3096,3096,0,22700,22200,19000,3200,0,500,500,0,0,4004,4004,4000,0,1873,240,30,430,264,128
2020,881700361,63752,23200,8200,8200,15000,40552,40000,0,40000,0,552,500,52,0,8326,4326,4326,0,4100,900,480,240,240,327
2020,881700391,2360,2200,200,200,2000,160,0,0,0,0,160,0,160,0,0,0,0,0,2076,312,30,180,264,32
2020,881800311,2464,2164,264,264,1900,300,0,0,0,0,300,300,0,0,0,0,0,0,1308,277,70,200,72,7
2020,881800341,710,710,210,210,500,0,0,0,0,0,0,0,0,0,0,0,0,0,629,270,120,10,24,1
2020,881800361,39065,3831,3831,3831,0,35234,33700,23700,10000,0,1534,1534,0,0,2000,0,0,0,6518,336,100,570,326,697
2020,881800371,24639,5839,5839,5839,0,18800,10000,10000,0,0,8800,2400,6400,0,9508,9508,9408,0,3874,174,80,480,240,80
2020,881800381,35595,9595,9595,9595,0,26000,24500,24500,0,0,1500,1500,0,0,21584,21584,20584,0,3107,320,600,240,360,83
2020,881800391,18510,16210,4810,4810,11400,2300,0,0,0,0,2300,2300,0,0,200,200,0,0,2950,720,10,50,200,56
2020,881900301,22213,3530,3530,3530,0,18683,18000,18000,0,0,683,600,83,0,2736,2736,2736,0,3338,240,310,240,192,85
2020,881900311,7077,1427,1427,1427,0,5650,5200,5200,0,0,450,450,0,0,9302,9302,6990,2312,2013,164,10,140,239,733
2020,881900331,41694,25694,25694,25694,0,16000,13000,13000,0,0,3000,3000,0,0,0,0,0,0,3650,240,40,340,360,1690
2020,881900341,42846,20146,10146,10146,10000,22700,21900,0,19300,2600,800,800,0,0,60,60,0,0,3324,480,24,360,360,769
2020,881900351,25620,920,920,920,0,24700,23000,23000,0,0,1700,1600,100,0,5850,5850,5700,0,3810,300,50,650,360,135
2020,881900361,160,160,10,10,150,0,0,0,0,0,0,0,0,0,0,0,0,0,841,180,100,10,15,1
2020,882000302,51180,12000,12000,12000,0,39180,37200,27000,10200,0,1980,1980,0,0,1200,0,0,0,2300,180,100,360,180,376
2020,882000312,100,100,100,100,0,0,0,0,0,0,0,0,0,0,0,0,0,0,910,168,240,60,24,1
2020,882000322,15120,4020,4020,4020,0,11100,11000,11000,0,0,100,100,0,0,3500,3500,0,3500,2157,190,240,480,180,51
2020,882000342,13480,4080,4080,4080,0,9400,9000,9000,0,0,400,400,0,0,0,0,0,0,1808,180,12,36,108,23
2020,882000352,14900,5300,5300,5300,0,9600,6000,6000,0,0,3600,3600,0,0,0,0,0,0,2522,155,22,180,120,144
2020,882000372,5700,100,100,100,0,5600,5600,5600,0,0,0,0,0,0,0,0,0,0,963,90,148,20,68,6
2020,882600301,20680,3300,2300,300,1000,17380,17000,0,17000,0,380,380,0,0,360,360,0,200,2134,588,50,180,240,21
2020,882600311,53376,3736,3736,3736,0,49640,48000,25000,23000,0,1640,850,790,0,17608,2608,2558,0,1814,96,100,250,88,77
2020,882600321,128074,28674,28674,28674,0,99400,93500,56000,37500,0,5900,5900,0,0,14220,9220,7800,0,8180,480,300,480,420,2336
2020,882600331,22564,1664,1664,1664,0,20900,20000,10000,10000,0,900,800,100,0,7540,7540,6640,900,2430,240,50,300,240,67
2020,882600391,4005,80,80,80,0,3925,3500,3500,0,0,425,175,250,0,2900,2900,0,400,1012,110,150,100,87,2
2020,882700301,13800,800,800,800,0,13000,13000,13000,0,0,0,0,0,0,0,0,0,0,1673,980,60,36,48,16
2020,882700321,26914,7015,7015,7015,0,19899,18500,18500,0,0,1399,1350,49,0,2302,2302,1592,0,3271,276,700,290,300,159
2020,882700331,110909,20209,14209,13709,6000,90700,86600,0,86600,0,4100,1400,2700,0,36710,22710,22610,0,5130,655,350,555,260,412
2020,882700341,19980,18980,10980,10980,8000,1000,0,0,0,0,1000,800,200,0,0,0,0,0,3552,280,86,240,276,210
2020,882700351,5603,3603,2603,2603,1000,2000,0,0,0,0,2000,1800,200,0,650,650,0,0,3518,180,120,600,240,30
2020,882700371,5520,20,20,20,0,5500,5500,5500,0,0,0,0,0,0,0,0,0,0,713,118,188,5,78,4
2020,882700381,3256,2708,2708,2708,0,548,0,0,0,0,548,480,68,0,0,0,0,0,690,108,57,44,14,10
2020,882800301,19533,10233,10233,10233,0,9300,8000,8000,0,0,1300,1100,200,0,967,967,700,250,1854,180,215,350,60,143
2020,882800321,40052,5029,5029,5029,0,35023,25500,25500,0,0,9523,723,8000,800,17280,17280,17280,0,4326,240,100,584,216,65
2020,882800331,182398,46088,31088,31088,15000,136310,135000,0,135000,0,1310,800,510,0,54120,50120,50000,0,7251,485,210,380,336,2969
2020,882800341,17830,680,680,680,0,17150,17000,17000,0,0,150,0,150,0,0,0,0,0,525,75,60,24,36,39
2020,882800361,21709,6480,6480,6480,0,15229,15000,15000,0,0,229,229,0,0,12902,12902,9802,3000,5490,380,200,240,120,175
2020,882800371,1100,1100,1100,1100,0,0,0,0,0,0,0,0,0,0,0,0,0,0,509,50,72,29,18,1
2020,882800391,68800,11400,11400,11400,0,57400,48500,3500,45000,0,8900,3750,5150,0,15000,0,0,0,3120,300,300,360,240,183
2020,882900321,40064,16934,16934,16934,0,23130,23000,23000,0,0,130,130,0,0,6500,6500,4500,2000,4180,360,150,420,300,1363
2020,882900331,44459,8279,8279,8279,0,36180,36000,25000,11000,0,180,180,0,0,15000,15000,15000,0,2930,360,150,240,220,318
2020,882900341,37389,989,989,989,0,36400,36000,21000,15000,0,400,400,0,0,3200,3200,0,3000,4670,180,1270,360,240,125
2020,882900361,6050,50,50,50,0,6000,6000,6000,0,0,0,0,0,0,0,0,0,0,984,84,6,60,24,9
2020,882900371,23895,4475,4475,4475,0,19420,18000,12000,6000,0,1420,1400,20,0,5050,5050,5000,0,3207,180,12,360,145,875
2020,882900391,4825,175,175,175,0,4650,4650,2650,2000,0,0,0,0,0,0,0,0,0,527,70,84,11,25,5
2020,883000302,24946,3846,3846,3846,0,21100,21000,6000,15000,0,100,100,0,0,2000,2000,2000,0,3662,225,900,480,144,63
2020,883000312,550,550,550,550,0,0,0,0,0,0,0,0,0,0,0,0,0,0,456,120,50,20,36,1
2020,883600301,610,300,300,300,0,310,0,0,0,0,310,40,270,0,15200,15200,15200,0,1619,79,340,95,45,8
2020,883600311,43530,4380,4380,4380,0,39150,37000,14000,23000,0,2150,2150,0,0,2300,2300,0,2300,2410,340,150,240,110,72
2020,883800301,9010,1010,1010,1010,0,8000,8000,2500,5500,0,0,0,0,0,0,0,0,0,1210,84,560,120,66,7
2020,883900301,14460,410,410,410,0,14050,14000,6000,8000,0,50,0,50,0,0,0,0,0,915,66,500,35,24,6
2020,890000202,54310,4110,4110,2110,0,50200,50000,20000,30000,0,200,200,0,0,3000,2000,0,2000,1906,264,250,96,120,31
2020,890000232,2400,400,100,100,300,2000,0,0,0,0,2000,2000,0,0,1000,1000,0,0,1690,480,10,240,120,53
2020,890000252,16400,2400,400,400,2000,14000,14000,0,14000,0,0,0,0,0,0,0,0,0,816,60,200,60,53,7
2020,890000272,16310,15210,3710,3710,11500,1100,0,0,0,0,1100,1100,0,0,300,300,0,300,1690,265,200,50,155,21
2020,890000312,76963,9163,9163,9163,0,67800,67500,30000,37500,0,300,200,100,0,0,0,0,0,1786,100,36,180,200,281
2020,890000322,10818,4043,3443,3443,600,6775,6375,0,6375,0,400,400,0,0,9100,9100,6900,0,6100,1500,500,700,500,107
2020,890000332,15187,87,87,87,0,15100,15000,15000,0,0,100,100,0,0,0,0,0,0,1973,124,180,180,126,39
2020,890000342,56070,4720,4720,4720,0,51350,50000,10000,40000,0,1350,850,500,0,0,0,0,0,1114,58,10,240,96,208
2020,890000352,31304,2804,2804,2804,0,28500,28000,18000,10000,0,500,500,0,0,1950,1950,1950,0,1060,70,120,40,30,240
2020,890000362,281660,17660,17660,17660,0,264000,254400,254400,0,0,9600,4600,0,5000,79900,79900,78400,0,5270,190,100,480,480,326
2020,890000372,780,730,730,730,0,50,0,0,0,0,50,0,50,0,520,520,0,300,4680,1200,300,120,180,2
2020,890000382,1900,400,100,100,300,1500,0,0,0,0,1500,1500,0,0,0,0,0,0,1824,564,10,120,180,17
2020,890600201,48330,21980,21980,21980,0,26350,20000,20000,0,0,6350,700,2150,3500,0,0,0,0,2938,420,300,360,108,72
2020,890600211,2700,2700,2700,2700,0,0,0,0,0,0,0,0,0,0,0,0,0,0,1031,300,15,150,54,154
2020,890600221,62197,7967,7967,7967,0,54230,48000,30000,18000,0,6230,6000,230,0,0,0,0,0,2662,396,100,840,264,479
2020,890600301,11985,6835,5535,5535,1300,5150,5000,0,5000,0,150,150,0,0,2000,2000,1500,0,1492,180,78,420,144,19
2020,890600311,35471,1351,1351,1351,0,34120,21000,20000,1000,0,13120,3120,0,10000,5830,5830,4340,0,1562,294,200,80,132,46
2020,890600321,19240,4140,4140,4140,0,15100,15000,15000,0,0,100,100,0,0,4000,4000,4000,0,2450,228,50,500,132,36
2020,890600331,69250,10250,10250,10250,0,59000,58000,18000,40000,0,1000,1000,0,0,2000,2000,0,2000,1648,180,240,150,60,86
2020,890600341,6364,4564,4564,4564,0,1800,0,0,0,0,1800,1800,0,0,0,0,0,0,3956,180,60,300,240,28
2020,890600371,80582,13682,13682,13682,0,66900,65000,45000,20000,0,1900,1700,200,0,25000,25000,25000,0,4790,900,200,100,150,417
2020,890600381,48255,7155,7155,7155,0,41100,36000,30000,6000,0,5100,5000,100,0,0,0,0,0,3624,300,540,180,264,459
2020,890600391,45218,2482,2482,2482,0,42736,41400,10000,31400,0,1336,300,1036,0,11100,11100,6000,5100,1786,86,140,100,100,56
2020,890700201,84315,3965,3965,3965,0,80350,80000,30000,50000,0,350,250,100,0,0,0,0,0,2033,360,120,240,108,204
2020,890700211,37380,16930,1930,1930,15000,20450,20000,0,20000,0,450,450,0,0,0,0,0,0,3094,250,650,250,84,86
2020,890700231,47768,12168,3668,3668,8500,35600,35000,0,35000,0,600,600,0,0,0,0,0,0,1904,204,60,144,60,44
2020,890700301,97492,29992,29992,29992,0,67500,65000,35000,30000,0,2500,100,2400,0,0,0,0,0,1887,450,50,125,65,97
2020,890700311,237771,10090,10090,10090,0,227681,213800,15000,198800,0,13881,3300,10581,0,13800,13800,10000,3800,2047,362,596,193,120,417
2020,890700341,4748,3348,3148,3148,200,1400,0,0,0,0,1400,1400,0,0,0,0,0,0,1399,100,300,35,120,32
2020,890700361,6,6,6,6,0,0,0,0,0,0,0,0,0,0,0,0,0,0,1380,470,130,100,120,8
2020,890700371,42370,16370,16370,16370,0,26000,25000,25000,0,0,1000,1000,0,0,6000,6000,6000,0,3040,240,100,300,200,141
2020,890700391,7304,7004,1004,1004,6000,300,0,0,0,0,300,300,0,0,4000,4000,4000,0,1898,360,20,240,48,47
2020,890800201,9250,750,750,750,0,8500,7000,7000,0,0,1500,1500,0,0,2600,2600,1100,1000,1270,300,300,120,100,7
2020,890800231,62537,6178,6178,6178,0,56359,54000,54000,0,0,2359,2100,259,0,12600,12600,12600,0,2190,192,200,500,100,155
2020,890800241,147860,17560,17560,16960,0,130300,105000,70000,35000,0,25300,300,25000,0,42650,42650,40000,2400,2510,400,100,100,240,306
2020,890800271,10,10,10,10,0,0,0,0,0,0,0,0,0,0,2700,2700,0,0,1245,444,20,30,60,1
2020,890800301,19500,4000,4000,4000,0,15500,15000,10000,5000,0,500,0,500,0,0,0,0,0,2346,234,840,20,60,61
2020,890800311,3760,3760,1260,1260,2500,0,0,0,0,0,0,0,0,0,0,0,0,0,1648,450,10,180,48,1
2020,890800321,113960,28560,28560,28560,0,85400,80000,15000,65000,0,5400,400,5000,0,0,0,0,0,4190,180,30,720,180,139
2020,890800331,34611,11320,11320,8320,0,23291,20000,20000,0,0,3291,2500,791,0,3000,3000,3000,0,1937,252,180,240,144,66
2020,890800341,57873,19723,19023,18823,700,38150,37500,0,37500,0,650,650,0,0,0,0,0,0,5120,1580,84,480,300,85
2020,890800351,68652,2552,2552,2552,0,66100,66000,16000,50000,0,100,100,0,0,6350,5850,3000,2800,2006,150,100,120,144,112
2020,890800361,10990,2090,2090,2090,0,8900,8900,8900,0,0,0,0,0,0,0,0,0,0,646,154,180,0,18,6
2020,890800371,46880,5180,5180,5180,0,41700,40000,40000,0,0,1700,1700,0,0,23140,23140,22640,500,5120,360,150,500,330,196
2020,890800381,21688,738,738,738,0,20950,20000,20000,0,0,950,450,500,0,70,70,0,0,1590,120,50,240,180,119
2020,890800391,71008,708,708,708,0,70300,70000,70000,0,0,300,300,0,0,160,60,0,0,1270,100,50,200,50,38
2020,890900201,22150,5150,5150,5150,0,17000,16000,16000,0,0,1000,1000,0,0,20,20,0,0,1457,312,56,84,120,21
2020,890900221,1512,1112,612,612,500,400,0,0,0,0,400,400,0,0,4282,4282,0,0,1557,720,60,120,96,12
2020,890900231,214000,1500,1500,1500,0,212500,181500,0,181500,0,31000,5500,500,25000,51000,41000,33000,7000,3990,200,700,400,190,226
2020,890900241,32980,2980,2980,2980,0,30000,29000,12000,17000,0,1000,1000,0,0,100,100,0,0,1460,100,20,200,120,54
2020,890900251,25,25,25,25,0,0,0,0,0,0,0,0,0,0,0,0,0,0,978,240,336,72,36,1
2020,890900271,43000,2000,2000,2000,0,41000,41000,40000,1000,0,0,0,0,0,0,0,0,0,1026,216,10,10,70,48
2020,890900291,119920,4720,4720,4720,0,115200,113000,43000,70000,0,2200,2200,0,0,29300,2300,2000,300,4264,324,240,310,180,518
2020,890900301,30810,16310,16310,16310,0,14500,14500,7000,7500,0,0,0,0,0,0,0,0,0,2871,618,1380,5,68,76
2020,890900311,28956,28256,10256,10256,18000,700,0,0,0,0,700,700,0,0,20320,20320,0,20000,3080,300,40,500,300,646
2020,890900331,7300,6800,6800,6800,0,500,0,0,0,0,500,500,0,0,0,0,0,0,1083,127,10,36,60,17
2020,890900341,45,45,35,35,10,0,0,0,0,0,0,0,0,0,0,0,0,0,974,308,95,10,72,1
2020,890900351,1800,1800,1800,1300,0,0,0,0,0,0,0,0,0,0,300,300,0,0,2254,494,150,180,480,6
2020,890900361,2930,1630,30,30,1600,1300,0,0,0,0,1300,1300,0,0,1070,1070,0,0,1100,276,12,120,72,100
2020,890900371,75683,10033,10033,10033,0,65650,65000,55000,10000,0,650,650,0,0,18554,18554,6554,7000,8480,500,540,700,240,689
2020,890900381,77792,7592,7592,7592,0,70200,69000,54000,15000,0,1200,1200,0,0,12500,11500,10000,1500,3290,600,100,120,240,599
2020,891000212,92138,7538,7538,7538,0,84600,80000,80000,0,0,4600,4600,0,0,14000,14000,14000,0,3673,312,300,240,210,163
2020,891000222,155000,3000,3000,3000,0,152000,149000,70000,79000,0,3000,3000,0,0,20000,0,0,0,2425,264,5,480,96,227
2020,891000302,2650,2450,1450,1450,1000,200,0,0,0,0,200,200,0,0,2000,2000,0,2000,2966,1096,10,240,240,56
2020,891000312,650,50,50,50,0,600,0,0,0,0,600,600,0,0,1100,1100,0,700,1001,84,30,200,72,59
2020,891000332,50,50,50,50,0,0,0,0,0,0,0,0,0,0,0,0,0,0,975,120,10,60,60,1
2020,891600301,195310,14760,14760,14760,0,180550,180000,20000,160000,0,550,400,150,0,4600,4600,4600,0,1632,186,660,84,60,258
2020,891600311,59612,10362,10362,10362,0,49250,47000,25000,22000,0,2250,2250,0,0,0,0,0,0,1110,122,40,300,48,78
2020,891600331,55216,5916,5916,5916,0,49300,42000,30000,12000,0,7300,300,5000,2000,3025,3000,3000,0,1540,120,50,120,150,143
2020,891600341,570,450,50,50,400,120,0,0,0,0,120,120,0,0,0,0,0,0,440,0,0,100,30,25
2020,891700301,6314,6314,4914,4914,1400,0,0,0,0,0,0,0,0,0,0,0,0,0,1700,200,100,100,90,95
2020,891700321,45300,3300,3300,3300,0,42000,42000,42000,0,0,0,0,0,0,0,0,0,0,847,65,170,0,12,62
2020,891700341,130020,8020,8020,8020,0,122000,106000,36000,70000,0,16000,1000,15000,0,29400,29400,29400,0,3639,220,360,840,204,145
2020,891700351,4497,4317,1617,1617,2700,180,0,0,0,0,180,180,0,0,2200,2200,2200,0,1864,416,100,100,180,16
2020,891800201,15100,100,100,100,0,15000,15000,15000,0,0,0,0,0,0,6000,6000,0,4000,1126,84,96,180,96,60
2020,891800211,39450,12050,12050,5050,0,27400,26000,13000,13000,0,1400,1400,0,0,2000,0,0,0,2200,180,80,250,90,426
2020,891800221,80455,11438,11438,11318,0,69017,68000,21000,47000,0,1017,0,1017,0,8000,0,0,0,2695,180,60,50,180,263
2020,891800231,57677,8327,8327,8327,0,49350,46000,20000,26000,0,3350,2350,0,1000,15500,15000,13800,1200,3896,420,20,452,312,172
2020,891800281,5800,300,300,300,0,5500,5500,5500,0,0,0,0,0,0,0,0,0,0,298,90,40,12,12,6
2020,891800301,236462,312,312,312,0,236150,235000,230000,5000,0,1150,1100,50,0,75100,71600,70000,1600,3720,350,100,500,120,276
2020,891800311,61220,11821,11821,11821,0,49399,48000,15000,33000,0,1399,1000,399,0,0,0,0,0,1986,156,10,360,600,132
2020,891800321,53250,3250,3250,3250,0,50000,50000,50000,0,0,0,0,0,0,0,0,0,0,585,107,7,20,18,82
2020,891800331,10,10,10,10,0,0,0,0,0,0,0,0,0,0,0,0,0,0,1800,120,10,50,180,123
2020,891800341,15563,472,472,472,0,15091,13000,13000,0,0,2091,1936,155,0,12126,12126,7126,5000,5310,360,200,1000,150,106
2020,891900201,56758,8158,8158,8158,0,48600,47800,45000,0,2800,800,800,0,0,15020,15020,15000,0,5220,540,400,400,360,303
2020,891900211,48520,14520,2520,2520,12000,34000,34000,0,34000,0,0,0,0,0,12030,30,0,0,2330,240,30,50,240,244
2020,891900221,29126,926,926,926,0,28200,28000,28000,0,0,200,200,0,0,15060,15060,14080,980,2406,174,20,80,100,26
2020,891900301,13768,12068,11568,11568,500,1700,0,0,0,0,1700,1700,0,0,0,0,0,0,2890,996,0,480,60,2386
2020,891900311,15230,200,200,200,0,15030,15000,15000,0,0,30,0,30,0,0,0,0,0,847,58,240,15,21,5
2020,891900331,3898,3098,3098,3098,0,800,0,0,0,0,800,800,0,0,40,40,0,0,2782,0,10,150,150,26
2020,891900341,74264,15264,15264,15264,0,59000,57000,37000,20000,0,2000,1000,1000,0,4000,4000,3000,1000,5400,240,660,240,360,483
2020,892800211,143100,500,500,500,0,142600,142000,50000,92000,0,600,500,100,0,0,0,0,0,1341,256,140,344,96,133
2020,892800291,89300,4300,4300,4300,0,85000,85000,5000,80000,0,0,0,0,0,0,0,0,0,1431,150,818,24,24,26
2020,893800201,10005,5,5,5,0,10000,10000,10000,0,0,0,0,0,0,100,100,0,0,598,124,60,60,24,4
2020,893800281,48129,47379,22379,14259,25000,750,0,0,0,0,750,750,0,0,0,0,0,0,4357,270,200,537,270,104
2020,893800291,52131,1231,1231,1231,0,50900,50000,50000,0,0,900,900,0,0,9340,9340,9340,0,4670,360,30,620,360,535
2020,894800221,16155,14055,1055,1055,13000,2100,0,0,0,0,2100,1900,200,0,0,0,0,0,1680,240,30,360,120,111
2020,894800291,64504,14954,14954,12954,0,49550,45000,45000,0,0,4550,4350,200,0,4400,4400,4400,0,4940,300,150,250,240,538
2020,895800231,132010,21810,17810,17810,4000,110200,110000,0,110000,0,200,200,0,0,7000,7000,7000,0,3481,960,120,300,204,268
2020,895800241,186244,3744,3744,3744,0,182500,180000,70000,110000,0,2500,2500,0,0,20000,20000,20000,0,2908,260,10,120,40,730
2020,895800271,6545,5996,3996,1996,2000,549,0,0,0,0,549,0,549,0,5700,5700,0,5000,2115,384,250,30,156,870
2020,910000102,104241,23328,23328,23328,0,80913,80000,80000,0,0,913,800,113,0,0,0,0,0,4540,180,460,180,150,616
2020,910000112,68886,68334,48334,46834,20000,552,0,0,0,0,552,100,452,0,0,0,0,0,5702,832,50,70,360,4318
2020,910000152,83600,3600,3600,3600,0,80000,80000,80000,0,0,0,0,0,0,3500,0,0,0,2790,740,120,120,240,333
2020,910000162,170560,20560,20560,18060,0,150000,150000,135000,15000,0,0,0,0,0,83000,72000,62000,10000,5553,243,100,100,240,2855
2020,910000172,10450,10450,3150,3150,7300,0,0,0,0,0,0,0,0,0,0,0,0,0,1267,140,112,80,80,9
2020,910000182,150200,200,200,200,0,150000,150000,150000,0,0,0,0,0,0,100000,60000,60000,0,1850,600,120,10,120,632
2020,910000202,13364,3550,3550,3550,0,9814,8500,8500,0,0,1314,600,714,0,60,60,0,0,1818,184,60,360,122,31
2020,910000212,23142,11242,5242,5242,6000,11900,0,0,0,0,11900,3900,0,8000,0,0,0,0,1736,216,90,280,180,79
2020,910000222,71286,24810,24810,24810,0,46476,44250,21000,23250,0,2226,2000,226,0,0,0,0,0,1790,252,30,180,54,402
2020,910000232,25025,25,25,25,0,25000,25000,25000,0,0,0,0,0,0,0,0,0,0,721,180,120,15,36,27
2020,910000242,1510,1510,10,10,1500,0,0,0,0,0,0,0,0,0,0,0,0,0,600,78,6,18,18,0
2020,910000252,105722,35850,35850,35850,0,69872,68000,38000,30000,0,1872,1872,0,0,0,0,0,0,2335,354,67,324,247,223
2020,910000262,21040,30,30,30,0,21010,21000,21000,0,0,10,0,10,0,0,0,0,0,1030,180,63,36,20,20
2020,910000272,25855,3455,3455,3455,0,22400,22000,22000,0,0,400,400,0,0,27000,27000,14000,13000,4150,300,70,480,480,153
2020,910000282,31707,1640,1640,1640,0,30067,30000,30000,0,0,67,0,67,0,65,65,0,0,930,180,180,36,72,33
2020,910000292,60200,200,200,200,0,60000,60000,10000,50000,0,0,0,0,0,24700,14700,14700,0,1152,240,72,0,30,203
2020,910000302,48610,1110,1110,1110,0,47500,45000,45000,0,0,2500,2500,0,0,24600,24600,21600,0,3280,250,100,350,480,147
2020,910000312,53200,15200,5700,5700,9500,38000,38000,0,38000,0,0,0,0,0,5000,0,0,0,1274,180,80,144,120,196
2020,910000322,31867,3967,3967,3967,0,27900,27700,27700,0,0,200,200,0,0,6000,3000,0,0,2103,380,150,372,144,63
2020,910000342,61600,36100,36100,36100,0,25500,22000,22000,0,0,3500,3000,500,0,12500,12500,9000,3500,4350,500,150,300,300,199
2020,910000362,10000,1700,700,700,1000,8300,8000,0,8000,0,300,300,0,0,4000,4000,4000,0,4450,1000,300,600,250,56
2020,910000372,2080,1380,380,380,1000,700,0,0,0,0,700,700,0,0,0,0,0,0,3233,981,150,200,144,176
2020,910000392,41047,30648,2648,2648,28000,10399,10076,0,1000,9076,323,300,23,0,15280,15280,14000,1000,4240,300,10,300,300,538
2020,910600131,1870,1870,870,870,1000,0,0,0,0,0,0,0,0,0,0,0,0,0,1220,55,100,10,55,3
2020,910600161,1706,1406,1206,1206,200,300,0,0,0,0,300,300,0,0,255,255,0,250,1556,576,20,100,140,194
2020,910600181,3730,3730,130,130,3600,0,0,0,0,0,0,0,0,0,524,524,0,524,1010,220,180,50,120,1
2020,910600191,42589,21989,8989,8989,13000,20600,20000,0,20000,0,600,600,0,0,0,0,0,0,1610,300,50,120,60,489
2020,910600201,191650,1150,1150,1150,0,190500,188000,188000,0,0,2500,0,2500,0,68953,53953,40000,13953,4340,310,320,250,240,1544
2020,910600211,1810,1810,1810,1810,0,0,0,0,0,0,0,0,0,0,4650,4650,50,4600,966,516,12,18,60,1
2020,910600221,5878,5878,3178,3178,2700,0,0,0,0,0,0,0,0,0,0,0,0,0,1218,90,30,60,18,1
2020,910600231,2159,2159,1159,1159,1000,0,0,0,0,0,0,0,0,0,0,0,0,0,1694,345,70,192,117,1
2020,910600241,27814,5814,5814,4314,0,22000,22000,22000,0,0,0,0,0,0,10750,10750,10750,0,2450,290,120,70,150,391
2020,910600251,280,280,280,280,0,0,0,0,0,0,0,0,0,0,0,0,0,0,1285,150,84,96,60,26
2020,910600261,51967,21967,21967,21967,0,30000,28000,28000,0,0,2000,2000,0,0,17378,17378,15800,0,2400,200,100,480,50,340
2020,910600271,57834,4789,4789,4789,0,53045,53000,20000,33000,0,45,45,0,0,4500,0,0,0,1466,128,100,86,72,83
2020,910600281,67678,10028,10028,8028,0,57650,55000,50000,5000,0,2650,2500,150,0,10500,10500,0,9500,4260,480,380,300,180,752
2020,910600321,40158,29980,1980,1980,28000,10178,0,0,0,0,10178,1500,8678,0,866,866,0,866,4114,240,200,220,264,51
2020,910600341,30594,5594,5594,5594,0,25000,25000,25000,0,0,0,0,0,0,0,0,0,0,2341,210,120,120,240,310
2020,910600351,129866,34956,34956,34956,0,94910,91900,59900,32000,0,3010,1250,1760,0,0,0,0,0,5212,240,1932,500,276,3090
2020,910600361,190106,89806,72806,72806,17000,100300,100000,0,100000,0,300,300,0,0,100000,100000,0,100000,3508,744,660,120,84,56
2020,910600371,72711,30211,30211,30211,0,42500,38000,38000,0,0,4500,4500,0,0,7120,7120,4300,0,3638,720,60,420,168,398
2020,910600381,95260,5760,5760,5760,0,89500,85000,55000,30000,0,4500,3700,800,0,36800,36800,26800,10000,7410,360,150,250,350,576
2020,910700111,113500,31500,31500,31500,0,82000,80000,80000,0,0,2000,2000,0,0,0,0,0,0,2740,180,1500,130,20,108
2020,910700171,21200,200,200,200,0,21000,21000,16000,5000,0,0,0,0,0,3000,0,0,0,1799,342,1000,15,72,38
2020,910700181,58400,2800,2800,1100,0,55600,55000,55000,0,0,600,600,0,0,7440,7440,6400,500,3510,400,100,240,320,120
2020,910700201,50100,1100,1100,1100,0,49000,48000,9000,39000,0,1000,1000,0,0,2280,80,0,0,1229,178,178,96,48,93
2020,910700211,21100,2650,2650,2650,0,18450,18000,18000,0,0,450,450,0,0,4030,30,0,0,2603,486,46,480,120,56
2020,910700221,28769,9001,9001,9001,0,19768,17000,17000,0,0,2768,2530,238,0,3650,3650,3650,0,3048,126,480,540,247,80
2020,910700231,150250,250,250,250,0,150000,150000,20000,130000,0,0,0,0,0,114000,114000,60000,54000,1531,300,400,15,36,161
2020,910700241,10235,5690,5690,5690,0,4545,4500,4500,0,0,45,0,45,0,0,0,0,0,976,74,100,36,57,17
2020,910700251,6881,6793,5963,5963,830,88,0,0,0,0,88,0,88,0,0,0,0,0,509,56,30,24,24,1
2020,910700261,20833,17494,10494,5494,7000,3339,0,0,0,0,3339,0,339,3000,2700,2700,0,2700,954,200,56,60,120,4
2020,910700271,118363,45360,37360,34360,8000,73003,68000,0,68000,0,5003,1935,3068,0,20000,20000,20000,0,3772,360,300,540,340,280
2020,910700281,303,303,3,3,300,0,0,0,0,0,0,0,0,0,0,0,0,0,430,68,10,10,42,0
2020,910700291,64660,24520,24520,24520,0,40140,39500,20000,19500,0,640,640,0,0,1000,0,0,0,1773,240,300,144,78,146
2020,910700341,1740,240,40,40,200,1500,0,0,0,0,1500,1500,0,0,900,900,0,550,1516,360,10,240,96,27
2020,910700361,218916,8116,8116,8116,0,210800,174000,32000,140000,2000,36800,5800,11000,20000,26020,11720,8000,0,4570,360,480,600,480,326
2020,910700371,14516,14321,10321,10321,4000,195,0,0,0,0,195,195,0,0,0,0,0,0,2852,660,100,200,96,201
2020,910700381,41976,23800,5800,5800,18000,18176,8000,0,0,8000,10176,950,226,9000,0,0,0,0,2137,192,100,600,180,13
2020,910700391,33610,1060,1060,1060,0,32550,30000,30000,0,0,2550,2550,0,0,0,0,0,0,2256,180,40,240,192,44
2020,910701111,20214,2214,2214,1814,0,18000,18000,18000,0,0,0,0,0,0,2120,2120,2000,0,2584,432,20,180,204,67
2020,910800101,245010,102210,45210,45210,57000,142800,141000,0,141000,0,1800,1500,300,0,76650,9500,9500,0,5700,300,500,300,150,615
2020,910800121,722,722,222,222,500,0,0,0,0,0,0,0,0,0,0,0,0,0,715,170,30,100,95,1
2020,910800141,218306,8306,8306,8306,0,210000,210000,110000,100000,0,0,0,0,0,15000,0,0,0,2480,180,120,80,80,505
2020,910800211,31720,6720,6720,6720,0,25000,25000,25000,0,0,0,0,0,0,1000,0,0,0,7820,1000,50,1000,720,284
2020,910800221,401,401,201,201,200,0,0,0,0,0,0,0,0,0,0,0,0,0,1360,320,110,84,60,1
2020,910800231,5,5,5,5,0,0,0,0,0,0,0,0,0,0,200,200,0,0,475,144,120,36,15,0
2020,910800251,27010,10,10,10,0,27000,27000,27000,0,0,0,0,0,0,500,0,0,0,891,120,70,86,85,18
2020,910800261,339780,27780,27780,27780,0,312000,305000,85000,220000,0,7000,5000,2000,0,40000,30000,30000,0,10980,720,700,600,380,7435
2020,910800271,20680,2880,2880,2880,0,17800,17000,14000,0,3000,800,800,0,0,10408,10408,5508,2900,3315,180,35,700,200,104
2020,910800281,13078,878,878,878,0,12200,12000,12000,0,0,200,200,0,0,7950,7950,7800,150,2434,180,10,240,144,29
2020,910800291,8980,8730,2730,2730,6000,250,0,0,0,0,250,250,0,0,0,0,0,0,2686,240,10,360,156,29
2020,910800301,12398,12398,6398,6398,6000,0,0,0,0,0,0,0,0,0,0,0,0,0,820,120,10,60,60,88
2020,910800311,11100,10940,5440,5440,5500,160,0,0,0,0,160,160,0,0,0,0,0,0,1504,84,10,240,120,16
2020,910800321,52300,2300,2300,2300,0,50000,50000,50000,0,0,0,0,0,0,0,0,0,0,596,220,100,10,36,43
2020,910800341,27020,18320,1320,1320,17000,8700,7000,0,0,7000,1700,1700,0,0,35463,35463,11000,24463,1459,180,20,100,84,227
2020,910800371,4220,3620,620,620,3000,600,0,0,0,0,600,600,0,0,0,0,0,0,492,69,5,110,90,8
2020,910900121,97271,1771,1771,1771,0,95500,85000,85000,0,0,10500,2500,0,8000,28700,16700,14000,500,6000,300,200,1100,400,124
2020,910900131,21870,21870,3870,3870,18000,0,0,0,0,0,0,0,0,0,100,100,0,0,2900,200,500,240,400,18
2020,910900151,70140,54640,3640,3640,51000,15500,0,0,0,0,15500,15500,0,0,34000,34000,14000,5000,2420,200,80,200,180,679
2020,910900171,66800,18220,18220,18220,0,48580,48000,48000,0,0,580,450,130,0,0,0,0,0,1679,600,120,15,64,92
2020,910900191,87226,1226,1226,1226,0,86000,86000,86000,0,0,0,0,0,0,27000,2000,2000,0,1200,180,96,60,48,109
2020,910900201,17310,10310,10310,10310,0,7000,7000,7000,0,0,0,0,0,0,0,0,0,0,1542,170,180,100,72,26
2020,910900211,37427,13345,13345,11345,0,24082,16000,16000,0,0,8082,4000,2082,2000,16976,16976,12664,1000,4600,240,1000,60,60,102
2020,910900221,85562,14580,14580,14580,0,70982,69000,56000,13000,0,1982,1800,182,0,13560,13560,4230,9330,5356,336,1500,600,240,473
2020,910900241,10050,7050,1100,1100,5950,3000,0,0,0,0,3000,3000,0,0,0,0,0,0,2027,84,5,180,108,26
2020,910900251,17261,2261,2261,2261,0,15000,15000,15000,0,0,0,0,0,0,0,0,0,0,3100,240,100,250,260,17
2020,910900261,10060,60,60,60,0,10000,10000,10000,0,0,0,0,0,0,0,0,0,0,708,90,60,10,48,12
2020,910900271,11463,818,818,818,0,10645,8900,8900,0,0,1745,1700,45,0,1452,1452,1450,0,2404,240,230,120,456,67
2020,910900281,21221,8821,8821,8821,0,12400,12400,12400,0,0,0,0,0,0,1928,1928,1928,0,1502,120,48,60,48,13
2020,910900321,20982,15982,12582,11582,3400,5000,5000,0,5000,0,0,0,0,0,0,0,0,0,1110,50,30,110,120,35
2020,910900341,5340,4440,3440,3440,1000,900,0,0,0,0,900,900,0,0,0,0,0,0,1538,348,30,220,200,61
2020,910900351,21395,2155,2155,2155,0,19240,17000,17000,0,0,2240,2240,0,0,14000,14000,10000,0,2540,200,350,500,160,51
2020,910900371,42555,2325,2325,2325,0,40230,40000,40000,0,0,230,200,30,0,10000,10000,10000,0,1870,240,30,240,130,85
2020,910900381,100736,46738,46738,46738,0,53998,52898,35000,0,17898,1100,1100,0,0,14915,14915,0,14915,4910,300,80,960,420,200
2020,911000102,3030,3030,30,30,3000,0,0,0,0,0,0,0,0,0,0,0,0,0,653,120,0,11,20,1
2020,911000112,27100,26500,3500,3500,23000,600,0,0,0,0,600,600,0,0,0,0,0,0,1280,172,10,180,108,81
2020,911000142,580,580,80,80,500,0,0,0,0,0,0,0,0,0,1000,1000,0,0,2076,500,20,70,336,2
2020,911000152,42070,4970,4970,4970,0,37100,35000,35000,0,0,2100,2100,0,0,0,0,0,0,2088,240,120,72,96,68
2020,911000162,11858,3458,1458,1458,2000,8400,8000,0,8000,0,400,400,0,0,4600,4600,4300,0,3030,540,500,240,180,148
2020,911000172,28010,160,160,160,0,27850,27000,27000,0,0,850,800,50,0,15000,15000,15000,0,2056,240,36,600,180,37
2020,911000192,10670,9970,1970,1970,8000,700,0,0,0,0,700,700,0,0,0,0,0,0,1556,500,2,120,84,521
2020,911000222,340000,76000,76000,76000,0,264000,250000,40000,200000,10000,14000,2000,12000,0,15000,15000,15000,0,6450,1500,1800,1000,200,1554
2020,911000232,93580,3580,3580,2580,0,90000,81000,80000,0,1000,9000,3600,5400,0,4000,4000,4000,0,5710,480,50,360,120,3477
2020,911000242,7376,2076,2076,2076,0,5300,5300,5300,0,0,0,0,0,0,2100,2100,0,0,650,50,30,20,100,40
2020,911000262,9700,100,100,100,0,9600,9600,9600,0,0,0,0,0,0,0,0,0,0,2370,180,10,100,200,49
2020,911000272,4600,4600,900,900,3700,0,0,0,0,0,0,0,0,0,30,30,0,0,2248,84,20,84,120,1
2020,911000282,63160,1660,1660,1660,0,61500,60000,60000,0,0,1500,1500,0,0,2600,2600,2400,0,2439,480,100,240,84,40
2020,911000292,10,10,10,10,0,0,0,0,0,0,0,0,0,0,2069,2069,0,2000,1396,240,50,240,96,44
2020,911000312,13980,13180,2180,2180,11000,800,0,0,0,0,800,800,0,0,0,0,0,0,2094,100,120,450,144,19
2020,911000332,7594,6444,3444,3444,3000,1150,0,0,0,0,1150,1000,150,0,0,0,0,0,1374,144,10,180,282,46
2020,911000352,5808,5808,3608,3608,2200,0,0,0,0,0,0,0,0,0,50,50,0,0,1960,360,50,20,100,24
2020,911000362,62800,2300,2300,2300,0,60500,60000,0,60000,0,500,500,0,0,10000,0,0,0,5350,396,144,180,420,73
2020,911000372,143164,1010,1010,1010,0,142154,142000,130000,0,12000,154,154,0,0,16000,10000,10000,0,5620,360,350,840,300,549
2020,911000392,119193,55733,55733,45733,0,63460,55000,55000,0,0,8460,460,5000,3000,27810,27810,26600,0,3119,313,100,420,280,430
2020,911600111,5796,5796,2796,2796,3000,0,0,0,0,0,0,0,0,0,300,300,300,0,1088,108,30,120,180,2
2020,911600141,10580,8980,1980,1980,7000,1600,0,0,0,0,1600,1600,0,0,2000,2000,0,0,2506,120,100,360,96,85
2020,911600161,11582,5632,4632,3632,1000,5950,0,0,0,0,5950,2450,500,3000,5230,5230,0,3000,3570,730,120,360,240,340
2020,911600201,34160,5160,5160,5160,0,29000,29000,25000,4000,0,0,0,0,0,6500,3500,3500,0,3078,160,280,180,220,47
2020,911600211,137078,9928,9928,9928,0,127150,105300,39000,53000,13300,21850,9000,12850,0,2500,2500,2500,0,3870,240,50,500,180,1176
2020,911600221,6030,6030,30,30,6000,0,0,0,0,0,0,0,0,0,0,0,0,0,922,210,120,178,14,12
2020,911600241,2080,2080,80,80,2000,0,0,0,0,0,0,0,0,0,0,0,0,0,584,84,96,24,30,1
2020,911600251,34320,3230,3230,3230,0,31090,31000,19000,12000,0,90,0,90,0,2800,300,0,300,946,168,120,20,18,25
2020,911600261,1426,1200,1200,1200,0,226,0,0,0,0,226,0,226,0,0,0,0,0,1056,132,150,25,48,24
2020,911600271,12550,1550,1550,1550,0,11000,11000,11000,0,0,0,0,0,0,0,0,0,0,1346,276,150,120,60,45
2020,911600281,32330,10230,10230,10230,0,22100,14000,14000,0,0,8100,500,100,7500,0,0,0,0,4260,276,400,240,324,39
2020,911600301,21000,1000,1000,1000,0,20000,20000,20000,0,0,0,0,0,0,0,0,0,0,1180,150,500,40,50,47
2020,911600331,94628,1628,1628,1628,0,93000,90000,75000,15000,0,3000,3000,0,0,35635,35135,33385,0,4630,400,1500,300,200,166
2020,911600341,210060,7060,7060,7060,0,203000,200000,100000,100000,0,3000,3000,0,0,59000,9000,9000,0,2014,360,300,120,144,285
2020,911600351,6364,6364,1364,1364,5000,0,0,0,0,0,0,0,0,0,2160,2160,1800,100,623,35,50,50,48,1
2020,911600381,154142,50642,23642,23642,27000,103500,100400,0,100400,0,3100,3100,0,0,57000,0,0,0,4200,360,100,500,108,210
2020,911600391,214000,3800,3800,3800,0,210200,210000,120000,90000,0,200,200,0,0,18800,7300,4500,2800,1676,360,36,200,80,274
2020,911700101,105574,8674,8674,8674,0,96900,95000,59000,36000,0,1900,1900,0,0,2000,0,0,0,5810,350,300,350,410,222
2020,911700111,10960,10890,890,890,10000,70,0,0,0,0,70,70,0,0,0,0,0,0,3490,240,600,280,270,67
2020,911700121,11725,11725,1725,1725,10000,0,0,0,0,0,0,0,0,0,4650,4650,1500,1600,1900,400,120,120,180,1
2020,911700141,61880,1380,1380,1380,0,60500,60500,60500,0,0,0,0,0,0,8000,8000,8000,0,2581,270,40,15,96,66
2020,911700171,47346,29146,12146,2146,17000,18200,18000,0,18000,0,200,0,200,0,1000,0,0,0,4000,100,30,120,120,198
2020,911700201,13803,13603,2603,2603,11000,200,0,0,0,0,200,100,100,0,3900,3900,3500,400,1510,90,10,100,140,7
2020,911700211,3050,3050,50,50,3000,0,0,0,0,0,0,0,0,0,0,0,0,0,789,344,92,15,28,1
2020,911700231,29316,7196,7196,7196,0,22120,20000,0,20000,0,2120,1800,320,0,500,500,0,0,1872,128,1000,84,50,68
2020,911700241,21462,1262,1262,1262,0,20200,19000,19000,0,0,1200,1200,0,0,0,0,0,0,2820,180,20,800,270,23
2020,911700251,40334,18954,6954,6954,12000,21380,20000,0,0,20000,1380,1000,380,0,0,0,0,0,2540,240,120,420,240,108
2020,911700291,55149,12186,12186,12186,0,42963,32000,0,32000,0,10963,3100,113,7750,17500,15000,15000,0,2700,210,5,180,120,1219
2020,911700301,4262,2612,2312,2312,300,1650,0,0,0,0,1650,1650,0,0,4300,4300,0,4300,3054,370,60,1010,396,107
2020,911700311,60364,7364,7364,6164,0,53000,53000,15000,38000,0,0,0,0,0,6700,2700,2500,200,1559,100,33,10,180,74
2020,911700331,209510,19510,19510,19510,0,190000,188000,38000,150000,0,2000,2000,0,0,20200,10200,10000,200,4040,300,400,200,240,370
2020,911700351,236360,26860,26860,26860,0,209500,200000,110000,90000,0,9500,8000,1500,0,65100,64100,60000,0,12130,660,600,720,250,2463
2020,911700361,15730,530,30,30,500,15200,14000,0,14000,0,1200,0,500,700,8530,8530,8000,500,1844,220,350,120,144,23
2020,911700371,9633,9133,7833,4833,1300,500,0,0,0,0,500,0,0,500,2450,2450,1500,750,1165,370,55,50,130,1
2020,911700381,11988,3488,3188,2688,300,8500,0,0,0,0,8500,5500,3000,0,7156,7156,0,850,2642,540,50,360,84,421
2020,911700391,2733,2733,163,163,2570,0,0,0,0,0,0,0,0,0,0,0,0,0,456,192,30,24,20,1
2020,911800101,89638,29988,29988,29988,0,59650,55000,55000,0,0,4650,4650,0,0,0,0,0,0,4550,360,200,360,360,2524
2020,911800111,18042,17700,9700,9700,8000,342,0,0,0,0,342,0,342,0,0,0,0,0,3116,300,20,240,156,88
2020,911800171,158200,58200,58200,58200,0,100000,100000,70000,30000,0,0,0,0,0,1011,11,0,0,5804,360,2500,240,72,380
2020,911800201,46441,14482,14482,14482,0,31959,27500,27000,500,0,4459,4300,159,0,0,0,0,0,3000,250,300,200,300,343
2020,911800211,39820,220,220,220,0,39600,33000,29000,4000,0,6600,1600,5000,0,23100,23100,19000,4100,4180,480,10,600,480,79
2020,911800221,80540,10040,10040,10040,0,70500,70000,48000,22000,0,500,200,300,0,23,23,0,0,1754,243,45,140,122,140
2020,911800231,35410,34360,1360,1360,33000,1050,0,0,0,0,1050,800,250,0,0,0,0,0,851,136,50,45,36,15
2020,911800241,102350,75550,45550,45550,30000,26800,26000,0,26000,0,800,800,0,0,0,0,0,0,3015,240,35,480,240,1502
2020,911800261,10,10,10,10,0,0,0,0,0,0,0,0,0,0,2000,2000,0,0,1050,240,0,120,120,21
2020,911800271,56060,60,60,60,0,56000,56000,56000,0,0,0,0,0,0,20730,18130,16000,2130,800,130,40,20,50,21
2020,911800281,17600,17600,1100,1100,16500,0,0,0,0,0,0,0,0,0,1000,1000,0,0,930,180,60,24,66,25
2020,911800291,40540,6240,6240,4240,0,34300,25000,25000,0,0,9300,2350,3450,3500,3500,3500,3500,0,1523,168,5,150,120,67
2020,911800311,79646,1946,1946,1796,0,77700,77000,77000,0,0,700,700,0,0,15951,15951,14800,600,5526,276,20,650,280,129
2020,911800321,112350,1660,1660,1660,0,110690,105000,80000,25000,0,5690,690,5000,0,22500,22500,22500,0,3600,480,240,240,240,335
2020,911800331,11704,11204,3204,3204,8000,500,0,0,0,0,500,300,200,0,0,0,0,0,1920,250,100,150,130,103
2020,911800381,4100,4100,100,100,4000,0,0,0,0,0,0,0,0,0,0,0,0,0,1131,198,168,20,25,1
2020,911900141,616,616,116,116,500,0,0,0,0,0,0,0,0,0,0,0,0,0,1131,360,160,36,60,8
2020,911900151,64810,17810,12010,12010,5800,47000,47000,0,47000,0,0,0,0,0,20000,0,0,0,960,96,120,36,30,74
2020,911900161,115309,309,309,309,0,115000,115000,70000,45000,0,0,0,0,0,23500,15000,0,0,1480,220,100,40,50,352
2020,911900171,1143,743,243,243,500,400,0,0,0,0,400,400,0,0,250,250,250,0,1620,760,20,120,200,26
2020,911900181,630,630,130,130,500,0,0,0,0,0,0,0,0,0,900,900,0,800,1940,500,30,70,120,5
2020,911900191,140250,27250,27250,27250,0,113000,90000,65000,25000,0,23000,3000,20000,0,2200,0,0,0,7224,260,550,850,260,298
2020,911900201,1860,1860,1860,1860,0,0,0,0,0,0,0,0,0,0,0,0,0,0,484,120,60,20,24,1
2020,911900231,62610,6810,6810,6810,0,55800,55000,12000,43000,0,800,800,0,0,11489,10489,10489,0,3080,240,80,480,180,258
2020,911900241,280,280,30,30,250,0,0,0,0,0,0,0,0,0,0,0,0,0,719,95,60,24,24,0
2020,911900251,7300,1300,1300,1300,0,6000,6000,6000,0,0,0,0,0,0,0,0,0,0,450,80,50,60,30,7
2020,911900261,11708,2608,2608,2608,0,9100,9000,9000,0,0,100,0,100,0,1000,1000,1000,0,1974,200,50,200,144,46
2020,911900271,22830,7830,7830,7830,0,15000,15000,15000,0,0,0,0,0,0,80,80,0,0,4170,240,50,400,400,309
2020,911900281,123928,21432,21432,21432,0,102496,92300,50000,40000,2300,10196,7100,96,3000,48000,48000,48000,0,3334,240,24,700,300,245
2020,911900291,17140,4140,140,140,4000,13000,13000,0,13000,0,0,0,0,0,3500,0,0,0,920,100,100,50,30,13
2020,911900341,280270,270,270,270,0,280000,280000,280000,0,0,0,0,0,0,35000,30000,30000,0,2580,360,350,90,60,321
2020,911900371,4623,4623,4123,4123,500,0,0,0,0,0,0,0,0,0,20,20,0,0,2044,540,25,240,144,65
2020,911900391,27170,27170,3170,3170,24000,0,0,0,0,0,0,0,0,0,0,0,0,0,918,300,60,15,15,49
2020,912000102,19030,3558,2558,2558,1000,15472,0,0,0,0,15472,10472,0,5000,4620,4620,1620,3000,5041,672,250,408,240,94
2020,912000112,159640,57440,4440,4440,53000,102200,100000,0,100000,0,2200,2200,0,0,84500,49500,39500,10000,4970,480,120,540,180,2896
2020,912000142,45500,24000,24000,24000,0,21500,21500,21500,0,0,0,0,0,0,0,0,0,0,2839,132,1000,84,60,92
2020,912000172,29914,3594,3594,3594,0,26320,26000,26000,0,0,320,320,0,0,9096,9096,8896,200,4606,350,150,216,210,81
2020,912000182,82074,16074,16074,16074,0,66000,35000,35000,0,0,31000,1000,30000,0,12770,12770,6000,6670,4870,264,500,240,396,174
2020,912000202,37760,2760,2760,2760,0,35000,33000,16000,17000,0,2000,1500,500,0,8000,5000,5000,0,1980,210,120,240,120,73
2020,912000222,16240,1240,1240,1240,0,15000,15000,15000,0,0,0,0,0,0,250,0,0,0,936,120,120,36,60,16
2020,912000232,16100,1100,1100,1100,0,15000,12000,12000,0,0,3000,3000,0,0,8100,8100,4500,0,2290,200,150,360,120,129
2020,912000242,26540,2540,2540,540,0,24000,24000,24000,0,0,0,0,0,0,4950,4950,2200,2750,1414,168,60,80,156,56
2020,912000262,19596,1584,1584,584,0,18012,17800,17800,0,0,212,100,112,0,10893,10893,10730,0,1878,183,243,250,268,44
2020,912000272,21340,2140,2140,1140,0,19200,16800,16800,0,0,2400,1900,500,0,9800,9800,9800,0,4150,320,120,600,480,104
2020,912000282,21420,1320,1320,1320,0,20100,20000,20000,0,0,100,0,100,0,120,0,0,0,958,180,72,60,24,51
2020,912000292,1000,1000,500,500,500,0,0,0,0,0,0,0,0,0,0,0,0,0,1086,60,240,10,36,1
2020,912000302,5,5,5,5,0,0,0,0,0,0,0,0,0,0,0,0,0,0,631,180,9,60,36,1
2020,912000312,20044,44,44,20,0,20000,20000,0,20000,0,0,0,0,0,19000,0,0,0,969,120,120,18,60,15
2020,912000332,71809,5896,5896,4896,0,65913,65000,40000,25000,0,913,800,113,0,20100,5100,5000,0,2500,360,300,360,120,53
2020,912000352,119160,40160,40160,38160,0,79000,70000,70000,0,0,9000,200,0,8800,22000,22000,22000,0,5900,480,50,360,240,153
2020,912000372,15100,100,100,100,0,15000,15000,0,15000,0,0,0,0,0,1350,1350,0,1350,941,190,100,20,30,13
2020,912000382,20600,8800,8800,8800,0,11800,10000,10000,0,0,1800,1800,0,0,20,20,0,0,4500,240,180,720,480,97
2020,912000392,1330,930,430,430,500,400,0,0,0,0,400,400,0,0,2000,2000,0,2000,1344,462,48,120,90,221
2020,912600101,147235,25420,25420,25420,0,121815,121000,81000,40000,0,815,315,500,0,4720,720,720,0,8120,400,100,340,250,2064
2020,912600121,26560,4460,4460,2960,0,22100,20000,20000,0,0,2100,600,0,1500,0,0,0,0,4999,277,700,540,450,64
2020,912600131,134380,4240,4240,4240,0,130140,130000,90000,40000,0,140,0,140,0,4000,0,0,0,4276,468,2500,60,120,238
2020,912600141,83558,30558,30558,30558,0,53000,53000,50000,3000,0,0,0,0,0,1970,270,270,0,2322,388,50,192,216,541
2020,912600161,656,656,356,356,300,0,0,0,0,0,0,0,0,0,0,0,0,0,590,246,10,10,24,1
2020,912600171,49650,650,650,650,0,49000,49000,49000,0,0,0,0,0,0,9980,9980,9980,0,5250,2740,10,240,120,290
2020,912600181,13280,13080,80,80,13000,200,0,0,0,0,200,200,0,0,0,0,0,0,2360,480,60,120,180,32
2020,912600191,76720,19120,19120,19120,0,57600,55000,55000,0,0,2600,2300,300,0,17600,17600,17600,0,3938,350,100,360,168,913
2020,912600201,58182,25682,14182,14182,11500,32500,30000,0,0,30000,2500,2500,0,0,20,20,0,0,3770,300,50,240,240,133
2020,912600211,2500,2500,500,500,2000,0,0,0,0,0,0,0,0,0,0,0,0,0,1523,257,20,50,96,24
2020,912600221,55800,8600,8600,8600,0,47200,47000,45000,2000,0,200,200,0,0,20000,20000,20000,0,4290,320,10,240,240,89
2020,912600251,78990,20840,840,840,20000,58150,58000,0,58000,0,150,0,150,0,28000,22000,0,22000,2650,245,730,120,48,66
2020,912600271,34880,5880,5880,5880,0,29000,28000,28000,0,0,1000,1000,0,0,1320,1320,0,1200,4788,278,100,300,240,238
2020,912600281,51749,11049,11049,9049,0,40700,40000,40000,0,0,700,700,0,0,26000,26000,26000,0,3070,360,120,300,360,87
2020,912600291,52065,11715,11715,11715,0,40350,40000,15000,25000,0,350,350,0,0,41097,23097,0,23097,2839,183,75,320,336,1316
2020,912600341,30112,12332,12332,11332,0,17780,17500,17500,0,0,280,280,0,0,5520,5520,5520,0,2119,300,120,150,180,86
2020,912600351,68238,7138,7138,7138,0,61100,55000,27000,0,28000,6100,5800,300,0,43580,43580,43150,0,2960,300,30,240,240,254
2020,912600391,34724,8974,8974,8974,0,25750,25000,25000,0,0,750,300,450,0,0,0,0,0,2430,360,120,360,240,531
2020,912700101,51395,2395,2395,2395,0,49000,49000,30000,19000,0,0,0,0,0,25500,12500,12500,0,2930,180,400,360,204,183
2020,912700121,6878,6878,5878,5878,1000,0,0,0,0,0,0,0,0,0,1520,1520,1500,0,2002,768,100,96,132,1
2020,912700161,95000,7500,7500,7500,0,87500,87500,68000,19500,0,0,0,0,0,0,0,0,0,960,204,100,30,36,79
2020,912700171,185920,58120,58120,58120,0,127800,125000,80000,45000,0,2800,800,2000,0,41000,39000,31000,8000,8550,500,100,500,250,3597
2020,912700181,20300,300,300,300,0,20000,20000,20000,0,0,0,0,0,0,0,0,0,0,812,240,100,12,50,29
2020,912700191,35412,7412,7412,7412,0,28000,28000,28000,0,0,0,0,0,0,1550,1550,1400,0,1990,230,100,80,40,102
2020,912700201,78400,13900,13900,13900,0,64500,60000,60000,0,0,4500,3500,1000,0,0,0,0,0,3984,480,480,360,120,2528
2020,912700231,12762,4762,4762,4762,0,8000,8000,8000,0,0,0,0,0,0,0,0,0,0,1410,180,24,84,72,14
2020,912700271,26620,12220,12220,12220,0,14400,14000,14000,0,0,400,400,0,0,0,0,0,0,2290,140,150,300,120,56
2020,912700281,43186,15866,15866,13866,0,27320,23000,15000,8000,0,4320,1320,3000,0,12622,12622,10775,1340,3462,210,200,360,264,175
2020,912700311,79780,7000,7000,7000,0,72780,72000,72000,0,0,780,780,0,0,10900,10900,10900,0,2160,180,100,70,86,121
2020,912700321,28245,3245,3245,3245,0,25000,25000,25000,0,0,0,0,0,0,0,0,0,0,2952,300,500,120,240,38
2020,912700351,13850,250,250,250,0,13600,12000,12000,0,0,1600,1600,0,0,10186,10186,8910,0,3084,300,60,324,180,355
2020,912700361,82400,7800,7800,7800,0,74600,73000,45000,28000,0,1600,1300,300,0,16000,6000,6000,0,2280,280,100,250,120,489
2020,912700371,65087,12887,12887,12767,0,52200,50000,50000,0,0,2200,2000,200,0,180,180,0,0,2246,280,100,250,100,147
2020,912700381,10120,120,120,120,0,10000,10000,10000,0,0,0,0,0,0,8300,8300,5000,3250,965,65,10,130,160,98
2020,912800101,8045,8045,3045,45,5000,0,0,0,0,0,0,0,0,0,0,0,0,0,1518,510,24,60,60,1
2020,912800111,48557,10439,10439,8739,0,38118,38000,38000,0,0,118,50,68,0,0,0,0,0,4026,576,550,120,180,33
2020,912800121,48849,2049,2049,2049,0,46800,38000,38000,0,0,8800,800,0,8000,7000,7000,5000,2000,1665,220,100,10,75,337
2020,912800141,37925,12425,12425,12425,0,25500,24500,24500,0,0,1000,1000,0,0,7871,7871,7871,0,3600,720,10,200,200,109
2020,912800161,76760,12360,12360,12360,0,64400,60000,60000,0,0,4400,4000,400,0,8500,8500,8500,0,4680,320,250,480,200,1280
2020,912800171,2586,2586,1086,1086,1500,0,0,0,0,0,0,0,0,0,0,0,0,0,1014,264,10,40,120,1
2020,912800191,53521,10971,10971,10971,0,42550,42000,42000,0,0,550,550,0,0,0,0,0,0,5076,250,50,330,156,770
2020,912800211,19620,4320,4320,4320,0,15300,15000,15000,0,0,300,300,0,0,150,150,0,0,2250,108,1024,180,15,30
2020,912800231,21070,2380,2380,2380,0,18690,17590,15000,0,2590,1100,900,200,0,5200,5200,2600,0,4100,240,180,360,360,235
2020,912800241,132800,12800,300,300,12500,120000,120000,0,108000,12000,0,0,0,0,62000,56000,54000,2000,1851,180,100,100,168,660
2020,912800271,38350,3580,3580,3580,0,34770,27000,27000,0,0,7770,3520,250,4000,0,0,0,0,3670,300,150,400,120,58
2020,912800281,74420,11420,11420,6420,0,63000,60000,30000,30000,0,3000,1000,0,2000,9140,9140,8140,1000,3655,300,700,700,75,228
2020,912800291,1720,1720,1220,1220,500,0,0,0,0,0,0,0,0,0,0,0,0,0,1004,180,60,90,54,1
2020,912800321,36836,36386,4386,4386,32000,450,0,0,0,0,450,150,300,0,0,0,0,0,3526,240,360,120,180,2032
2020,912800341,154080,18080,18080,18080,0,136000,133000,65000,68000,0,3000,3000,0,0,11500,8500,8500,0,3914,600,200,240,124,306
2020,912800351,30470,30470,8470,8470,22000,0,0,0,0,0,0,0,0,0,5000,5000,5000,0,2506,204,30,216,216,874
2020,912800371,1340,1340,1040,1040,300,0,0,0,0,0,0,0,0,0,0,0,0,0,900,80,20,10,22,1
2020,912800381,5340,5240,240,240,5000,100,0,0,0,0,100,100,0,0,4000,4000,4000,0,2200,240,50,150,180,34
2020,912900111,5015,3150,3150,3150,0,1865,0,0,0,0,1865,1600,265,0,0,0,0,0,4690,180,120,360,120,532
2020,912900121,56879,54684,14684,14684,40000,2195,0,0,0,0,2195,2195,0,0,20000,20000,20000,0,5160,720,120,240,480,1312
2020,912900151,73300,4300,4300,4300,0,69000,67000,65000,2000,0,2000,2000,0,0,820,820,820,0,2126,360,30,500,120,223
2020,912900161,12581,12581,581,581,12000,0,0,0,0,0,0,0,0,0,0,0,0,0,740,130,70,10,30,1
2020,912900181,3400,2400,1400,1400,1000,1000,0,0,0,0,1000,1000,0,0,100,100,0,0,3514,612,30,1200,156,70
2020,912900211,6800,6230,230,230,6000,570,0,0,0,0,570,400,170,0,2800,2800,2700,0,1760,180,150,500,80,16
2020,912900221,56400,8300,8300,8300,0,48100,43000,43000,0,0,5100,4700,400,0,200,200,0,0,4260,280,100,1000,360,2205
2020,912900251,27712,712,712,712,0,27000,27000,27000,0,0,0,0,0,0,64,64,0,0,1050,90,60,120,120,32
2020,912900271,18200,3200,3200,3200,0,15000,15000,15000,0,0,0,0,0,0,0,0,0,0,800,240,100,16,60,20
2020,912900281,92250,27800,27800,27800,0,64450,55000,55000,0,0,9450,9450,0,0,14000,14000,12000,2000,4239,285,145,520,119,495
2020,912900311,33496,10316,10316,9316,0,23180,22000,22000,0,0,1180,180,0,1000,18872,18872,15272,3600,4070,800,20,300,220,21
2020,912900321,61400,12500,12500,12500,0,48900,42000,42000,0,0,6900,1900,5000,0,7500,7500,4000,3500,2466,342,20,264,180,176
2020,912900341,40380,2380,2380,2380,0,38000,38000,38000,0,0,0,0,0,0,200,200,0,200,1200,100,96,120,120,37
2020,912900371,5650,5650,150,150,5500,0,0,0,0,0,0,0,0,0,0,0,0,0,1890,180,20,50,120,46
2020,912900381,37390,34890,2890,2890,32000,2500,0,0,0,0,2500,2500,0,0,0,0,0,0,4500,360,300,250,180,198
2020,913000112,52561,5961,5961,5961,0,46600,45000,45000,0,0,1600,1600,0,0,5900,5900,3500,2400,2732,250,212,150,120,427
2020,913000122,25818,25718,10718,10718,15000,100,0,0,0,0,100,100,0,0,0,0,0,0,3133,180,113,200,240,436
2020,913000132,42390,6890,6890,6890,0,35500,34000,34000,0,0,1500,1500,0,0,14000,14000,12000,0,3940,300,200,400,240,69
2020,913000162,24200,5000,5000,3000,0,19200,16000,16000,0,0,3200,0,2700,500,0,0,0,0,2286,156,60,84,156,26
2020,913000192,8001,8001,1,1,8000,0,0,0,0,0,0,0,0,0,8000,8000,8000,0,840,480,28,36,26,1
2020,913000202,28830,1750,1750,1750,0,27080,26000,26000,0,0,1080,750,330,0,3000,3000,3000,0,2842,320,350,192,120,368
2020,913000212,43370,5350,5350,5350,0,38020,27000,27000,0,0,11020,7800,220,3000,8600,8600,8600,0,1363,174,15,144,100,94
2020,913000222,19060,1360,1360,1360,0,17700,15800,15800,0,0,1900,1900,0,0,9856,9856,9856,0,3459,270,50,324,125,79
2020,913000262,29267,5857,5857,5857,0,23410,23000,23000,0,0,410,410,0,0,13000,13000,13000,0,4315,264,10,240,216,35
2020,913000312,23080,23080,12080,12080,11000,0,0,0,0,0,0,0,0,0,0,0,0,0,1862,180,10,80,72,38
2020,913000322,22508,5008,5008,5008,0,17500,15000,15000,0,0,2500,2500,0,0,0,0,0,0,663,15,12,240,76,121
2020,913000332,14000,700,700,700,0,13300,13000,13000,0,0,300,300,0,0,800,800,0,800,1470,180,110,250,30,56
2020,913000342,107700,82700,82700,82700,0,25000,25000,10000,15000,0,0,0,0,0,0,0,0,0,1850,580,360,40,60,16
2020,913000352,27886,9486,9486,9486,0,18400,18000,18000,0,0,400,400,0,0,0,0,0,0,3517,357,120,240,240,228
2020,913000362,103770,22270,2270,2270,20000,81500,80000,0,80000,0,1500,1500,0,0,0,0,0,0,2974,660,100,480,96,668
2020,913000372,24200,1000,1000,1000,0,23200,23000,23000,0,0,200,200,0,0,0,0,0,0,2292,480,120,240,72,58
2020,913000392,2574,2574,2334,2334,240,0,0,0,0,0,0,0,0,0,800,800,0,800,2511,204,50,288,168,2
2020,913600101,38118,118,118,118,0,38000,38000,38000,0,0,0,0,0,0,79,79,0,0,1790,300,330,70,90,39
2020,913600131,10455,10455,455,455,10000,0,0,0,0,0,0,0,0,0,0,0,0,0,1560,300,5,85,80,2
2020,913600141,8068,8068,68,68,8000,0,0,0,0,0,0,0,0,0,0,0,0,0,834,60,0,10,24,1
2020,913600151,17570,4820,4820,4820,0,12750,12000,12000,0,0,750,750,0,0,2088,2088,1188,900,2260,132,15,180,230,27
2020,913600171,7480,7480,480,480,7000,0,0,0,0,0,0,0,0,0,1660,1660,0,1500,1924,880,50,264,225,1
2020,913600181,3350,3350,350,350,3000,0,0,0,0,0,0,0,0,0,200,200,0,0,1275,240,80,20,85,30
2020,913600191,281566,9066,9066,9066,0,272500,270000,140000,130000,0,2500,2500,0,0,80500,30500,30000,500,2276,276,120,480,420,247
2020,913600201,85662,19462,19462,19462,0,66200,65000,60000,5000,0,1200,900,300,0,0,0,0,0,5750,180,200,340,240,793
2020,913600221,650,650,150,150,500,0,0,0,0,0,0,0,0,0,0,0,0,0,768,164,70,72,36,1
2020,913600231,2494,2494,134,134,2360,0,0,0,0,0,0,0,0,0,1600,1600,0,1600,988,108,20,130,120,1
2020,913600241,435,417,117,117,300,18,0,0,0,0,18,0,18,0,47,47,0,47,2065,474,15,84,320,22
2020,913600251,29448,2048,2048,2048,0,27400,27000,27000,0,0,400,400,0,0,8172,8172,7772,0,3510,230,100,390,270,151
2020,913600261,58587,187,187,187,0,58400,58000,58000,0,0,400,0,400,0,0,0,0,0,1302,570,50,50,12,73
2020,913600301,9982,9982,932,932,9050,0,0,0,0,0,0,0,0,0,8050,8050,8050,0,1462,480,120,10,72,13
2020,913600311,137400,6150,6150,6150,0,131250,129500,55000,69500,5000,1750,1450,300,0,62600,41100,41100,0,3930,300,100,300,180,790
2020,913600331,137085,4520,4520,4520,0,132565,130000,100000,30000,0,2565,2000,565,0,31000,31000,30000,1000,3460,300,150,300,90,772
2020,913600371,2080,2080,1080,1080,1000,0,0,0,0,0,0,0,0,0,0,0,0,0,1644,960,36,240,108,1
2020,913600381,18300,5300,3300,3300,2000,13000,13000,0,13000,0,0,0,0,0,1000,0,0,0,1630,100,10,150,60,172
2020,913600391,40930,14530,14530,14530,0,26400,25000,25000,0,0,1400,1400,0,0,0,0,0,0,2118,240,100,240,200,108
2020,913700101,34582,29082,1082,1082,28000,5500,4300,0,0,4300,1200,1200,0,0,20500,20500,15000,1500,1948,360,230,150,180,39
2020,913700141,43692,3692,3692,2692,0,40000,23000,23000,0,0,17000,2000,15000,0,11190,11190,9690,0,3524,108,300,100,180,24
2020,913700171,10340,10340,5340,5340,5000,0,0,0,0,0,0,0,0,0,620,620,0,620,5300,230,300,400,350,127
2020,913700181,700,700,200,200,500,0,0,0,0,0,0,0,0,0,2500,2500,0,0,974,460,4,36,24,0
2020,913700191,143626,139226,69226,69026,70000,4400,0,0,0,0,4400,3500,900,0,0,0,0,0,9740,1000,300,600,180,3706
2020,913700201,27813,700,700,700,0,27113,27000,27000,0,0,113,0,113,0,0,0,0,0,1736,168,120,60,48,11
2020,913700231,21134,100,100,100,0,21034,21000,20000,1000,0,34,0,34,0,0,0,0,0,782,200,66,36,20,16
2020,913700241,70668,6668,6668,6668,0,64000,61000,26000,35000,0,3000,0,1000,2000,23200,23200,21700,1500,6842,300,100,280,312,373
2020,913700311,34224,14044,14044,12044,0,20180,19500,19500,0,0,680,680,0,0,10920,10920,8920,2000,2810,300,120,180,180,176
2020,913700321,1550,1550,1550,1550,0,0,0,0,0,0,0,0,0,0,2300,2300,0,2300,2352,72,10,150,150,35
2020,913700341,18254,18254,3254,3254,15000,0,0,0,0,0,0,0,0,0,40,40,0,0,1572,132,50,96,168,5
2020,913700351,4325,4325,3425,3425,900,0,0,0,0,0,0,0,0,0,1770,1770,1770,0,646,264,15,30,36,1
2020,913800101,2949,2949,949,949,2000,0,0,0,0,0,0,0,0,0,3760,3760,0,1000,2190,560,20,70,160,1
2020,913800111,148248,8248,8248,6248,0,140000,140000,140000,0,0,0,0,0,0,68600,54600,43800,10800,3436,540,80,200,396,167
2020,913800121,3030,3030,30,30,3000,0,0,0,0,0,0,0,0,0,250,250,0,250,608,90,300,10,28,1
2020,913800131,9060,7460,2460,2460,5000,1600,0,0,0,0,1600,1600,0,0,0,0,0,0,3916,1200,50,480,156,398
2020,913800151,50220,5020,5020,5020,0,45200,45000,45000,0,0,200,0,200,0,17200,17200,17000,0,5750,240,200,150,360,3519
2020,913800161,60300,200,200,200,0,60100,60000,60000,0,0,100,100,0,0,35200,35200,35200,0,1970,700,30,50,180,31
2020,913800181,45070,3510,3510,3510,0,41560,40000,40000,0,0,1560,1560,0,0,5100,5100,5000,100,8056,276,180,120,420,1739
2020,913800191,4960,4960,1960,1960,3000,0,0,0,0,0,0,0,0,0,320,320,0,320,2056,840,10,250,156,1
2020,913800201,160,50,50,50,0,110,0,0,0,0,110,0,110,0,0,0,0,0,581,63,10,28,24,0
2020,913800221,27440,3440,3440,3440,0,24000,23000,23000,0,0,1000,1000,0,0,0,0,0,0,1666,162,12,168,170,634
2020,913800231,26328,16278,4278,4278,12000,10050,10000,0,0,10000,50,0,50,0,4050,4050,4000,0,2358,300,90,50,213,169
2020,913800241,18904,954,954,954,0,17950,16000,16000,0,0,1950,1950,0,0,7310,7310,7000,0,1756,180,10,360,156,112
2020,913800301,65066,65066,62066,52066,3000,0,0,0,0,0,0,0,0,0,2300,2300,0,2300,6800,1800,300,100,400,452
2020,913800331,6177,677,677,677,0,5500,5500,5500,0,0,0,0,0,0,7536,7536,3736,1300,1233,108,200,60,155,9
2020,913800341,19826,1526,1526,1526,0,18300,17000,17000,0,0,1300,1300,0,0,10852,10852,10800,0,1549,180,4,120,180,67
2020,913800361,111700,45300,45300,35300,0,66400,45000,41000,0,4000,21400,11400,0,10000,50000,50000,50000,0,7920,360,0,600,330,2683
2020,913900101,31108,8108,8108,8108,0,23000,23000,23000,0,0,0,0,0,0,12980,12980,12880,0,3548,192,30,310,322,53
2020,913900131,50740,740,740,740,0,50000,50000,30000,20000,0,0,0,0,0,4826,826,826,0,1228,280,150,48,50,125
2020,913900151,30168,26368,8368,7368,18000,3800,2800,0,0,2800,1000,0,0,1000,6100,6100,6000,100,3420,300,200,150,150,2064
2020,913900171,21600,20600,2600,2600,18000,1000,0,0,0,0,1000,1000,0,0,8800,8800,8800,0,2582,700,10,300,72,32
2020,913900181,45190,190,190,190,0,45000,45000,45000,0,0,0,0,0,0,14960,2760,2760,0,2051,240,1300,60,78,51
2020,913900211,155616,48290,48290,18290,0,107326,95000,95000,0,0,12326,7100,5226,0,18275,18275,18200,0,13480,760,40,590,540,2582
2020,913900221,3266,2166,2166,2166,0,1100,0,0,0,0,1100,900,200,0,0,0,0,0,2456,180,96,360,150,262
2020,913900231,127706,27056,27056,27056,0,100650,90000,40000,50000,0,10650,650,10000,0,16900,16900,12000,4000,4960,320,300,400,240,120
2020,913900241,15520,1020,1020,1020,0,14500,13000,13000,0,0,1500,1500,0,0,20,20,0,0,1962,240,50,240,250,87
2020,913900251,71344,12144,12144,6144,0,59200,48000,28000,20000,0,11200,1200,10000,0,6000,5000,5000,0,5616,276,70,300,160,176
2020,913900311,20322,12196,12196,12196,0,8126,7500,7500,0,0,626,400,226,0,60,60,0,0,2160,360,120,240,60,58
2020,913900341,198,198,98,98,100,0,0,0,0,0,0,0,0,0,400,400,0,400,1596,420,60,240,120,1
2020,913900351,31935,30995,8995,8995,22000,940,0,0,0,0,940,940,0,0,7000,7000,7000,0,3330,350,50,480,200,85
2020,913900361,70394,29094,29094,29094,0,41300,39000,39000,0,0,2300,2300,0,0,0,0,0,0,3312,420,12,600,240,1454
2020,913900371,1631,1631,1231,431,400,0,0,0,0,0,0,0,0,0,2900,2900,0,2100,1252,124,104,180,228,2
2020,913900391,143500,3500,3500,3500,0,140000,140000,0,140000,0,0,0,0,0,110000,10000,10000,0,1495,360,70,28,60,414
2020,914000102,34480,2480,2480,2480,0,32000,30000,30000,0,0,2000,2000,0,0,14000,14000,13000,1000,4652,196,50,480,420,71
2020,914000112,126770,6670,6670,6670,0,120100,120000,120000,0,0,100,100,0,0,0,0,0,0,2360,600,100,100,100,535
2020,914000162,1600,1600,600,600,1000,0,0,0,0,0,0,0,0,0,0,0,0,0,1970,960,10,10,240,497
2020,914000172,30272,3272,3272,3272,0,27000,27000,27000,0,0,0,0,0,0,0,0,0,0,1044,194,50,10,100,50
2020,914000312,49039,18229,18229,18229,0,30810,30000,30000,0,0,810,810,0,0,9594,9594,9500,0,3556,300,160,420,204,212
2020,914000322,41290,770,770,770,0,40520,40000,40000,0,0,520,520,0,0,8000,8000,8000,0,1430,340,125,160,65,106
2020,914000332,10510,9310,3310,3310,6000,1200,0,0,0,0,1200,1200,0,0,4500,4500,0,4500,2820,1200,10,360,300,31
2020,914000342,41690,6190,6190,3190,0,35500,23000,23000,0,0,12500,2000,500,10000,30270,30270,15000,5000,4987,360,30,374,348,543
2020,914000352,21351,551,551,551,0,20800,20000,20000,0,0,800,800,0,0,560,560,400,0,1100,216,60,105,84,46
2020,914000382,110920,8920,8920,8920,0,102000,101000,40000,61000,0,1000,1000,0,0,36015,1015,0,0,5120,370,350,300,360,175
2020,914000392,29485,25885,7885,2885,18000,3600,3000,0,0,3000,600,600,0,0,0,0,0,0,2043,215,0,135,72,13
2020,914600101,230850,15850,15850,15850,0,215000,215000,85000,130000,0,0,0,0,0,26347,17347,17347,0,1600,180,200,20,80,172
2020,914600111,2384,384,384,384,0,2000,0,0,0,0,2000,2000,0,0,1500,1500,0,1500,3500,230,100,200,240,68
2020,914600121,55350,350,350,350,0,55000,55000,48000,7000,0,0,0,0,0,3000,0,0,0,1120,190,120,30,40,133
2020,914600131,26550,850,850,350,0,25700,25000,25000,0,0,700,0,200,500,1300,1300,1300,0,1470,260,150,150,160,43
2020,914600311,68702,9802,9802,9802,0,58900,55000,55000,0,0,3900,3900,0,0,7220,7220,7000,200,3002,230,120,180,170,325
2020,914600321,24208,1208,1208,1208,0,23000,22000,22000,0,0,1000,1000,0,0,11726,11726,11726,0,2014,340,24,72,108,59
2020,914600331,26450,300,300,300,0,26150,22000,22000,0,0,4150,4150,0,0,0,0,0,0,1330,180,260,360,60,106
2020,914600341,85800,5750,5750,5750,0,80050,80000,80000,0,0,50,50,0,0,12000,0,0,0,1875,360,200,120,90,100
2020,914600361,148220,18220,18220,18220,0,130000,130000,90000,40000,0,0,0,0,0,13000,0,0,0,5000,480,300,600,220,6677
2020,914600391,95886,15800,15800,15800,0,80086,76400,40000,36400,0,3686,3600,86,0,26500,13500,10000,3500,6070,360,1000,360,300,763
2020,914700111,94160,2160,2160,1160,0,92000,90000,90000,0,0,2000,2000,0,0,5120,120,0,0,3250,400,100,300,250,81
2020,914700131,5010,5010,10,10,5000,0,0,0,0,0,0,0,0,0,0,0,0,0,473,82,2,10,15,1
2020,914700311,37600,14200,14200,13600,0,23400,23000,23000,0,0,400,200,200,0,0,0,0,0,2251,156,36,361,120,68
2020,914700351,41070,1070,1070,1070,0,40000,40000,40000,0,0,0,0,0,0,0,0,0,0,914,201,120,24,72,41
2020,914700361,73450,16450,16450,16450,0,57000,55000,40000,15000,0,2000,2000,0,0,8492,8492,8492,0,3280,480,120,480,360,3307
2020,914800111,181000,81000,22000,22000,59000,100000,100000,0,100000,0,0,0,0,0,4000,0,0,0,840,360,50,10,40,494
2020,914800121,3118,3118,1118,1118,2000,0,0,0,0,0,0,0,0,0,0,0,0,0,1177,102,50,100,180,7
2020,914800141,660,660,10,10,650,0,0,0,0,0,0,0,0,0,667,667,0,0,1616,176,500,24,48,7
2020,914800151,39716,37490,11490,9690,26000,2226,0,0,0,0,2226,2000,226,0,180,180,0,0,3541,180,500,193,168,411
2020,914800171,276933,10733,10733,10733,0,266200,265000,80000,185000,0,1200,1200,0,0,205600,42600,33600,9000,6004,360,180,620,240,1641
2020,914800181,5393,5393,2393,2393,3000,0,0,0,0,0,0,0,0,0,2400,2400,0,400,3386,606,52,180,144,2
2020,914800191,11504,11504,1504,1504,10000,0,0,0,0,0,0,0,0,0,900,900,400,500,1379,196,50,102,123,5
2020,914800301,49136,13836,13836,13836,0,35300,30000,30000,0,0,5300,2300,3000,0,8920,8920,8920,0,4060,250,200,360,250,3691
2020,914800311,110101,5121,5121,5121,0,104980,102000,50000,52000,0,2980,2980,0,0,46116,16116,15960,0,3922,364,148,645,275,219
2020,914800361,18206,18206,18206,10206,0,0,0,0,0,0,0,0,0,0,6378,6378,0,6378,2912,752,600,120,180,495
2020,914800371,22248,20748,10748,10748,10000,1500,0,0,0,0,1500,1500,0,0,0,0,0,0,4130,1000,20,190,240,112
2020,914800381,28405,21225,9225,9225,12000,7180,7000,0,7000,0,180,180,0,0,0,0,0,0,3180,1000,100,300,240,302
2020,914800391,28620,10520,2520,2520,8000,18100,10600,0,4000,6600,7500,500,0,7000,22000,22000,20000,2000,2790,210,250,1120,90,79
2020,914900101,2500,2500,500,500,2000,0,0,0,0,0,0,0,0,0,0,0,0,0,2110,1100,30,60,90,1
2020,914900121,85100,100,100,100,0,85000,85000,85000,0,0,0,0,0,0,0,0,0,0,960,240,100,30,30,97
2020,914900131,106000,19000,19000,19000,0,87000,85000,85000,0,0,2000,2000,0,0,14700,14700,14200,500,5570,450,120,400,180,2147
2020,914900161,26250,250,250,250,0,26000,26000,26000,0,0,0,0,0,0,1000,0,0,0,1187,276,333,0,60,13
2020,914900181,11654,11454,9454,9454,2000,200,0,0,0,0,200,200,0,0,0,0,0,0,4630,1300,100,600,300,22
2020,914900191,8400,7500,4800,4800,2700,900,0,0,0,0,900,900,0,0,0,0,0,0,518,31,20,30,12,20
2020,914900301,40874,624,624,624,0,40250,40000,40000,0,0,250,250,0,0,0,0,0,0,2161,357,216,180,134,122
2020,914900321,41620,11430,11430,11430,0,30190,21000,21000,0,0,9190,4190,5000,0,8900,8900,7500,0,5877,843,64,722,120,118
2020,914900331,10981,10981,5981,1981,5000,0,0,0,0,0,0,0,0,0,725,725,0,700,1362,348,36,12,78,14
2020,914900361,203269,28000,28000,27500,0,175269,155000,65000,90000,0,20269,100,169,20000,400,400,0,0,8920,480,120,120,180,480
2020,914900371,40580,39780,13780,13780,26000,800,0,0,0,0,800,800,0,0,9300,9300,9300,0,5380,400,30,150,300,556
2020,915000102,72320,15920,15920,12920,0,56400,51000,51000,0,0,5400,400,0,5000,60,60,0,0,2118,256,0,240,336,111
2020,915000142,174,174,20,20,154,0,0,0,0,0,0,0,0,0,0,0,0,0,907,152,3,10,30,1
2020,915000152,4653,4613,2613,2613,2000,40,0,0,0,0,40,0,40,0,0,0,0,0,1515,690,113,20,102,1
2020,915000172,17100,15100,100,100,15000,2000,0,0,0,0,2000,2000,0,0,15000,15000,15000,0,1641,180,10,96,180,192
2020,915000182,23670,23070,5070,5070,18000,600,0,0,0,0,600,600,0,0,15900,15900,13000,2900,3170,180,20,300,120,286
2020,915000302,1520,1520,1520,1520,0,0,0,0,0,0,0,0,0,0,0,0,0,0,1020,228,300,10,84,42
2020,915000312,38970,18370,2370,2370,16000,20600,20000,0,20000,0,600,600,0,0,5000,0,0,0,1994,360,480,360,144,109
2020,915000322,1299,1079,79,79,1000,220,0,0,0,0,220,220,0,0,7000,7000,0,7000,3606,720,240,360,324,66
2020,915000332,83520,15840,15840,15840,0,67680,67000,30000,37000,0,680,480,200,0,2000,0,0,0,2108,288,400,200,120,97
2020,915000352,11,11,11,11,0,0,0,0,0,0,0,0,0,0,60000,60000,0,0,880,120,10,60,120,10
2020,915000372,1230,880,580,580,300,350,0,0,0,0,350,350,0,0,0,0,0,0,2074,420,300,360,144,72
2020,915600101,47934,10794,10794,10794,0,37140,35000,35000,0,0,2140,2000,140,0,0,0,0,0,3777,154,720,370,463,70
2020,915600181,1050,1050,350,350,700,0,0,0,0,0,0,0,0,0,0,0,0,0,1615,216,14,192,276,0
2020,915600191,757,757,5,5,752,0,0,0,0,0,0,0,0,0,0,0,0,0,428,290,50,3,8,0
2020,915600301,34570,7170,7170,7170,0,27400,23000,23000,0,0,4400,3700,700,0,2000,2000,0,0,6725,408,310,1260,150,853
2020,915600321,1670,1490,1490,1490,0,180,0,0,0,0,180,180,0,0,220,220,0,0,2561,144,100,372,136,24
2020,915600361,11432,1032,1032,1032,0,10400,10400,10000,400,0,0,0,0,0,2150,2150,2000,0,1536,216,60,144,180,23
2020,915600371,5630,30,30,30,0,5600,5600,5600,0,0,0,0,0,0,0,0,0,0,600,60,182,24,22,3
2020,915600381,44000,7500,7500,6000,0,36500,34000,34000,0,0,2500,2400,100,0,2000,2000,2000,0,1590,216,105,302,216,130
2020,915600391,350102,51102,51102,33102,0,299000,255000,70000,185000,0,44000,1500,37500,5000,64000,50000,50000,0,5832,540,120,240,300,3945
2020,915700111,5300,5300,3300,2700,2000,0,0,0,0,0,0,0,0,0,1300,1300,0,1300,1790,840,20,50,130,45
2020,915700121,340,340,340,340,0,0,0,0,0,0,0,0,0,0,0,0,0,0,814,120,200,50,24,1
2020,915700131,93499,36499,15499,13499,21000,57000,55000,0,55000,0,2000,2000,0,0,19000,0,0,0,2560,240,50,250,120,307
2020,915700161,53153,12340,12340,12340,0,40813,39000,39000,0,0,1813,1700,113,0,12820,12820,11320,1500,3162,192,60,168,132,183
2020,915700181,304400,45400,45400,25400,0,259000,257000,167000,90000,0,2000,2000,0,0,93000,90000,38000,52000,15070,500,600,480,240,15881
2020,915700191,6795,6795,3295,3295,3500,0,0,0,0,0,0,0,0,0,0,0,0,0,965,180,10,60,120,18
2020,915700301,60950,3950,3950,3950,0,57000,56000,51000,5000,0,1000,1000,0,0,16000,16000,16000,0,2979,460,62,351,227,122
2020,915700331,86132,49632,49632,49632,0,36500,30000,30000,0,0,6500,6000,500,0,0,0,0,0,5207,360,120,360,312,169
2020,915700341,145730,21780,21780,17780,0,123950,123000,63000,60000,0,950,650,300,0,49403,47403,47403,0,2970,300,400,300,170,610
2020,915700381,4045,4045,45,45,4000,0,0,0,0,0,0,0,0,0,0,0,0,0,1155,240,300,120,120,1
2020,915700391,44960,7660,7660,7660,0,37300,37000,37000,0,0,300,300,0,0,9740,9740,3420,5000,4327,216,5,250,480,899
2020,915800171,1000,1000,700,700,300,0,0,0,0,0,0,0,0,0,0,0,0,0,1680,420,120,120,90,1
2020,915800191,28425,3125,3125,3125,0,25300,25000,25000,0,0,300,300,0,0,7550,7550,7550,0,3720,240,180,120,240,254
2020,915800311,151660,1460,1460,1460,0,150200,148000,68000,80000,0,2200,2200,0,0,30000,0,0,0,5285,430,120,850,360,515
2020,915800321,57598,2548,2548,2548,0,55050,54000,30000,24000,0,1050,1050,0,0,27752,21752,19562,2000,7342,300,2000,520,360,129
2020,915800331,116600,5000,5000,5000,0,111600,111600,25000,50000,36600,0,0,0,0,0,0,0,0,979,300,126,84,41,330
2020,915800371,1591,1591,11,11,1580,0,0,0,0,0,0,0,0,0,1440,1440,1340,0,458,200,10,50,23,1
2020,915900121,3223,3223,1723,1723,1500,0,0,0,0,0,0,0,0,0,730,730,730,0,1654,264,30,120,120,1
2020,915900141,61882,4774,4774,4774,0,57108,56000,56000,0,0,1108,800,308,0,0,0,0,0,2358,360,100,720,84,191
2020,915900151,4932,4632,872,872,3760,300,0,0,0,0,300,300,0,0,4200,4200,3200,1000,4870,610,1000,360,420,289
2020,915900161,20390,4390,1590,1590,2800,16000,16000,0,16000,0,0,0,0,0,626,26,0,0,521,120,120,36,45,11
2020,915900171,944,944,4,4,940,0,0,0,0,0,0,0,0,0,1790,1790,350,1200,802,312,0,60,60,1
2020,915900181,58576,33576,15576,15576,18000,25000,25000,0,0,25000,0,0,0,0,12700,12700,10000,2700,2746,108,200,96,72,9
2020,915900191,2014,2014,14,14,2000,0,0,0,0,0,0,0,0,0,0,0,0,0,959,170,100,18,21,1
2020,915900301,2640,1040,540,540,500,1600,0,0,0,0,1600,600,1000,0,0,0,0,0,4300,600,120,1440,240,58
2020,915900311,48532,5332,5332,2332,0,43200,41000,26000,15000,0,2200,2200,0,0,22892,21892,18892,3000,3000,300,1500,180,180,109
2020,915900331,70111,3640,3640,3640,0,66471,65000,60000,5000,0,1471,1200,271,0,14779,14779,14679,0,3838,480,5,482,124,161
2020,915900341,32740,17501,1501,1501,16000,15239,14000,0,14000,0,1239,900,339,0,19100,19100,19100,0,2599,300,300,145,190,41
2020,915900351,25707,15707,14707,14707,1000,10000,10000,0,10000,0,0,0,0,0,19425,11400,5500,5000,1414,484,30,60,180,443
2020,915900361,31200,9600,9600,9600,0,21600,20000,20000,0,0,1600,1600,0,0,20000,20000,14000,6000,1929,200,100,300,150,64
2020,915900371,26350,1350,1350,1350,0,25000,25000,25000,0,0,0,0,0,0,0,0,0,0,1230,300,30,50,80,51
2020,915900381,26430,22180,2680,2680,19500,4250,3000,0,0,3000,1250,850,400,0,18250,18250,10000,250,2188,250,180,120,240,119
2020,916000112,31075,30925,20925,20425,10000,150,0,0,0,0,150,150,0,0,0,0,0,0,9150,870,800,880,500,167
2020,916000122,19110,18210,4210,4210,14000,900,0,0,0,0,900,900,0,0,0,0,0,0,4885,600,240,300,240,453
2020,916000132,104456,5356,5356,5356,0,99100,99000,60000,39000,0,100,100,0,0,43000,19000,19000,0,2389,240,110,120,96,173
2020,916000142,76430,6930,6930,6930,0,69500,67000,32000,35000,0,2500,2500,0,0,18000,18000,18000,0,1560,180,60,360,180,761
2020,916000162,32220,31720,4720,4720,27000,500,0,0,0,0,500,500,0,0,9000,9000,9000,0,3308,204,50,400,84,36
2020,916000182,4632,2632,2632,2632,0,2000,0,0,0,0,2000,0,2000,0,100,100,0,0,3000,280,50,120,90,1
2020,916000192,80300,300,300,300,0,80000,80000,80000,0,0,0,0,0,0,0,0,0,0,1882,324,120,36,132,410
2020,916000302,11760,1760,1760,1760,0,10000,10000,10000,0,0,0,0,0,0,0,0,0,0,338,24,5,5,0,85
2020,916000322,57160,10210,10210,10210,0,46950,46000,46000,0,0,950,800,150,0,0,0,0,0,5184,372,1020,400,180,94
2020,916000332,45010,10,10,10,0,45000,45000,45000,0,0,0,0,0,0,0,0,0,0,1530,400,200,150,60,26
2020,916000342,64170,5743,5743,5743,0,58427,57000,57000,0,0,1427,1127,300,0,12990,12990,10650,2340,4735,320,75,800,245,111
2020,916000352,24000,23000,23000,23000,0,1000,0,0,0,0,1000,1000,0,0,350,350,0,0,2420,300,100,150,100,59
2020,916000362,77550,2250,2250,2250,0,75300,75000,75000,0,0,300,300,0,0,0,0,0,0,2816,480,500,180,96,77
2020,916000382,3450,150,150,150,0,3300,3300,3300,0,0,0,0,0,0,0,0,0,0,387,112,84,49,22,9
2020,916000392,8055,1400,1400,200,0,6655,5455,5455,0,0,1200,0,0,1200,3330,3330,3000,270,1262,350,30,0,172,4
2020,916600151,66374,2374,2374,2374,0,64000,64000,64000,0,0,0,0,0,0,0,0,0,0,780,180,60,24,36,62
2020,916600171,105600,6600,6600,6600,0,99000,98000,38000,60000,0,1000,1000,0,0,38800,35800,35800,0,4284,384,240,1440,240,106
2020,916600181,2432,2432,432,432,2000,0,0,0,0,0,0,0,0,0,0,0,0,0,2193,1380,15,72,80,1
2020,916600191,86058,6058,6058,6058,0,80000,80000,70000,10000,0,0,0,0,0,5400,4000,0,0,1600,180,360,60,120,103
2020,916600301,16030,16030,30,30,16000,0,0,0,0,0,0,0,0,0,0,0,0,0,1240,300,50,50,40,2
2020,916600311,107068,96068,96068,95568,0,11000,8000,8000,0,0,3000,3000,0,0,0,0,0,0,1510,170,100,240,100,146
2020,916600321,55075,7175,7175,6275,0,47900,40000,40000,0,0,7900,400,0,7500,0,0,0,0,4340,352,271,392,261,74
2020,916600331,70851,20901,20901,20901,0,49950,46300,39000,7300,0,3650,2650,1000,0,2500,2500,0,2500,8162,369,200,660,209,1530
2020,916600351,52108,14108,14108,14108,0,38000,38000,38000,0,0,0,0,0,0,0,0,0,0,3319,340,120,50,228,2559
2020,916600361,65057,5157,5157,4857,0,59900,48000,36000,12000,0,11900,1600,10300,0,11510,9510,9510,0,4644,300,120,600,204,364
2020,916600381,37161,7635,7635,7635,0,29526,27000,12000,15000,0,2526,1300,226,1000,0,0,0,0,5000,300,2068,604,140,175
2020,916600391,28220,820,820,820,0,27400,27000,27000,0,0,400,400,0,0,3000,3000,3000,0,1449,252,100,92,45,44
2020,916700101,1888,1888,88,88,1800,0,0,0,0,0,0,0,0,0,1843,1843,1743,0,1050,309,250,42,24,1
2020,916700111,7881,6881,2381,1981,4500,1000,0,0,0,0,1000,1000,0,0,0,0,0,0,543,93,20,93,77,22
2020,916700131,1100,1100,100,100,1000,0,0,0,0,0,0,0,0,0,0,0,0,0,1272,120,12,120,144,1
2020,916700141,11368,8368,4368,4368,4000,3000,0,0,0,0,3000,3000,0,0,0,0,0,0,2095,55,50,30,200,127
2020,916700161,24250,100,100,100,0,24150,23000,23000,0,0,1150,1150,0,0,12300,12300,10000,2000,5190,170,20,700,250,81
2020,916700181,348500,48000,11000,11000,37000,300500,300000,0,300000,0,500,500,0,0,85000,0,0,0,1834,144,360,360,60,1407
2020,916700191,4250,4100,100,100,4000,150,0,0,0,0,150,150,0,0,0,0,0,0,2930,1320,10,240,240,26
2020,916700331,53945,2945,2945,2945,0,51000,48000,48000,0,0,3000,3000,0,0,9400,9400,9100,300,3220,300,20,500,180,238
2020,916700341,52300,7000,7000,7000,0,45300,45000,45000,0,0,300,300,0,0,0,0,0,0,3820,300,120,250,250,1603
2020,916700381,310994,27594,27594,27594,0,283400,282000,100000,182000,0,1400,1400,0,0,29800,27800,27800,0,4380,600,300,600,120,265
2020,916800101,21161,661,661,661,0,20500,20000,20000,0,0,500,500,0,0,0,0,0,0,1810,120,450,180,60,63
2020,916800111,55150,2130,2130,2130,0,53020,53000,53000,0,0,20,20,0,0,3000,0,0,0,1410,200,50,80,50,151
2020,916800161,1049,1049,49,49,1000,0,0,0,0,0,0,0,0,0,200,200,0,0,1396,472,10,36,36,1
2020,916800171,154520,4520,4520,20,0,150000,150000,150000,0,0,0,0,0,0,99000,19000,19000,0,1200,240,300,0,60,83
2020,916800191,5960,5960,1960,1960,4000,0,0,0,0,0,0,0,0,0,3580,3580,3500,0,1956,720,10,60,56,1
2020,916800311,1680,1680,880,880,800,0,0,0,0,0,0,0,0,0,0,0,0,0,1372,276,60,360,144,1
2020,916800331,38444,9854,9854,9854,0,28590,26500,13000,13500,0,2090,1500,590,0,500,500,0,500,838,112,120,60,96,22
2020,916800341,17253,15753,3753,3753,12000,1500,0,0,0,0,1500,1500,0,0,90,90,0,0,2047,451,520,126,95,41
2020,916800351,7077,6777,1496,1496,5281,300,0,0,0,0,300,300,0,0,3900,3900,3800,0,1280,300,50,30,120,6
2020,916800361,31178,1078,1078,1078,0,30100,29000,29000,0,0,1100,1100,0,0,28708,28708,19519,1570,6270,300,200,264,240,81
2020,916800371,70980,16850,850,850,16000,54130,54000,0,54000,0,130,130,0,0,28000,28000,28000,0,1890,420,90,260,120,162
2020,916800381,38350,50,50,50,0,38300,38300,38300,0,0,0,0,0,0,0,0,0,0,640,300,60,20,36,31
2020,916900101,2,2,2,2,0,0,0,0,0,0,0,0,0,0,0,0,0,0,1241,321,20,120,60,1
2020,916900111,4001,4001,2001,2001,2000,0,0,0,0,0,0,0,0,0,260,260,0,0,1844,124,120,50,110,2
2020,916900121,705,705,5,5,700,0,0,0,0,0,0,0,0,0,0,0,0,0,846,204,20,60,24,1
2020,916900141,8836,8836,7836,7836,1000,0,0,0,0,0,0,0,0,0,5300,5300,0,0,2718,623,610,192,188,47
2020,916900151,507,407,107,107,300,100,0,0,0,0,100,100,0,0,0,0,0,0,1205,700,60,120,25,26
2020,916900171,4600,3300,2300,2300,1000,1300,0,0,0,0,1300,1300,0,0,2300,2300,0,2000,2730,700,30,100,300,256
2020,916900181,90870,370,370,370,0,90500,90000,90000,0,0,500,500,0,0,65500,20500,19500,1000,5950,250,100,400,400,165
2020,916900191,218258,42758,42758,42758,0,175500,175000,170000,5000,0,500,500,0,0,0,0,0,0,4588,420,60,360,168,2235
2020,916900301,14708,11408,2908,2908,8500,3300,0,0,0,0,3300,3300,0,0,12080,12080,6880,3000,4175,288,20,670,223,184
2020,916900321,43495,14061,14061,14061,0,29434,27000,27000,0,0,2434,1530,904,0,10630,10630,10630,0,3557,312,90,160,141,110
2020,916900351,343200,82950,82950,82950,0,260250,259500,65000,194500,0,750,350,400,0,58000,0,0,0,4874,600,150,180,120,872
2020,916900371,242020,25120,25120,25120,0,216900,210000,75000,135000,0,6900,5900,1000,0,17300,0,0,0,6157,600,600,480,327,514
2020,916900391,12550,780,780,780,0,11770,11500,11500,0,0,270,270,0,0,8000,8000,8000,0,3077,360,40,270,252,34
2020,917000102,5300,3500,500,500,3000,1800,0,0,0,0,1800,1800,0,0,500,500,0,0,2400,810,10,200,100,119
2020,917000112,2050,2050,50,50,2000,0,0,0,0,0,0,0,0,0,320,320,0,0,920,552,10,60,60,5
2020,917000122,3335,3335,935,935,2400,0,0,0,0,0,0,0,0,0,1063,1063,0,752,679,300,0,96,56,1
2020,917000152,42640,42570,12570,12570,30000,70,0,0,0,0,70,0,70,0,18000,18000,18000,0,3210,120,20,96,156,531
2020,917000172,3003,3003,3,3,3000,0,0,0,0,0,0,0,0,0,0,0,0,0,558,360,50,5,18,0
2020,917000182,101040,8940,8940,5440,0,92100,90000,90000,0,0,2100,600,1500,0,21000,10000,10000,0,3940,180,10,600,240,220
2020,917000302,19546,15446,7746,7746,7700,4100,0,0,0,0,4100,600,3500,0,5950,5950,5950,0,7938,840,38,600,240,640
2020,917000312,87068,6568,6568,6568,0,80500,78000,33000,45000,0,2500,2500,0,0,38000,12000,12000,0,3620,420,400,120,120,917
2020,917000332,12192,1592,1592,1592,0,10600,8000,8000,0,0,2600,2600,0,0,1900,1900,1900,0,2143,216,5,300,144,36
2020,917000352,70911,23311,23311,19311,0,47600,43000,31000,12000,0,4600,2300,300,2000,29020,19020,15000,4000,3940,420,100,480,300,142
2020,917000362,52960,12900,12900,12900,0,40060,38960,31000,7960,0,1100,1100,0,0,9788,9788,9788,0,3140,300,60,300,300,92
2020,917000372,25040,25040,5040,5040,20000,0,0,0,0,0,0,0,0,0,0,0,0,0,3984,360,24,60,480,13
2020,917000392,27885,25885,11385,6385,14500,2000,600,0,600,0,1400,1400,0,0,11647,11647,7500,4072,3200,300,250,250,200,112
2020,917600101,12100,10100,100,100,10000,2000,0,0,0,0,2000,2000,0,0,5000,5000,5000,0,3536,200,36,400,300,527
2020,917600111,7258,7258,258,258,7000,0,0,0,0,0,0,0,0,0,0,0,0,0,1085,132,20,120,72,9
2020,917600131,2650,2600,600,600,2000,50,0,0,0,0,50,50,0,0,0,0,0,0,3052,864,50,50,264,57
2020,917600141,3459,3259,3259,3259,0,200,0,0,0,0,200,0,200,0,1520,1520,1050,400,3322,180,1100,126,168,74
2020,917600171,111920,22220,2220,2220,20000,89700,85000,0,85000,0,4700,4700,0,0,50000,8000,0,1000,2430,300,200,150,180,97
2020,917600181,1686,1686,1286,1286,400,0,0,0,0,0,0,0,0,0,3000,3000,3000,0,1200,137,300,120,100,18
2020,917600321,3100,3100,100,100,3000,0,0,0,0,0,0,0,0,0,34500,34500,30000,2500,1614,660,60,168,96,2
2020,917600331,4343,4343,2600,2600,1743,0,0,0,0,0,0,0,0,0,0,0,0,0,1160,320,20,40,20,1
2020,917600351,47108,9367,9367,9367,0,37741,33000,15000,18000,0,4741,770,3971,0,0,0,0,0,2706,312,60,360,144,165
2020,917600361,33758,10518,10518,10518,0,23240,23000,5000,18000,0,240,0,240,0,8000,8000,3000,5000,1526,290,180,72,77,38
2020,917600371,274490,48220,24220,19220,24000,226270,218000,0,218000,0,8270,6270,2000,0,4000,0,0,0,6871,1080,555,460,186,3344
2020,917600381,24842,20600,7600,4600,13000,4242,0,0,0,0,4242,4242,0,0,0,0,0,0,1935,60,15,240,200,229
2020,917700101,1020,1020,20,20,1000,0,0,0,0,0,0,0,0,0,1450,1450,150,0,1810,624,10,96,120,1
2020,917700131,21064,17830,830,830,17000,3234,3234,0,3234,0,0,0,0,0,9630,9630,9600,0,2517,195,20,120,276,454
2020,917700141,949,709,509,509,200,240,0,0,0,0,240,240,0,0,100,100,100,0,3516,858,48,52,252,15
2020,917700161,66020,20,20,20,0,66000,64000,64000,0,0,2000,2000,0,0,32700,32700,27000,3700,4260,600,1200,360,300,150
2020,917700311,34566,4626,4626,4626,0,29940,16200,16200,0,0,13740,1740,0,12000,6000,6000,6000,0,2580,360,36,234,288,90
2020,917700321,20,20,20,20,0,0,0,0,0,0,0,0,0,0,0,0,0,0,916,360,60,18,18,1
2020,917700331,77220,29420,29420,29420,0,47800,46000,11000,35000,0,1800,1800,0,0,0,0,0,0,4530,1130,100,550,230,87
2020,917700341,20560,16460,16460,16460,0,4100,3000,3000,0,0,1100,1100,0,0,0,0,0,0,2772,352,200,500,220,74
2020,917700351,36243,1000,1000,1000,0,35243,34000,20000,14000,0,1243,0,1243,0,15380,15380,15280,0,3732,360,360,240,396,28
2020,917700361,15128,678,678,678,0,14450,14000,14000,0,0,450,450,0,0,5308,5308,5000,0,984,150,50,120,72,39
2020,917700371,74627,21847,21847,21847,0,52780,45000,45000,0,0,7780,3600,180,4000,27800,27800,24800,3000,4290,240,240,360,280,73
2020,917800101,110090,8690,8690,8690,0,101400,100000,100000,0,0,1400,1400,0,0,7500,7500,6500,1000,3695,176,180,324,225,257
2020,917800111,35923,33923,5923,5923,28000,2000,0,0,0,0,2000,2000,0,0,8900,8900,0,8900,2900,200,300,200,300,50
2020,917800131,205985,19185,19185,19185,0,186800,180000,180000,0,0,6800,6800,0,0,23013,23013,22673,0,6840,420,300,360,240,3130
2020,917800311,62118,11440,11440,10940,0,50678,45000,30000,15000,0,5678,5000,678,0,16000,15000,0,15000,7800,360,200,400,480,2238
2020,917800321,12670,2670,2670,2670,0,10000,10000,10000,0,0,0,0,0,0,150000,150000,0,0,1966,180,1000,180,60,17
2020,917800331,19660,3260,3260,3260,0,16400,16000,16000,0,0,400,400,0,0,7560,7560,7560,0,2716,240,200,360,116,57
2020,917800341,5120,4520,4520,4520,0,600,0,0,0,0,600,600,0,0,0,0,0,0,2556,430,30,300,240,131
2020,917800351,18785,1735,1735,1735,0,17050,17000,17000,0,0,50,50,0,0,0,0,0,0,2765,200,130,120,180,351
2020,917800361,26790,6390,6390,6390,0,20400,17000,17000,0,0,3400,400,3000,0,5902,5902,5652,0,2770,410,150,360,210,91
2020,917800371,10910,10110,110,110,10000,800,0,0,0,0,800,800,0,0,0,0,0,0,1900,120,30,120,192,1
2020,917800381,68554,33641,33641,33641,0,34913,23000,23000,0,0,11913,1800,113,10000,0,0,0,0,2154,230,144,540,98,69
2020,917900101,101696,6396,6396,6396,0,95300,95000,70000,25000,0,300,300,0,0,27400,12400,12400,0,2639,180,50,240,108,111
2020,917900111,8990,8990,5990,5990,3000,0,0,0,0,0,0,0,0,0,0,0,0,0,1520,450,150,120,100,8
2020,917900131,14330,13380,4380,4380,9000,950,0,0,0,0,950,950,0,0,0,0,0,0,2656,400,36,360,120,119
2020,917900141,17562,1532,1532,1532,0,16030,15500,15500,0,0,530,530,0,0,0,0,0,0,1632,350,10,80,192,22
2020,917900151,312,312,12,12,300,0,0,0,0,0,0,0,0,0,0,0,0,0,545,300,18,28,26,1
2020,917900161,437700,38500,38500,38500,0,399200,390000,90000,300000,0,9200,4200,5000,0,5000,0,0,0,5760,360,150,400,200,631
2020,917900301,41643,8063,8063,8063,0,33580,30300,15800,14500,0,3280,3280,0,0,22404,9904,7676,0,3716,320,200,350,360,92
2020,917900311,52440,640,640,640,0,51800,13000,13000,0,0,38800,2700,33100,3000,37730,37730,10640,0,4151,144,5,792,550,339
2020,917900331,35500,500,500,500,0,35000,35000,35000,0,0,0,0,0,0,3500,3500,3500,0,1430,360,120,60,60,47
2020,917900351,33290,10990,10990,10990,0,22300,22000,22000,0,0,300,300,0,0,0,0,0,0,3214,420,120,120,204,67
2020,917900361,51754,8104,8104,8104,0,43650,43000,22000,21000,0,650,650,0,0,5084,5084,4784,300,3060,420,300,200,180,442
2020,917900371,102460,6460,6460,6460,0,96000,96000,36000,60000,0,0,0,0,0,10000,0,0,0,2340,240,120,240,120,1050
2020,917900391,25500,7300,7300,7300,0,18200,15000,15000,0,0,3200,3200,0,0,0,0,0,0,4470,480,240,600,480,90
2020,918000112,3466,2666,2466,2466,200,800,0,0,0,0,800,800,0,0,45,45,0,0,5590,960,300,540,420,130
2020,918000122,510,510,10,10,500,0,0,0,0,0,0,0,0,0,0,0,0,0,2384,610,120,0,180,1
2020,918000162,35150,31150,1150,1150,30000,4000,0,0,0,0,4000,4000,0,0,0,0,0,0,2484,194,500,350,240,64
2020,918000302,4385,3395,1795,795,1600,990,0,0,0,0,990,390,0,600,900,900,0,0,3569,480,70,480,290,27
2020,918000312,46160,6760,6760,5760,0,39400,35000,35000,0,0,4400,3100,800,500,12200,4400,0,2000,3430,300,120,780,430,139
2020,918000322,18270,2270,2270,2270,0,16000,16000,4000,12000,0,0,0,0,0,0,0,0,0,670,156,120,48,24,7
2020,918000332,18580,900,900,900,0,17680,17500,17500,0,0,180,180,0,0,0,0,0,0,1200,120,35,120,180,177
2020,918600111,734300,130800,130800,130800,0,603500,594500,320000,274500,0,9000,2000,7000,0,18000,0,0,0,12458,600,50,600,360,6183
2020,918600131,289000,59000,59000,59000,0,230000,230000,230000,0,0,0,0,0,0,28000,28000,28000,0,10380,720,500,180,480,4175
2020,918600141,33150,32150,8150,6650,24000,1000,0,0,0,0,1000,1000,0,0,3900,3900,1400,2500,2740,180,50,200,150,27
2020,918600171,421110,39110,39110,35610,0,382000,380000,300000,80000,0,2000,0,2000,0,26500,24500,24500,0,6310,800,450,100,360,9621
2020,918600301,10816,316,316,316,0,10500,10500,4500,6000,0,0,0,0,0,800,800,0,800,1590,120,180,72,78,6
2020,918600321,12918,818,818,818,0,12100,8500,8500,0,0,3600,600,3000,0,9300,9300,5600,700,3030,170,10,450,230,47
2020,918600331,9,9,9,9,0,0,0,0,0,0,0,0,0,0,0,0,0,0,1135,144,720,10,31,1
2020,918700101,96910,4910,4910,4910,0,92000,90000,90000,0,0,2000,2000,0,0,9000,0,0,0,4738,360,1600,168,120,184
2020,918700151,275900,21200,21200,21200,0,254700,253000,250000,0,3000,1700,1700,0,0,17000,17000,13000,4000,14900,600,400,420,480,14409
2020,918700171,157050,56900,26900,26900,30000,100150,100000,0,100000,0,150,150,0,0,20000,20000,0,20000,4750,400,150,300,150,2490
2020,918700341,22929,20879,8879,8879,12000,2050,0,0,0,0,2050,2050,0,0,6500,6500,6500,0,2078,156,390,240,240,62
2020,918800111,254160,54160,34160,34160,20000,200000,200000,0,200000,0,0,0,0,0,60000,0,0,0,3406,2500,120,36,60,766
2020,918800121,165282,14832,14832,14832,0,150450,150000,55000,95000,0,450,450,0,0,52000,11000,11000,0,1696,180,10,180,96,389
2020,918800131,6000,6000,0,0,6000,0,0,0,0,0,0,0,0,0,6000,6000,6000,0,600,24,30,0,18,0
2020,918800181,1300,1300,300,300,1000,0,0,0,0,0,0,0,0,0,0,0,0,0,2010,500,60,240,120,10
2020,918800191,678240,83440,83440,83440,0,594800,590000,140000,450000,0,4800,4800,0,0,215000,200000,200000,0,7350,600,850,420,180,7146
2020,918800301,39508,2808,2808,2808,0,36700,35000,10000,25000,0,1700,1700,0,0,10150,10150,10000,0,1162,120,10,600,72,415
2020,918800311,71000,2000,2000,2000,0,69000,69000,9000,60000,0,0,0,0,0,0,0,0,0,1744,150,50,20,84,33
2020,918900121,1572,1572,12,12,1560,0,0,0,0,0,0,0,0,0,0,0,0,0,346,50,50,0,56,1
2020,918900131,335,335,35,35,300,0,0,0,0,0,0,0,0,0,0,0,0,0,1286,108,40,120,108,25
2020,918900161,284100,6100,6100,6100,0,278000,270000,270000,0,0,8000,8000,0,0,7140,7140,7140,0,3910,720,200,360,180,3717
2020,918900191,62290,290,290,290,0,62000,62000,62000,0,0,0,0,0,0,0,0,0,0,1300,280,290,15,60,47
2020,918900301,21022,5722,5722,5722,0,15300,10000,3000,7000,0,5300,5300,0,0,5900,5800,1500,1000,2244,180,350,650,144,55
2020,919000102,105696,19696,19696,19696,0,86000,80000,80000,0,0,6000,6000,0,0,0,0,0,0,3275,265,200,250,100,171
2020,919000112,25380,200,200,200,0,25180,25000,25000,0,0,180,180,0,0,9600,9600,9600,0,1392,150,120,100,72,58
2020,919000132,149884,149684,99684,99684,50000,200,0,0,0,0,200,200,0,0,0,0,0,0,4800,420,80,240,144,8522
2020,919000142,6260,2860,860,860,2000,3400,0,0,0,0,3400,3300,100,0,5600,5600,0,2300,7336,1200,36,280,480,167
2020,919000162,78936,3470,3470,3470,0,75466,75000,75000,0,0,466,466,0,0,1000,1000,0,0,3218,360,88,360,120,324
2020,919000172,82600,2600,2600,2600,0,80000,80000,80000,0,0,0,0,0,0,6000,0,0,0,1119,185,42,12,37,439
2020,919000182,2260,2260,60,60,2200,0,0,0,0,0,0,0,0,0,0,0,0,0,1092,720,30,20,22,32
2020,919000192,630,630,130,130,500,0,0,0,0,0,0,0,0,0,0,0,0,0,1440,600,15,60,70,1
2020,919600111,75100,4900,4900,4900,0,70200,70000,70000,0,0,200,200,0,0,3000,0,0,0,1718,180,24,540,60,139
2020,919600121,3322,3322,322,322,3000,0,0,0,0,0,0,0,0,0,1500,1500,1500,0,813,516,10,6,16,1
2020,919600191,9000,9000,500,500,8500,0,0,0,0,0,0,0,0,0,4500,4500,4500,0,1436,120,200,72,144,4
2020,919700181,150,150,150,150,0,0,0,0,0,0,0,0,0,0,0,0,0,0,970,0,35,15,60,1
2020,919700191,58110,710,710,710,0,57400,56100,50000,6100,0,1300,1300,0,0,18000,3000,3000,0,3722,174,10,200,240,108
2020,919800141,44950,800,800,800,0,44150,44000,34000,10000,0,150,150,0,0,1400,1400,1200,200,5200,110,50,300,200,378
2020,919800161,21766,21266,9266,9266,12000,500,0,0,0,0,500,500,0,0,0,0,0,0,3730,720,200,450,200,41
2020,919800171,5900,4900,400,400,4500,1000,0,0,0,0,1000,1000,0,0,0,0,0,0,2080,340,100,560,80,12
2020,919800181,35770,5770,2270,2270,3500,30000,30000,0,30000,0,0,0,0,0,20000,0,0,0,1366,60,30,10,120,119
2020,919800191,182750,35450,24450,24450,11000,147300,145000,0,25000,120000,2300,2300,0,0,20400,20400,0,18000,3348,140,800,72,216,1948
2020,919900121,167900,4900,4900,4900,0,163000,160000,160000,0,0,3000,3000,0,0,20520,20520,14520,6000,4453,360,33,130,230,1451
2020,919900131,3300,3300,2300,2300,1000,0,0,0,0,0,0,0,0,0,0,0,0,0,1913,756,3,12,72,1
2020,919900141,32712,32112,10112,10112,22000,600,0,0,0,0,600,600,0,0,0,0,0,0,4090,200,500,240,420,770
2020,919900151,1930,1730,730,730,1000,200,0,0,0,0,200,200,0,0,0,0,0,0,3260,840,120,240,110,31
2020,919900161,11769,11444,2644,2644,8800,325,0,0,0,0,325,280,45,0,6900,6900,6500,220,2428,216,24,50,192,54
2020,919900191,226260,36000,16000,16000,20000,190260,190000,0,190000,0,260,170,90,0,0,0,0,0,3110,108,600,108,120,229
2020,920000202,149,36,36,36,0,113,0,0,0,0,113,0,113,0,0,0,0,0,600,0,120,10,24,1
2020,920000212,225,225,225,225,0,0,0,0,0,0,0,0,0,0,0,0,0,0,388,80,20,20,18,1
2020,920000222,1580,80,80,80,0,1500,1500,1500,0,0,0,0,0,0,0,0,0,0,340,50,120,5,15,3
2020,920000242,65013,19900,19900,19900,0,45113,39000,27000,12000,0,6113,1000,5113,0,150,150,0,0,2887,240,100,480,300,172
2020,920000252,118395,56495,56495,56495,0,61900,60000,60000,0,0,1900,1900,0,0,18600,18600,18000,0,5050,240,120,1300,360,380
2020,920000282,10900,9000,2000,1500,7000,1900,0,0,0,0,1900,600,1300,0,0,0,0,0,1250,150,100,100,100,11
2020,920000292,2172,1720,1720,1720,0,452,0,0,0,0,452,0,452,0,0,0,0,0,1770,300,200,10,144,43
2020,920000302,7610,7110,2110,2110,5000,500,0,0,0,0,500,500,0,0,7000,7000,7000,0,2310,240,120,240,180,21
2020,920000312,22280,19480,2480,2480,17000,2800,0,0,0,0,2800,2800,0,0,5340,5340,5000,300,3998,372,0,480,360,484
2020,920000322,12,12,12,12,0,0,0,0,0,0,0,0,0,0,0,0,0,0,1084,564,0,70,120,75
2020,920000332,99376,950,950,950,0,98426,97500,17500,80000,0,926,700,226,0,10377,8377,7760,600,3320,300,20,720,180,348
2020,920000352,103900,2800,2800,2800,0,101100,100000,20000,80000,0,1100,1100,0,0,400,400,0,400,2058,350,150,400,168,186
2020,920600201,34870,8640,8640,6140,0,26230,18000,18000,0,0,8230,3380,2850,2000,1394,1394,730,0,2839,240,60,300,200,189
2020,920600211,55596,15076,4076,4076,11000,40520,40000,0,40000,0,520,400,120,0,36500,35500,35500,0,2326,350,33,336,143,117
2020,920600221,29226,6446,6446,6446,0,22780,22000,22000,0,0,780,780,0,0,4500,0,0,0,3296,288,100,690,270,77
2020,920600231,17489,5489,5489,2689,0,12000,12000,12000,0,0,0,0,0,0,0,0,0,0,488,100,10,20,18,13
2020,920600241,19050,18950,7950,7650,11000,100,0,0,0,0,100,0,100,0,7500,7500,7000,0,2970,250,150,200,270,107
2020,920600271,110,110,110,110,0,0,0,0,0,0,0,0,0,0,0,0,0,0,810,270,55,40,36,1
2020,920600291,10910,910,910,910,0,10000,10000,10000,0,0,0,0,0,0,2000,2000,2000,0,1320,300,400,100,50,9
2020,920600301,31017,15977,15977,15977,0,15040,14500,14500,0,0,540,0,540,0,0,0,0,0,1985,213,347,120,80,173
2020,920600321,7100,7100,100,100,7000,0,0,0,0,0,0,0,0,0,0,0,0,0,540,120,30,20,25,2
2020,920600331,28820,10620,10620,10620,0,18200,15000,15000,0,0,3200,3100,100,0,7350,6550,4600,0,2776,240,50,720,200,108
2020,920600371,38452,1392,1392,1392,0,37060,36500,4500,32000,0,560,50,510,0,0,0,0,0,976,180,73,190,60,63
2020,920600391,4800,4700,700,700,4000,100,0,0,0,0,100,100,0,0,0,0,0,0,1676,248,150,150,48,35
2020,920700201,38000,500,500,500,0,37500,37500,30000,7500,0,0,0,0,0,3000,3000,3000,0,605,130,50,20,25,84
2020,920700211,20350,1250,1250,1250,0,19100,17000,17000,0,0,2100,2100,0,0,18416,18416,15700,500,2222,225,100,250,150,68
2020,920700221,45172,3072,3072,3072,0,42100,40800,21000,19800,0,1300,1300,0,0,0,0,0,0,2446,216,150,350,160,99
2020,920700231,22482,5482,4482,4482,1000,17000,4000,0,0,4000,13000,1000,12000,0,18000,18000,10800,3000,6480,1200,500,180,350,439
2020,920700241,46000,27000,17000,17000,10000,19000,17000,0,17000,0,2000,2000,0,0,500,0,0,0,2438,300,40,360,168,661
2020,920700271,73630,4930,4930,4930,0,68700,52000,26000,26000,0,16700,1600,15100,0,25050,25050,24931,0,1990,240,300,420,70,111
2020,920700281,7350,5550,2550,2550,3000,1800,0,0,0,0,1800,1500,300,0,3000,3000,0,3000,3246,1000,25,216,144,52
2020,920700291,8327,8327,2327,2327,6000,0,0,0,0,0,0,0,0,0,0,0,0,0,1005,145,50,25,65,1
2020,920700311,67220,16420,16420,16420,0,50800,48000,16000,32000,0,2800,2800,0,0,1400,1400,0,1400,2902,300,120,480,372,209
2020,920700321,37070,34970,34970,33970,0,2100,0,0,0,0,2100,2100,0,0,800,800,0,0,3875,210,630,300,60,783
2020,920700331,64450,8400,8400,8400,0,56050,56000,27000,29000,0,50,50,0,0,7500,0,0,0,1712,276,120,120,120,735
2020,920700341,42610,10810,10810,2810,0,31800,31100,30000,1100,0,700,700,0,0,17800,14000,14000,0,4275,375,240,720,360,270
2020,920700351,1230,1230,230,230,1000,0,0,0,0,0,0,0,0,0,10,10,0,0,963,480,5,20,48,0
2020,920700361,38100,15800,8800,8800,7000,22300,21000,0,21000,0,1300,1300,0,0,31918,13918,7468,6450,3650,900,100,400,400,105
2020,920700371,300,300,300,300,0,0,0,0,0,0,0,0,0,0,0,0,0,0,660,180,20,60,70,22
2020,920700381,44599,4299,3299,3299,1000,40300,40000,0,40000,0,300,300,0,0,15240,15240,5000,10000,3784,876,200,300,180,848
2020,920800211,6069,369,369,369,0,5700,5700,5700,0,0,0,0,0,0,0,0,0,0,2051,150,420,75,96,13
2020,920800221,8880,7580,80,80,7500,1300,0,0,0,0,1300,1300,0,0,4240,4240,3640,0,468,50,40,30,30,21
2020,920800231,12132,3432,3432,3432,0,8700,5000,5000,0,0,3700,3600,100,0,7610,7610,3960,0,2200,250,50,660,150,64
2020,920800281,22578,3528,3528,3528,0,19050,19000,10000,9000,0,50,50,0,0,500,0,0,0,1545,185,200,197,63,65
2020,920800291,5875,4525,2525,2525,2000,1350,0,0,0,0,1350,1350,0,0,3380,3380,0,3300,3464,800,130,180,170,204
2020,920800311,35054,4754,4754,4754,0,30300,30000,30000,0,0,300,300,0,0,2900,2600,500,0,1710,440,200,250,80,37
2020,920800331,4402,4402,2102,2102,2300,0,0,0,0,0,0,0,0,0,0,0,0,0,882,192,130,60,60,6
2020,920800341,24680,7980,7980,7980,0,16700,16000,16000,0,0,700,700,0,0,1100,1100,0,900,2053,264,10,247,156,151
2020,920800351,165610,1410,1410,1410,0,164200,160000,60000,100000,0,4200,3200,1000,0,100500,50500,50500,0,4154,264,400,180,230,746
2020,920800371,50585,4685,2685,2685,2000,45900,44500,0,44500,0,1400,1400,0,0,34780,31780,31700,0,1180,192,84,60,78,109
2020,920800381,87830,8630,4630,4630,4000,79200,78000,0,78000,0,1200,1200,0,0,3000,0,0,0,2784,344,50,480,144,259
2020,920800391,1200,1200,1200,1200,0,0,0,0,0,0,0,0,0,0,0,0,0,0,1475,250,200,50,90,1
2020,920900221,315,315,15,15,300,0,0,0,0,0,0,0,0,0,0,0,0,0,432,124,36,10,12,0
2020,920900231,330,330,20,20,310,0,0,0,0,0,0,0,0,0,134,134,0,0,846,129,40,37,65,0
2020,920900241,31858,8132,8132,8132,0,23726,23000,23000,0,0,726,500,226,0,0,0,0,0,4840,360,200,350,200,156
2020,920900251,15120,120,120,120,0,15000,15000,15000,0,0,0,0,0,0,6500,0,0,0,1190,200,300,50,35,17
2020,920900261,2682,2660,160,160,2500,22,0,0,0,0,22,0,22,0,0,0,0,0,630,120,20,50,50,1
2020,920900271,46234,14134,14134,14134,0,32100,15000,15000,0,0,17100,7100,0,10000,2000,2000,0,0,4215,200,215,800,454,167
2020,920900281,17850,1800,1800,500,0,16050,15000,15000,0,0,1050,1000,50,0,10650,10650,9850,0,1642,120,360,250,84,39
2020,920900301,1670,1470,1170,1170,300,200,0,0,0,0,200,200,0,0,0,0,0,0,1302,468,20,180,60,71
2020,920900311,15800,5000,5000,4640,0,10800,10000,10000,0,0,800,500,300,0,500,500,500,0,2110,180,100,200,120,36
2020,920900321,70340,2240,2240,2240,0,68100,66000,34000,32000,0,2100,2100,0,0,24600,22600,22600,0,4650,400,100,200,300,298
2020,920900341,29288,5848,5848,5848,0,23440,21000,21000,0,0,2440,2440,0,0,8676,8676,8676,0,2008,273,72,180,108,456
2020,920900351,12100,100,100,100,0,12000,11500,10000,1500,0,500,500,0,0,6638,6638,4476,2162,1104,120,50,300,144,353
2020,920900361,8350,1950,1950,1950,0,6400,5000,5000,0,0,1400,1400,0,0,500,500,500,0,1898,264,20,650,144,90
2020,920900371,3100,3100,2600,2600,500,0,0,0,0,0,0,0,0,0,0,0,0,0,2657,312,40,300,420,1
2020,920900391,25710,4247,4247,4247,0,21463,20000,11000,9000,0,1463,850,613,0,0,0,0,0,4693,384,620,970,334,103
2020,921000212,20442,2362,2362,2362,0,18080,15000,15000,0,0,3080,2980,100,0,5746,5746,3700,0,2305,230,70,250,150,51
2020,921000222,20080,20,20,20,0,20060,20000,20000,0,0,60,60,0,0,0,0,0,0,786,84,72,120,60,23
2020,921000232,1240,1090,1090,1090,0,150,0,0,0,0,150,150,0,0,1600,1600,0,1600,940,250,25,170,72,42
2020,921000242,78510,18510,510,510,18000,60000,60000,0,60000,0,0,0,0,0,0,0,0,0,1171,200,20,50,126,70
2020,921000252,55700,600,600,600,0,55100,55000,43000,12000,0,100,0,100,0,500,0,0,0,428,144,36,12,16,87
2020,921000262,2700,1500,1200,1200,300,1200,0,0,0,0,1200,700,500,0,300,300,0,0,1700,550,10,240,120,15
2020,921000272,20322,4642,4642,4642,0,15680,11680,11680,0,0,4000,3900,100,0,0,0,0,0,1850,150,50,300,150,126
2020,921000292,16520,520,520,520,0,16000,16000,16000,0,0,0,0,0,0,0,0,0,0,1185,75,200,30,40,87
2020,921000302,22210,2000,2000,2000,0,20210,16000,16000,0,0,4210,4010,200,0,2000,2000,2000,0,2142,270,200,510,60,251
2020,921000322,1330,1330,1330,1330,0,0,0,0,0,0,0,0,0,0,0,0,0,0,1007,127,540,120,60,5
2020,921000332,4780,3210,1110,110,2100,1570,0,0,0,0,1570,570,1000,0,4681,4681,2000,1000,2605,460,45,360,240,162
2020,921000342,296900,44600,44600,44600,0,252300,244000,19000,225000,0,8300,8300,0,0,8000,0,0,0,7895,605,60,1200,180,2379
2020,921000352,300,300,300,300,0,0,0,0,0,0,0,0,0,0,300,300,0,0,1660,200,100,200,60,22
2020,921000362,14310,4210,4210,4210,0,10100,7000,7000,0,0,3100,600,2500,0,0,0,0,0,1500,270,66,287,125,77
2020,921000372,10960,10160,7160,7160,3000,800,0,0,0,0,800,800,0,0,50,50,0,0,3160,600,60,180,240,62
2020,921000382,28722,10920,10920,9920,0,17802,15000,15000,0,0,2802,2350,452,0,40,40,0,0,4460,660,60,300,360,102
2020,921000392,374,374,174,174,200,0,0,0,0,0,0,0,0,0,0,0,0,0,921,300,96,36,24,1
2020,921600201,1235,1235,1235,1235,0,0,0,0,0,0,0,0,0,0,0,0,0,0,472,240,12,35,40,17
2020,921600221,45238,16138,16138,16138,0,29100,28500,21000,4000,3500,600,400,200,0,11400,11400,0,11400,4000,360,60,360,180,406
2020,921600231,8695,15,15,15,0,8680,8500,8500,0,0,180,0,180,0,3500,3500,3500,0,610,172,42,12,20,8
2020,921600241,18162,102,102,102,0,18060,18000,9000,9000,0,60,0,60,0,2700,2700,2700,0,3000,264,30,156,310,24
2020,921600251,16550,16200,3200,2900,13000,350,0,0,0,0,350,250,100,0,1000,1000,0,500,2460,250,150,510,90,22
2020,921600271,13650,1360,1360,1360,0,12290,12000,12000,0,0,290,250,40,0,0,0,0,0,2570,150,120,550,180,46
2020,921600291,25686,15636,5636,5636,10000,10050,9500,0,0,9500,550,300,250,0,5000,5000,0,5000,3550,250,400,450,150,35
2020,921600301,56020,21020,21020,11020,0,35000,12000,12000,0,0,23000,0,3000,20000,13000,13000,13000,0,3365,340,30,1430,290,1775
2020,921600311,3454,3454,2954,2954,500,0,0,0,0,0,0,0,0,0,0,0,0,0,2265,520,25,40,60,23
2020,921600331,27156,7756,7756,7756,0,19400,17000,7000,10000,0,2400,2400,0,0,0,0,0,0,2170,235,125,400,150,151
2020,921600341,10730,2030,2030,2030,0,8700,7000,4500,2500,0,1700,200,1500,0,0,0,0,0,1472,192,50,165,180,27
2020,921600361,15325,11025,11025,11025,0,4300,0,0,0,0,4300,4300,0,0,3360,3360,0,0,2480,210,200,360,120,210
2020,921600381,24296,10766,10766,10266,0,13530,11000,11000,0,0,2530,30,2000,500,1004,1004,1004,0,1936,240,30,204,192,49
2020,921700201,301,271,21,21,250,30,0,0,0,0,30,0,30,0,600,600,0,600,541,330,20,18,24,1
2020,921700231,8036,2536,2536,2536,0,5500,5000,5000,0,0,500,500,0,0,550,550,0,550,1104,80,300,240,84,31
2020,921700261,20510,510,510,510,0,20000,20000,20000,0,0,0,0,0,0,0,0,0,0,982,254,55,40,35,27
2020,921700291,20625,6400,6400,3400,0,14225,12800,8000,4800,0,1425,200,225,1000,450,450,0,450,1429,100,150,185,144,82
2020,921700311,10170,8870,6620,6620,2250,1300,0,0,0,0,1300,1300,0,0,0,0,0,0,2169,276,7,480,120,216
2020,921700341,570,520,20,20,500,50,0,0,0,0,50,50,0,0,1250,1250,0,1250,2212,580,50,390,132,25
2020,921700351,621,21,21,21,0,600,600,600,0,0,0,0,0,0,0,0,0,0,791,96,100,30,30,3
2020,921700371,32323,4097,4097,4097,0,28226,20500,8000,12500,0,7726,6000,226,1500,2070,2070,2000,0,4310,800,100,300,360,298
2020,921700381,15438,6238,6238,6238,0,9200,7200,7000,200,0,2000,2000,0,0,1600,1600,0,600,1665,160,70,185,60,33
2020,921800201,6000,1000,1000,1000,0,5000,5000,5000,0,0,0,0,0,0,0,0,0,0,392,100,20,12,30,6
2020,921800221,40650,150,150,150,0,40500,40200,40000,200,0,300,200,100,0,13770,9770,9770,0,1098,180,48,180,60,98
2020,921800231,1670,1370,1370,1370,0,300,0,0,0,0,300,300,0,0,0,0,0,0,2910,300,150,100,260,102
2020,921800241,10882,10882,4882,4882,6000,0,0,0,0,0,0,0,0,0,34,34,0,0,1338,354,30,14,60,17
2020,921800251,40172,12422,12422,10922,0,27750,21000,21000,0,0,6750,4750,1000,1000,19480,19480,14150,4850,4820,200,30,360,360,74
2020,921800261,30071,8008,8008,8008,0,22063,21000,21000,0,0,1063,950,113,0,20,20,0,0,3850,280,120,500,240,665
2020,921800271,37562,4337,4337,4337,0,33225,32000,32000,0,0,1225,1150,75,0,518,18,0,0,2820,300,500,400,200,415
2020,921800281,14942,14692,8192,8192,6500,250,0,0,0,0,250,250,0,0,50,50,0,0,2630,300,100,500,300,69
2020,921800291,99170,7170,7170,7170,0,92000,92000,92000,0,0,0,0,0,0,0,0,0,0,6990,540,360,840,250,1068
2020,921800301,4904,2854,2854,2854,0,2050,2000,0,2000,0,50,50,0,0,300,300,0,0,1202,300,240,240,72,21
2020,921800311,21916,13516,13516,13516,0,8400,8000,8000,0,0,400,0,400,0,0,0,0,0,715,150,60,25,30,27
2020,921800321,32205,6205,6205,6205,0,26000,26000,26000,0,0,0,0,0,0,8500,8500,8500,0,3005,538,635,168,180,385
2020,921800341,2610,10,10,10,0,2600,2500,2500,0,0,100,0,100,0,0,0,0,0,616,86,50,60,120,1
2020,921800361,20990,6790,6790,6790,0,14200,12700,4200,8500,0,1500,1500,0,0,0,0,0,0,5400,300,100,500,250,135
2020,921800371,2940,2940,2740,2740,200,0,0,0,0,0,0,0,0,0,2050,2050,0,2000,1504,324,50,120,120,1
2020,921800391,20390,3590,3090,3090,500,16800,13000,0,13000,0,3800,3800,0,0,0,0,0,0,2360,295,30,570,175,198
2020,921900221,8795,1667,1667,1667,0,7128,5500,5500,0,0,1628,1500,128,0,100,100,0,0,2219,440,55,215,120,61
2020,921900231,26432,23242,13242,13242,10000,3190,1000,0,1000,0,2190,1190,1000,0,9000,9000,0,9000,1977,204,150,480,96,648
2020,921900241,43188,16888,3888,3888,13000,26300,26000,0,21000,5000,300,300,0,0,17212,212,0,0,3715,300,120,260,260,98
2020,921900271,300,200,200,200,0,100,0,0,0,0,100,100,0,0,0,0,0,0,1820,400,300,100,120,31
2020,921900281,38870,1700,1700,1700,0,37170,37000,37000,0,0,170,0,170,0,5500,0,0,0,755,95,60,80,25,74
2020,921900301,39504,5964,5964,5964,0,33540,32000,22000,10000,0,1540,1300,240,0,5428,5428,5278,0,2442,252,10,410,240,91
2020,921900311,5730,1300,1300,800,0,4430,3200,3200,0,0,1230,1230,0,0,0,0,0,0,2820,766,398,90,216,75
2020,921900321,82800,5500,5500,4900,0,77300,75000,75000,0,0,2300,2300,0,0,15600,12000,12000,0,3780,150,20,264,156,101
2020,921900331,873880,56530,56530,56530,0,817350,680000,30000,650000,0,137350,27350,95000,15000,0,0,0,0,7718,120,12,960,276,597
2020,921900341,9540,540,540,540,0,9000,9000,9000,0,0,0,0,0,0,0,0,0,0,700,100,40,20,60,26
2020,921900361,520,20,20,20,0,500,500,500,0,0,0,0,0,0,0,0,0,0,537,95,20,35,32,3
2020,921900371,6334,2334,2334,2334,0,4000,4000,4000,0,0,0,0,0,0,0,0,0,0,1000,170,130,40,40,15
2020,921900381,11587,3450,3450,3450,0,8137,8000,8000,0,0,137,0,137,0,0,0,0,0,1076,228,200,120,18,31
2020,921900391,12780,2160,2160,2160,0,10620,10000,10000,0,0,620,620,0,0,0,0,0,0,1524,180,320,300,120,41
2020,922000202,17215,1170,1170,1170,0,16045,16000,16000,0,0,45,0,45,0,0,0,0,0,1932,72,20,180,240,74
2020,922000212,5293,5248,1748,1748,3500,45,0,0,0,0,45,0,45,0,20,20,0,0,1736,156,24,216,180,23
2020,922000232,51700,4750,4750,4750,0,46950,46000,31000,15000,0,950,950,0,0,2000,0,0,0,1570,240,55,150,45,117
2020,922000262,220,220,20,20,200,0,0,0,0,0,0,0,0,0,0,0,0,0,531,84,2,10,20,0
2020,922000272,18267,4767,4767,4767,0,13500,12000,12000,0,0,1500,1500,0,0,0,0,0,0,2600,200,100,150,160,504
2020,922000292,19000,5200,5200,5200,0,13800,13000,13000,0,0,800,800,0,0,80,80,0,0,1562,156,172,60,36,27
2020,922000302,8110,110,110,110,0,8000,8000,8000,0,0,0,0,0,0,0,0,0,0,457,110,60,55,27,7
2020,922000312,42097,220,220,220,0,41877,37000,500,36500,0,4877,2200,2677,0,5400,5400,2300,3100,1293,380,100,100,70,25
2020,922000332,18770,870,870,870,0,17900,7000,7000,0,0,10900,2850,50,8000,4500,4500,2700,0,1518,300,500,18,140,14
2020,922000342,41250,3200,3200,3200,0,38050,38000,3000,35000,0,50,0,50,0,0,0,0,0,1028,180,350,60,48,20
2020,922000352,12490,1430,1430,1430,0,11060,10500,7000,3500,0,560,560,0,0,0,0,0,0,3130,276,530,255,123,122
2020,922600221,107702,15002,15002,15002,0,92700,90000,90000,0,0,2700,2300,400,0,3540,540,0,440,3530,400,400,550,180,150
2020,922600231,4750,4650,1650,1650,3000,100,0,0,0,0,100,0,100,0,0,0,0,0,951,180,260,55,36,2
2020,922600251,43124,17598,17598,17598,0,25526,25000,25000,0,0,526,450,76,0,0,0,0,0,2820,240,360,60,240,32
2020,922600281,22029,6620,6620,6620,0,15409,13850,13850,0,0,1559,1175,384,0,5932,5932,4000,1500,4127,354,10,367,214,60
2020,922600291,67271,59320,51820,51820,7500,7951,1500,0,1500,0,6451,5095,1356,0,3432,3432,0,0,1958,215,410,375,121,699
2020,922600301,14612,5912,5912,5912,0,8700,8700,8000,700,0,0,0,0,0,0,0,0,0,1206,470,60,36,60,26
2020,922600321,67460,6260,6260,6260,0,61200,56000,10000,46000,0,5200,1200,4000,0,3300,3300,300,0,2318,220,150,530,130,55
2020,922600341,37900,8660,8660,8660,0,29240,27000,5000,22000,0,2240,1700,540,0,0,0,0,0,1341,162,100,240,144,82
2020,922600351,10900,5000,5000,5000,0,5900,4400,3000,1400,0,1500,1500,0,0,0,0,0,0,871,180,10,300,96,92
2020,922700201,40500,34100,32700,32700,1400,6400,0,0,0,0,6400,6000,400,0,100,100,0,0,2656,240,80,200,276,541
2020,922700211,125302,24522,24522,22522,0,100780,99500,49500,50000,0,1280,1280,0,0,35000,35000,35000,0,5470,480,200,550,300,669
2020,922700231,248941,42163,42163,37163,0,206778,190000,150000,40000,0,16778,5378,6400,5000,42777,42777,40717,0,8090,780,1290,300,320,342
2020,922700241,71640,2640,2640,2640,0,69000,68000,30000,38000,0,1000,1000,0,0,11350,7350,7100,0,2850,170,100,600,300,187
2020,922700251,17894,2844,2844,2844,0,15050,15000,15000,0,0,50,0,50,0,0,0,0,0,1710,350,200,100,100,26
2020,922700261,31850,15050,15050,15050,0,16800,16000,16000,0,0,800,500,300,0,50,50,0,0,3260,230,680,400,100,83
2020,922700291,16328,1900,1900,1900,0,14428,14000,14000,0,0,428,428,0,0,2250,2250,2250,0,3610,300,350,400,300,38
2020,922700301,35355,17180,17180,17180,0,18175,16000,16000,0,0,2175,2000,175,0,3300,3300,3000,0,3666,410,120,180,240,262
2020,922700311,19279,9734,9734,9734,0,9545,9000,9000,0,0,545,400,145,0,0,0,0,0,1633,194,210,360,84,76
2020,922700321,8660,6550,6550,6550,0,2110,2000,2000,0,0,110,100,10,0,0,0,0,0,1036,162,30,210,30,22
2020,922700351,10227,2477,2477,2477,0,7750,7600,3300,4300,0,150,150,0,0,0,0,0,0,1870,190,100,280,84,6
2020,922700361,7262,6826,4826,4826,2000,436,0,0,0,0,436,300,136,0,0,0,0,0,1939,555,250,136,192,13
2020,922800231,12500,4800,4300,4300,500,7700,7000,0,7000,0,700,700,0,0,0,0,0,0,3970,850,110,620,240,56
2020,922800251,48492,11892,11892,11892,0,36600,35000,35000,0,0,1600,400,1200,0,12022,12022,12022,0,3010,202,466,250,102,119
2020,922800271,10023,9523,323,323,9200,500,0,0,0,0,500,500,0,0,0,0,0,0,2380,180,35,300,120,156
2020,922800291,24000,5000,5000,5000,0,19000,15000,15000,0,0,4000,4000,0,0,6000,6000,4300,0,4800,300,200,500,200,357
2020,922800311,22340,1160,1160,1160,0,21180,21000,13000,8000,0,180,180,0,0,0,0,0,0,1620,240,120,360,180,240
2020,922800321,7694,7092,6092,6092,1000,602,0,0,0,0,602,0,602,0,800,800,0,0,1848,490,350,100,120,1
2020,922800351,33255,4305,4305,4305,0,28950,25000,25000,0,0,3950,2250,1700,0,2400,2400,400,2000,3808,564,30,780,360,150
2020,922900221,30788,12968,11968,8468,1000,17820,16000,0,0,16000,1820,700,1120,0,5930,5930,0,5800,4470,600,20,600,360,61
2020,922900231,1431,431,131,131,300,1000,0,0,0,0,1000,1000,0,0,0,0,0,0,2242,492,20,320,480,36
2020,922900241,22240,240,240,240,0,22000,22000,22000,0,0,0,0,0,0,7500,7500,7500,0,1130,300,250,100,30,18
2020,922900251,10757,8807,3807,3807,5000,1950,0,0,0,0,1950,1950,0,0,0,0,0,0,1861,159,15,380,65,162
2020,922900261,43160,9560,9560,9560,0,33600,33250,28800,4450,0,350,350,0,0,0,0,0,0,2310,360,400,250,100,94
2020,922900271,260,260,260,260,0,0,0,0,0,0,0,0,0,0,0,0,0,0,1020,240,200,60,60,1
2020,922900281,24428,14228,6228,6228,8000,10200,10000,0,0,10000,200,200,0,0,1700,1700,600,0,5340,260,200,360,300,525
2020,922900321,81452,3452,3452,3452,0,78000,75700,14500,61200,0,2300,1500,800,0,2100,2100,1500,500,5450,200,100,100,150,429
2020,922900331,16301,941,941,941,0,15360,11600,7700,3900,0,3760,3760,0,0,6255,6255,3555,2700,4336,156,300,480,380,186
2020,922900351,6300,300,300,300,0,6000,6000,6000,0,0,0,0,0,0,0,0,0,0,844,148,200,15,40,6
2020,923000202,8160,6960,6960,6960,0,1200,0,0,0,0,1200,1200,0,0,5500,5500,0,5200,1860,300,120,100,150,29
2020,923000212,17230,3880,3880,3880,0,13350,13000,13000,0,0,350,200,150,0,8000,8000,8000,0,2150,200,60,120,120,59
2020,923000222,78580,380,380,380,0,78200,77000,72000,5000,0,1200,1000,200,0,30000,20000,20000,0,1690,240,20,60,120,130
2020,923000242,19889,12258,12258,12258,0,7631,6431,0,6431,0,1200,500,700,0,60,60,0,0,1708,200,30,80,42,53
2020,923600201,57440,840,840,840,0,56600,55000,27000,28000,0,1600,600,1000,0,19000,18000,15000,3000,2010,320,180,240,60,123
2020,923600211,164242,70742,70742,70742,0,93500,92000,42000,50000,0,1500,800,700,0,210,210,0,0,4750,500,400,360,240,514
2020,923600221,146628,15928,15928,15428,0,130700,123000,35000,88000,0,7700,4700,3000,0,62120,62120,52000,0,4270,400,20,450,500,345
2020,923600231,3144,2724,2224,1724,500,420,0,0,0,0,420,250,170,0,0,0,0,0,2276,502,80,200,144,1693
2020,923600251,2953,2920,1120,1120,1800,33,0,0,0,0,33,0,33,0,0,0,0,0,544,204,30,25,25,1
2020,923700211,11155,9855,855,855,9000,1300,0,0,0,0,1300,1300,0,0,9100,9100,7000,2100,3420,440,200,600,480,123
2020,923700221,48520,7220,7220,7220,0,41300,40000,40000,0,0,1300,1300,0,0,12110,12110,12000,0,3870,200,10,240,300,176
2020,923700241,945,600,600,600,0,345,0,0,0,0,345,100,245,0,0,0,0,0,402,66,120,12,15,5
2020,923700251,545,545,245,245,300,0,0,0,0,0,0,0,0,0,0,0,0,0,1885,255,10,130,120,1
2020,923800201,110288,11688,11688,11688,0,98600,97600,28000,69600,0,1000,1000,0,0,1000,0,0,0,3900,360,10,480,120,969
2020,923800211,24915,6480,6480,6480,0,18435,17500,17500,0,0,935,900,35,0,0,0,0,0,2422,280,100,400,192,452
2020,923800231,34760,9960,9960,7960,0,24800,19500,19500,0,0,5300,4300,1000,0,8386,8386,8336,0,3370,370,60,400,360,488
2020,923800241,514,514,214,214,300,0,0,0,0,0,0,0,0,0,2000,2000,0,2000,1410,500,20,70,60,33
2020,923900201,41470,2420,2420,2340,0,39050,37000,37000,0,0,2050,1300,750,0,11600,11600,11300,300,4145,360,300,500,230,102
2020,923900221,4020,4020,20,20,4000,0,0,0,0,0,0,0,0,0,0,0,0,0,632,60,72,36,24,1
2020,923900231,21920,620,620,620,0,21300,21000,21000,0,0,300,300,0,0,3400,3400,3400,0,4528,360,200,500,228,132
2020,930000202,15575,1575,1575,1575,0,14000,12000,12000,0,0,2000,2000,0,0,7000,7000,7000,0,1162,164,60,108,216,42
2020,930000222,23085,2416,2416,2416,0,20669,20000,20000,0,0,669,600,69,0,2000,2000,0,0,1652,228,205,204,180,78
2020,930000232,25160,160,160,160,0,25000,25000,25000,0,0,0,0,0,0,0,0,0,0,1024,190,70,30,42,31
2020,930000252,54420,9420,9420,5620,0,45000,44000,30000,14000,0,1000,0,500,500,11000,0,0,0,1750,300,150,200,180,39
2020,930000262,8050,50,50,50,0,8000,8000,8000,0,0,0,0,0,0,2350,2350,2350,0,1133,150,10,33,120,10
2020,930000272,51290,2590,2590,2590,0,48700,48000,30000,18000,0,700,700,0,0,19000,16000,16000,0,2726,456,180,120,132,213
2020,930000282,72665,20922,20922,20922,0,51743,51000,51000,0,0,743,515,228,0,5417,5417,5417,0,3811,300,60,500,250,2315
2020,930000292,154870,11770,11770,11770,0,143100,108000,65000,43000,0,35100,2000,3100,30000,74640,74640,54640,20000,8850,480,10,440,60,7086
2020,930000302,5519,2519,2519,2519,0,3000,2500,2500,0,0,500,500,0,0,0,0,0,0,1036,240,100,240,42,25
2020,930000312,58112,8612,8612,8612,0,49500,45000,45000,0,0,4500,4500,0,0,0,0,0,0,1862,146,72,360,120,185
2020,930000322,9960,3960,3960,3960,0,6000,6000,6000,0,0,0,0,0,0,0,0,0,0,562,202,48,15,12,8
2020,930000342,2510,2410,710,710,1700,100,0,0,0,0,100,100,0,0,0,0,0,0,1665,256,380,160,114,13
2020,930000372,15900,900,900,900,0,15000,15000,15000,0,0,0,0,0,0,0,0,0,0,637,180,180,10,15,19
2020,930000392,39387,15387,15387,15387,0,24000,23000,14000,9000,0,1000,500,500,0,7000,0,0,0,3584,438,100,180,276,951
2020,930600251,13358,358,358,358,0,13000,13000,13000,0,0,0,0,0,0,0,0,0,0,670,154,36,10,25,18
2020,930600291,9820,9820,9820,9820,0,0,0,0,0,0,0,0,0,0,0,0,0,0,1526,60,20,10,96,74
2020,930600321,76326,21826,21826,21826,0,54500,51000,30000,21000,0,3500,3500,0,0,1300,1300,1300,0,2152,300,100,240,132,1261
2020,930600331,8690,2910,2910,410,0,5780,5000,5000,0,0,780,480,300,0,0,0,0,0,1326,256,50,180,180,25
2020,930600371,24738,3738,3738,3738,0,21000,17000,17000,0,0,4000,4000,0,0,13268,13268,10300,0,2212,220,25,390,168,161
2020,930600381,43464,17964,17964,16864,0,25500,25000,25000,0,0,500,500,0,0,4900,4900,4900,0,7424,380,150,640,378,785
2020,930600391,18323,3973,3973,973,0,14350,7500,7500,0,0,6850,4350,1500,1000,4003,4003,0,1500,3555,540,36,649,240,68
2020,930700261,8093,6365,6365,6365,0,1728,0,0,0,0,1728,1228,500,0,919,919,0,0,3004,240,1500,600,84,23
2020,930700271,54410,4260,4260,4260,0,50150,50000,20000,30000,0,150,150,0,0,4000,4000,4000,0,1555,280,100,200,90,66
2020,930700291,43466,38566,12066,11566,26500,4900,700,0,700,0,4200,1700,2500,0,17600,17600,9000,8000,4070,420,10,400,300,1260
2020,930700331,10883,3230,3230,3230,0,7653,7500,7500,0,0,153,0,153,0,0,0,0,0,1079,120,18,15,84,32
2020,930700341,10294,4494,4494,4494,0,5800,5000,5000,0,0,800,800,0,0,0,0,0,0,1945,120,150,390,70,57
2020,930700351,3150,1910,950,950,960,1240,0,0,0,0,1240,1240,0,0,1490,1490,650,840,2240,360,60,360,110,202
2020,930700361,2360,2160,560,560,1600,200,0,0,0,0,200,200,0,0,0,0,0,0,1292,300,50,60,72,1
2020,930700371,9640,640,640,640,0,9000,8500,8500,0,0,500,500,0,0,1600,1600,1600,0,888,240,10,180,48,42
2020,930800231,2706,1706,1206,1206,500,1000,0,0,0,0,1000,1000,0,0,0,0,0,0,4339,660,8,654,438,92
2020,930800291,87151,87151,27151,27151,60000,0,0,0,0,0,0,0,0,0,48000,48000,0,48000,9770,400,250,600,120,2705
2020,930800301,340,240,240,240,0,100,0,0,0,0,100,100,0,0,4500,4500,0,1500,1793,126,500,240,60,44
2020,930800311,23202,4934,4934,4934,0,18268,18000,10000,8000,0,268,200,68,0,25,25,0,0,1780,180,40,120,120,35
2020,930800331,3061,3061,2761,2761,300,0,0,0,0,0,0,0,0,0,0,0,0,0,964,240,24,50,80,26
2020,930800341,71749,17749,17749,17749,0,54000,50500,10500,40000,0,3500,3500,0,0,11000,0,0,0,3735,860,400,480,180,94
2020,930800351,665,545,295,295,250,120,0,0,0,0,120,120,0,0,0,0,0,0,1135,340,25,106,48,26
2020,930800361,7611,4011,3011,1586,1000,3600,0,0,0,0,3600,0,600,3000,3900,3900,0,3900,1899,744,65,140,110,187
2020,930800371,15602,4312,4312,4312,0,11290,9000,9000,0,0,2290,2290,0,0,9500,9500,8500,0,3095,250,20,160,245,66
2020,930800381,96635,22035,22035,22035,0,74600,74000,24000,40000,10000,600,600,0,0,38322,10822,10822,0,7212,372,400,360,280,2955
2020,930900211,8310,6210,710,710,5500,2100,0,0,0,0,2100,2100,0,0,0,0,0,0,3240,120,300,540,360,265
2020,930900221,3388,3388,2908,2308,480,0,0,0,0,0,0,0,0,0,0,0,0,0,1610,240,40,200,180,22
2020,930900231,164,164,4,4,160,0,0,0,0,0,0,0,0,0,0,0,0,0,582,120,20,60,72,1
2020,930900241,47874,17274,17274,10274,0,30600,28000,28000,0,0,2600,2600,0,0,16900,16900,14000,2900,3036,216,0,180,240,377
2020,930900261,41850,8840,8840,5840,0,33010,32000,32000,0,0,1010,1010,0,0,25000,25000,25000,0,2460,240,60,180,60,576
2020,930900271,118462,8392,8392,7392,0,110070,106500,76500,30000,0,3570,3070,500,0,29000,26000,20000,6000,12310,1380,700,500,480,2194
2020,930900291,80792,29359,29359,29359,0,51433,51000,51000,0,0,433,433,0,0,0,0,0,0,2335,400,200,150,200,278
2020,930900301,4435,4185,3685,3685,500,250,0,0,0,0,250,250,0,0,0,0,0,0,3023,682,72,636,134,69
2020,930900351,21824,2924,2924,2924,0,18900,18000,18000,0,0,900,900,0,0,0,0,0,0,2584,264,120,180,120,85
2020,930900361,2368,2168,1668,1668,500,200,0,0,0,0,200,0,200,0,300,300,0,300,2111,600,60,120,120,5
2020,930900371,32860,5260,5260,5260,0,27600,27000,7000,20000,0,600,600,0,0,3500,3500,1000,2500,1944,360,120,240,204,211
2020,930900381,5581,5331,3331,3331,2000,250,0,0,0,0,250,250,0,0,0,0,0,0,2200,486,180,240,120,44
2020,930900391,8577,7507,3007,3007,4500,1070,0,0,0,0,1070,1070,0,0,2000,2000,2000,0,2840,300,360,480,180,6
2020,931000202,72639,113,113,113,0,72526,72000,72000,0,0,526,300,226,0,78500,78500,48000,0,7420,600,300,1200,620,1060
2020,931000212,7972,7852,7352,7352,500,120,0,0,0,0,120,120,0,0,0,0,0,0,1628,660,5,30,240,25
2020,931000242,6106,5900,2700,2700,3200,206,0,0,0,0,206,206,0,0,9000,9000,0,0,2430,516,350,220,120,48
2020,931000252,40487,6087,6087,6087,0,34400,34200,34200,0,0,200,200,0,0,21966,21966,11966,0,4688,283,120,138,180,188
2020,931000282,123050,4100,4100,4100,0,118950,110000,30000,80000,0,8950,7950,1000,0,12170,12170,9920,2000,5320,300,240,720,420,629
2020,931000302,20932,2182,2182,2182,0,18750,18500,18500,0,0,250,250,0,0,10788,10788,10000,400,1063,204,50,240,96,46
2020,931000312,5972,5872,4572,4572,1300,100,0,0,0,0,100,100,0,0,0,0,0,0,1390,540,70,150,100,43
2020,931000332,9719,9534,5734,5734,3800,185,0,0,0,0,185,185,0,0,1400,1400,0,1100,2390,120,10,150,300,14
2020,931000352,2372,1872,872,872,1000,500,0,0,0,0,500,0,500,0,2000,2000,0,2000,4635,1165,247,300,300,159
2020,931000362,48012,4342,4342,4342,0,43670,42500,20000,22500,0,1170,450,720,0,19300,12300,11300,1000,4454,204,120,360,360,360
2020,931000372,2075,2075,75,75,2000,0,0,0,0,0,0,0,0,0,0,0,0,0,1940,150,20,100,50,1
2020,931000382,1727,1727,27,27,1700,0,0,0,0,0,0,0,0,0,0,0,0,0,1120,300,0,60,0,1
2020,931000392,18705,205,205,205,0,18500,18100,5100,13000,0,400,400,0,0,0,0,0,0,2030,100,800,200,120,26
2020,931600221,43664,1664,1664,1664,0,42000,42000,42000,0,0,0,0,0,0,0,0,0,0,1771,180,800,50,31,51
2020,931600251,3500,3500,500,500,3000,0,0,0,0,0,0,0,0,0,0,0,0,0,912,60,60,36,24,1
2020,931600271,8100,100,100,100,0,8000,8000,8000,0,0,0,0,0,0,0,0,0,0,746,84,60,35,15,12
2020,931600311,213760,1500,1500,1500,0,212260,198000,73000,125000,0,14260,6500,2760,5000,40290,32290,26000,0,6152,600,100,600,192,203
2020,931600331,9640,2590,2590,2590,0,7050,7000,7000,0,0,50,50,0,0,0,0,0,0,4040,470,40,556,340,60
2020,931600351,19920,2520,2520,1520,0,17400,10500,10500,0,0,6900,3900,0,3000,6812,6812,6812,0,3310,360,10,360,180,80
2020,931600361,1450,1050,1050,1050,0,400,0,0,0,0,400,400,0,0,100,100,0,0,2150,350,180,300,250,82
2020,931600371,8813,2200,2200,2200,0,6613,6000,6000,0,0,613,500,113,0,1800,1800,1800,0,5176,720,20,880,336,187
2020,931600381,30896,866,866,866,0,30030,30000,30000,0,0,30,0,30,0,10000,10000,10000,0,2020,540,50,240,360,44
2020,931700211,120,120,20,20,100,0,0,0,0,0,0,0,0,0,100,100,0,0,1075,280,200,30,80,1
2020,931700241,2240,2240,1500,1500,740,0,0,0,0,0,0,0,0,0,0,0,0,0,622,150,120,10,60,2
2020,931700271,1550,1550,1350,1350,200,0,0,0,0,0,0,0,0,0,440,440,0,440,1969,516,250,135,220,29
2020,931700301,74160,13580,13580,13380,0,60580,59400,33000,26400,0,1180,1180,0,0,6400,6400,4200,2200,10417,312,300,770,325,1336
2020,931700321,123560,11760,11760,11760,0,111800,110000,30000,80000,0,1800,800,1000,0,5020,20,0,0,5430,240,50,240,240,1672
2020,931700331,89900,100,100,100,0,89800,88500,75000,13500,0,1300,1300,0,0,20483,15033,15000,0,2364,438,150,500,216,211
2020,931700341,17980,3980,3980,3980,0,14000,13000,13000,0,0,1000,1000,0,0,8002,8002,8002,0,2597,310,145,330,230,69
2020,931700361,10900,900,900,900,0,10000,10000,0,10000,0,0,0,0,0,0,0,0,0,1270,77,600,60,48,342
2020,931700371,30,30,30,30,0,0,0,0,0,0,0,0,0,0,0,0,0,0,506,180,120,10,36,1
2020,931700381,47424,6204,6204,6204,0,41220,28000,21000,7000,0,13220,3000,220,10000,2000,1500,300,1200,2176,200,120,360,252,300
2020,931700391,23618,9418,9418,9418,0,14200,14000,14000,0,0,200,200,0,0,4180,4180,4180,0,2740,150,30,260,360,296
2020,931800201,92755,35705,15705,15705,20000,57050,53900,0,53900,0,3150,3050,100,0,36300,6800,4800,2000,6508,180,60,324,236,609
2020,931800211,74659,18060,18060,18060,0,56599,52500,27500,25000,0,4099,3986,113,0,0,0,0,0,3980,300,530,840,240,179
2020,931800221,24219,2769,2769,2769,0,21450,20000,20000,0,0,1450,1000,450,0,5300,5300,5000,0,4290,250,200,360,360,341
2020,931800231,2792,2792,2292,2292,500,0,0,0,0,0,0,0,0,0,1042,1042,0,642,2000,450,10,170,150,4
2020,931800241,82,82,82,82,0,0,0,0,0,0,0,0,0,0,0,0,0,0,1567,120,400,20,32,1
2020,931800251,520,520,20,20,500,0,0,0,0,0,0,0,0,0,90,90,90,0,1546,600,180,60,30,21
2020,931800281,22234,2984,2984,2984,0,19250,18000,18000,0,0,1250,900,350,0,5573,5573,5573,0,2063,250,20,260,108,76
2020,931800291,1420,1400,1100,1100,300,20,0,0,0,0,20,0,20,0,800,800,0,800,884,330,20,30,98,1
2020,931800301,57861,15411,15411,15411,0,42450,37000,24000,13000,0,5450,2000,3450,0,1900,1900,1900,0,7050,650,590,400,300,303
2020,931800311,58484,34684,18684,18684,16000,23800,23000,0,23000,0,800,300,500,0,15000,0,0,0,3250,390,200,650,180,87
2020,931800321,12082,1532,1532,1532,0,10550,9000,9000,0,0,1550,750,0,800,0,0,0,0,4600,400,1500,450,250,143
2020,931800341,37300,7720,7720,7720,0,29580,29500,29500,0,0,80,80,0,0,15000,15000,15000,0,3704,240,24,360,360,39
2020,931800361,39500,2100,2100,2100,0,37400,32000,32000,0,0,5400,400,5000,0,13903,13903,13903,0,2320,360,300,240,96,1415
2020,931800391,5740,40,40,40,0,5700,5500,5500,0,0,200,200,0,0,4363,4363,0,2963,2178,154,200,510,132,221
2020,931900201,1513,1513,1313,973,200,0,0,0,0,0,0,0,0,0,0,0,0,0,1586,426,0,30,120,16
2020,931900211,301,301,1,1,300,0,0,0,0,0,0,0,0,0,1900,1900,0,0,617,323,50,48,30,1
2020,931900221,21000,5000,5000,5000,0,16000,16000,16000,0,0,0,0,0,0,0,0,0,0,990,240,35,40,45,18
2020,931900241,6840,6240,1740,1740,4500,600,0,0,0,0,600,600,0,0,2010,2010,2000,0,2314,420,100,264,240,48
2020,931900271,33386,2986,2986,2986,0,30400,22000,22000,0,0,8400,1400,0,7000,0,0,0,0,2350,336,156,24,100,30
2020,931900291,33012,6560,6560,6560,0,26452,26000,26000,0,0,452,0,452,0,400,400,400,0,1318,360,120,180,102,93
2020,931900301,17080,1030,1030,830,0,16050,15000,15000,0,0,1050,350,700,0,0,0,0,0,2996,140,10,400,276,23
2020,931900311,4500,4500,2000,2000,2500,0,0,0,0,0,0,0,0,0,0,0,0,0,399,45,150,20,24,1
2020,931900331,23702,13702,13702,13702,0,10000,10000,10000,0,0,0,0,0,0,2000,2000,2000,0,4282,300,120,420,600,43
2020,931900341,10880,380,380,380,0,10500,10000,10000,0,0,500,500,0,0,0,0,0,0,1502,204,20,180,108,40
2020,931900351,16446,7946,7946,7946,0,8500,8000,8000,0,0,500,500,0,0,800,800,800,0,4920,340,600,370,300,46
2020,931900361,31795,7495,7495,7495,0,24300,22000,22000,0,0,2300,2300,0,0,9300,9300,9300,0,3355,360,350,120,300,138
2020,931900371,56796,56196,29196,29196,27000,600,0,0,0,0,600,500,100,0,0,0,0,0,8676,288,250,324,84,1541
2020,931900381,2400,400,400,400,0,2000,2000,2000,0,0,0,0,0,0,0,0,0,0,637,140,220,20,17,4
2020,931900391,7482,2052,2052,2052,0,5430,3200,3200,0,0,2230,1900,330,0,2100,2100,0,300,1850,240,80,240,120,54
2020,932000202,18230,30,30,30,0,18200,17000,17000,0,0,1200,1200,0,0,10000,10000,10000,0,4037,72,310,300,280,52
2020,932000212,19770,4920,4920,4920,0,14850,14500,14500,0,0,350,350,0,0,3930,3930,3930,0,2497,197,30,204,222,193
2020,932000222,10330,5300,5300,5300,0,5030,5000,5000,0,0,30,30,0,0,0,0,0,0,1466,53,65,69,129,52
2020,932000242,48163,47663,19663,19663,28000,500,0,0,0,0,500,500,0,0,0,0,0,0,6820,420,200,240,360,420
2020,932000262,21000,650,650,650,0,20350,19000,19000,0,0,1350,1350,0,0,18060,18060,18000,0,1992,120,12,240,240,61
2020,932000292,16800,15400,400,400,15000,1400,0,0,0,0,1400,800,600,0,19830,19830,12000,7500,4065,570,5,60,180,332
2020,932000302,13400,5400,5400,5400,0,8000,8000,8000,0,0,0,0,0,0,0,0,0,0,612,60,60,36,18,26
2020,932000322,47310,2100,2100,2100,0,45210,45200,5200,40000,0,10,0,10,0,0,0,0,0,825,220,100,20,15,29
2020,932600201,45831,6641,6641,6641,0,39190,37500,24000,13500,0,1690,1170,520,0,2450,2450,2400,0,4268,288,500,200,300,250
2020,932600211,30200,6200,6200,6200,0,24000,24000,24000,0,0,0,0,0,0,0,0,0,0,1201,270,150,20,36,495
2020,932600221,21122,7166,7166,7166,0,13956,12000,12000,0,0,1956,1500,456,0,0,0,0,0,2122,138,20,200,182,110
2020,932600251,42840,2290,2290,2290,0,40550,40000,40000,0,0,550,550,0,0,11404,11404,11204,200,2660,300,30,360,240,283
2020,932600271,26900,16900,16900,16900,0,10000,10000,10000,0,0,0,0,0,0,0,0,0,0,960,120,0,120,130,13
2020,932600281,70460,11860,11860,11860,0,58600,55000,55000,0,0,3600,3600,0,0,27450,27450,25000,0,2350,480,100,360,240,78
2020,932600291,68610,8260,8260,2260,0,60350,55000,55000,0,0,5350,3350,2000,0,0,0,0,0,4690,540,50,600,360,182
2020,932600301,18025,8450,8450,8450,0,9575,9400,1400,8000,0,175,0,175,0,0,0,0,0,1060,120,200,50,60,20
2020,932600311,23185,14575,14575,14575,0,8610,8000,2000,6000,0,610,0,610,0,0,0,0,0,1260,160,80,20,60,36
2020,932600321,270,270,270,270,0,0,0,0,0,0,0,0,0,0,0,0,0,0,618,174,200,24,10,1
2020,932600331,3325,2325,2325,2125,0,1000,0,0,0,0,1000,0,0,1000,1000,1000,1000,0,1136,300,60,60,36,8
2020,932700201,11475,2020,2020,2020,0,9455,9400,9400,0,0,55,0,55,0,2000,2000,2000,0,702,140,20,36,16,1
2020,932700211,28093,6093,6093,6093,0,22000,21500,21500,0,0,500,500,0,0,100,100,0,0,1778,204,200,150,84,40
2020,932700241,46925,2684,2684,2684,0,44241,44000,11000,33000,0,241,150,91,0,24200,2200,2200,0,1229,120,10,105,78,46
2020,932700251,8400,5920,3920,3920,2000,2480,0,0,0,0,2480,1300,1180,0,1450,1450,1300,150,3173,456,230,482,232,1
2020,932700261,30386,4386,4386,4386,0,26000,25500,25500,0,0,500,0,500,0,17700,17700,16800,900,2050,240,10,50,300,341
2020,932700291,17430,430,430,430,0,17000,17000,17000,0,0,0,0,0,0,0,0,0,0,1606,240,450,30,36,26
2020,932700311,1500,1500,1500,1500,0,0,0,0,0,0,0,0,0,0,0,0,0,0,702,100,240,24,30,23
2020,932700321,4670,670,670,670,0,4000,4000,0,4000,0,0,0,0,0,0,0,0,0,733,108,240,24,36,4
2020,932800201,39034,4834,4834,4834,0,34200,31700,28700,3000,0,2500,2500,0,0,13400,13400,11700,1700,3725,250,300,250,190,335
2020,932800211,42158,11258,11258,11258,0,30900,28700,28700,0,0,2200,2200,0,0,19287,19287,17800,0,4762,300,120,720,162,86
2020,932800221,10662,9404,904,904,8500,1258,0,0,0,0,1258,1258,0,0,10970,10970,6700,4200,1924,550,20,240,144,233
2020,932800261,57190,8840,8840,6840,0,48350,42500,27500,15000,0,5850,850,0,5000,32000,20000,20000,0,5030,240,360,600,360,142
2020,932800271,31996,3196,3196,3196,0,28800,28000,14000,14000,0,800,800,0,0,7000,0,0,0,3500,240,40,480,240,215
2020,932800281,1132,832,182,182,650,300,0,0,0,0,300,300,0,0,1200,1200,0,0,1340,420,60,120,120,16
2020,932800301,12030,4680,4680,4680,0,7350,5500,5500,0,0,1850,1800,50,0,0,0,0,0,1635,157,12,350,97,215
2020,932800311,5170,1170,1170,1170,0,4000,4000,4000,0,0,0,0,0,0,0,0,0,0,563,132,60,24,36,5
2020,932800321,5550,1850,1850,1850,0,3700,3600,1500,2100,0,100,0,100,0,0,0,0,0,1083,97,434,30,30,2
2020,932800331,15713,1763,1763,1763,0,13950,12300,1500,10800,0,1650,100,1550,0,1300,1300,0,500,1365,240,60,50,60,8
2020,932900201,62220,9220,9220,9220,0,53000,51000,25000,26000,0,2000,2000,0,0,1000,0,0,0,2720,480,140,264,132,254
2020,932900211,41140,28585,7585,7585,21000,12555,12555,0,0,12555,0,0,0,0,23184,23184,17500,5655,3472,360,50,60,156,11
2020,932900231,19000,2700,2700,2700,0,16300,15500,9000,6500,0,800,800,0,0,10850,5850,5850,0,3370,300,200,400,240,119
2020,932900281,260,260,160,160,100,0,0,0,0,0,0,0,0,0,0,0,0,0,572,288,30,20,18,0
2020,932900291,31100,400,400,400,0,30700,29600,25000,4600,0,1100,1100,0,0,2000,2000,2000,0,1220,150,150,80,60,34
2020,932900301,3000,3000,3000,3000,0,0,0,0,0,0,0,0,0,0,0,0,0,0,886,160,240,36,0,45
2020,932900311,90,90,90,90,0,0,0,0,0,0,0,0,0,0,8000,8000,0,8000,873,84,180,40,48,1
2020,932900321,8511,7011,7011,7011,0,1500,0,0,0,0,1500,1300,200,0,0,0,0,0,1137,81,68,185,137,41
2020,932900331,50128,23226,23226,22226,0,26902,20000,20000,0,0,6902,1250,652,5000,11112,11112,6816,4296,6299,2160,720,135,120,35
2020,933000212,66000,2500,2500,1000,0,63500,62000,20000,42000,0,1500,0,1500,0,9000,9000,7000,2000,1150,240,0,120,60,41
2020,933600201,9864,9064,7264,7264,1800,800,0,0,0,0,800,800,0,0,6650,6650,0,3000,4300,1920,120,480,280,129
2020,933600211,31660,7160,7160,7160,0,24500,24500,3000,21500,0,0,0,0,0,0,0,0,0,920,150,20,50,60,31
2020,933800201,1620,1620,220,220,1400,0,0,0,0,0,0,0,0,0,0,0,0,0,640,188,10,20,72,1
2020,940000202,41175,3669,3669,3669,0,37506,36000,15000,21000,0,1506,1240,266,0,6546,6546,6546,0,1516,216,270,240,120,84
2020,940000222,28317,3969,3969,3969,0,24348,20000,20000,0,0,4348,4280,68,0,2643,2643,0,0,3496,314,111,342,425,178
2020,940000232,22675,2095,2095,1595,0,20580,18000,18000,0,0,2580,580,2000,0,9160,9160,9160,0,5806,244,5,688,367,23
2020,940000252,1018,469,269,269,200,549,0,0,0,0,549,500,49,0,5000,5000,0,5000,2553,150,10,243,144,158
2020,940000292,71091,6697,6697,6317,0,64394,63000,13000,50000,0,1394,1164,230,0,4000,2000,2000,0,2366,156,72,247,396,28
2020,940000302,24152,19302,3802,3802,15500,4850,3500,0,3500,0,1350,1350,0,0,0,0,0,0,6760,360,130,700,400,1341
2020,940000312,36133,14420,14420,14420,0,21713,20500,20500,0,0,1213,1100,113,0,0,0,0,0,5795,515,10,50,50,520
2020,940000332,3431,2131,1831,1831,300,1300,0,0,0,0,1300,1300,0,0,0,0,0,0,2010,300,10,200,100,23
2020,940000342,200,200,200,200,0,0,0,0,0,0,0,0,0,0,0,0,0,0,471,180,40,20,36,1
2020,940000352,18910,18810,10110,10110,8700,100,0,0,0,0,100,100,0,0,0,0,0,0,887,168,10,15,84,47
2020,940000372,63580,80,80,80,0,63500,62000,28000,34000,0,1500,1500,0,0,29400,22400,21000,0,3680,290,100,480,360,307
2020,940000392,98150,33650,33650,33650,0,64500,49000,8000,41000,0,15500,200,15300,0,0,0,0,0,3550,300,300,300,150,109
2020,940600201,122857,5178,5178,5178,0,117679,115000,90000,25000,0,2679,2519,160,0,8500,0,0,0,7252,360,251,612,179,860
2020,940600221,85066,23658,23658,23658,0,61408,60600,31000,29600,0,808,130,678,0,0,0,0,0,9702,280,7400,360,120,82
2020,940600261,81948,20272,20272,20272,0,61676,60500,44500,16000,0,1176,1080,96,0,28379,18379,18224,0,6386,405,140,900,336,901
2020,940600301,26810,310,310,310,0,26500,26000,8000,18000,0,500,500,0,0,12000,0,0,0,1985,200,350,380,125,98
2020,940600311,8040,40,40,40,0,8000,8000,8000,0,0,0,0,0,0,170,170,0,0,534,204,100,10,40,10
2020,940600321,26128,60,60,60,0,26068,26000,8000,18000,0,68,0,68,0,3500,1500,1500,0,1186,216,160,40,80,91
2020,940600331,14850,50,50,50,0,14800,14000,7000,7000,0,800,800,0,0,6000,0,0,0,546,90,48,60,48,31
2020,940600351,11759,1659,1659,1659,0,10100,10000,10000,0,0,100,100,0,0,8605,8605,7476,1000,1260,250,60,70,53,40
2020,940600361,115426,7026,7026,7026,0,108400,106000,10000,96000,0,2400,2400,0,0,7000,6000,6000,0,3370,210,150,300,290,296
2020,940700201,5929,135,135,135,0,5794,5500,5500,0,0,294,0,294,0,0,0,0,0,565,131,120,33,24,8
2020,940700211,100749,33984,33984,33984,0,66765,63000,53000,10000,0,3765,3490,275,0,13000,6000,6000,0,6317,300,1850,800,362,1192
2020,940700231,18652,4852,4852,4852,0,13800,13800,13800,0,0,0,0,0,0,300,0,0,0,993,78,60,36,36,37
2020,940700241,22229,2596,2596,2596,0,19633,18500,18500,0,0,1133,1100,33,0,0,0,0,0,3514,276,144,420,252,125
2020,940700261,39644,5054,5054,5054,0,34590,33000,28000,0,5000,1590,1440,150,0,21382,21382,21202,0,3499,264,150,353,245,281
2020,940700281,114493,48541,48541,48541,0,65952,59000,56000,3000,0,6952,6500,452,0,12250,12250,10000,2250,5107,312,93,362,252,679
2020,940700301,28294,10744,10744,10744,0,17550,16000,16000,0,0,1550,1550,0,0,3000,3000,2800,0,5278,282,330,450,360,567
2020,940700311,1400,1150,150,150,1000,250,0,0,0,0,250,250,0,0,1276,1276,0,1276,1875,650,180,240,120,26
2020,940700331,25780,16980,14980,14980,2000,8800,0,0,0,0,8800,2800,6000,0,4300,4300,0,2000,3720,900,240,360,240,996
2020,940700361,26636,14504,14504,14504,0,12132,11000,11000,0,0,1132,832,300,0,0,0,0,0,1260,170,10,200,80,253
2020,940700371,112992,24172,24172,24172,0,88820,86300,68000,14000,4300,2520,2200,320,0,14500,13500,13500,0,3286,342,440,240,163,536
2020,940700381,22506,400,400,400,0,22106,22000,4000,18000,0,106,0,106,0,0,0,0,0,727,136,60,10,55,13
2020,940700391,44250,4170,3970,970,200,40080,40000,0,40000,0,80,50,30,0,5700,4700,0,4700,1492,380,24,250,110,163
2020,940800221,590,590,290,290,300,0,0,0,0,0,0,0,0,0,0,0,0,0,2394,444,20,180,240,11
2020,940800231,2833,2800,400,400,2400,33,0,0,0,0,33,0,33,0,30,30,0,0,1279,126,245,152,67,101
2020,940800241,39655,2780,2780,2780,0,36875,36100,15500,20600,0,775,600,175,0,10070,70,0,0,2324,218,240,360,96,30
2020,940800251,36370,17945,17945,17945,0,18425,17000,9000,8000,0,1425,1280,145,0,20,20,0,0,2415,200,45,70,110,264
2020,940800281,11709,2709,2709,2709,0,9000,9000,9000,0,0,0,0,0,0,5000,0,0,0,2332,283,352,125,180,26
2020,940800291,6391,1172,1172,1172,0,5219,3000,0,3000,0,2219,1880,339,0,0,0,0,0,4200,540,360,420,240,167
2020,940800301,160080,8580,8580,8580,0,151500,150000,20000,130000,0,1500,400,1100,0,0,0,0,0,2022,599,36,280,149,126
2020,940800321,14850,1845,1845,845,0,13005,13000,13000,0,0,5,0,0,5,0,0,0,0,1370,300,250,200,300,62
2020,940800341,55820,2320,2320,2320,0,53500,49000,24000,25000,0,4500,4500,0,0,4050,4050,4050,0,4850,500,200,300,250,858
2020,940800381,27453,11903,11903,11903,0,15550,15000,15000,0,0,550,450,100,0,9500,9500,6500,3000,7020,250,100,250,120,197
2020,940900211,2020,2020,20,20,2000,0,0,0,0,0,0,0,0,0,140,140,0,140,1424,131,8,137,386,0
2020,940900221,32767,4653,4653,1653,0,28114,28000,28000,0,0,114,0,114,0,0,0,0,0,1417,181,331,61,53,20
2020,940900231,41192,996,996,996,0,40196,40000,0,40000,0,196,0,196,0,1000,0,0,0,1731,144,168,108,43,43
2020,940900241,3397,3397,97,97,3300,0,0,0,0,0,0,0,0,0,2000,2000,0,0,1273,360,278,52,74,1
2020,940900251,17771,2158,2158,2158,0,15613,15500,15500,0,0,113,80,33,0,2000,2000,2000,0,2175,177,300,180,168,58
2020,940900261,31605,105,105,75,0,31500,18400,11400,7000,0,13100,1100,0,12000,1000,1000,0,1000,3180,824,50,624,72,13
2020,940900271,21861,3948,3948,3948,0,17913,16000,16000,0,0,1913,1800,113,0,0,0,0,0,1868,200,540,120,55,51
2020,940900281,47963,28557,28557,28557,0,19406,18000,18000,0,0,1406,1080,326,0,0,0,0,0,3560,360,200,450,400,389
2020,940900291,197674,74,74,74,0,197600,196700,61000,135700,0,900,600,300,0,85155,49155,49155,0,3679,395,36,295,216,617
2020,940900301,5170,170,170,170,0,5000,5000,5000,0,0,0,0,0,0,0,0,0,0,785,100,350,20,60,10
2020,940900311,30184,1026,1026,1026,0,29158,29000,9000,20000,0,158,0,158,0,21000,13000,13000,0,1261,220,300,25,48,44
2020,940900331,34144,9944,9944,9944,0,24200,22000,22000,0,0,2200,2200,0,0,8272,8272,8272,0,4020,300,250,600,200,660
2020,940900351,5394,3794,294,294,3500,1600,0,0,0,0,1600,1600,0,0,0,0,0,0,2300,100,100,300,150,101
2020,940900371,17020,13320,3320,2320,10000,3700,0,0,0,0,3700,2700,1000,0,2700,2700,0,2700,2100,200,10,120,150,423
2020,940900381,100,100,100,100,0,0,0,0,0,0,0,0,0,0,0,0,0,0,250,50,30,10,20,1
2020,941000202,3256,3056,3006,3006,50,200,0,0,0,0,200,200,0,0,0,0,0,0,1459,252,12,151,121,66
2020,941000222,12846,1532,1532,1532,0,11314,11200,11200,0,0,114,0,114,0,5900,2100,2000,0,2370,260,180,360,365,27
2020,941000232,8620,8620,3620,3620,5000,0,0,0,0,0,0,0,0,0,0,0,0,0,1673,196,64,96,58,161
2020,941000242,21171,4571,4571,4571,0,16600,16600,8600,8000,0,0,0,0,0,0,0,0,0,1373,182,482,122,65,69
2020,941000262,44462,11832,11832,11832,0,32630,32000,32000,0,0,630,630,0,0,9668,9668,7668,2000,3256,216,242,356,178,263
2020,941000272,59507,56307,31307,30807,25000,3200,0,0,0,0,3200,2700,500,0,0,0,0,0,4218,718,108,583,176,464
2020,941000292,46725,16557,16557,16557,0,30168,29000,29000,0,0,1168,1090,78,0,0,0,0,0,2942,298,36,240,240,114
2020,941000302,6800,200,200,200,0,6600,6600,5000,1600,0,0,0,0,0,0,0,0,0,560,180,50,24,36,13
2020,941000352,5946,2646,2646,2646,0,3300,3300,3000,300,0,0,0,0,0,0,0,0,0,2347,240,150,120,108,118
2020,941000362,5500,5500,4000,4000,1500,0,0,0,0,0,0,0,0,0,0,0,0,0,767,192,40,24,60,6
2020,941000372,2000,2000,2000,2000,0,0,0,0,0,0,0,0,0,0,0,0,0,0,1270,118,600,60,12,1
2020,941000382,3900,200,200,200,0,3700,3700,3700,0,0,0,0,0,0,0,0,0,0,751,126,50,30,15,3
2020,941000392,5430,350,350,350,0,5080,5000,5000,0,0,80,70,10,0,5750,5750,2500,2500,1660,210,120,350,240,9
2020,941600211,901,716,216,216,500,185,0,0,0,0,185,10,175,0,0,0,0,0,1005,348,60,12,64,13
2020,941600221,39897,22948,14448,14448,8500,16949,14000,0,14000,0,2949,2900,49,0,4156,3156,3000,0,2996,361,254,408,188,84
2020,941600231,51461,3798,3798,3798,0,47663,17800,17800,0,0,29863,22700,163,7000,11200,11200,9000,2200,5880,185,202,387,420,264
2020,941600241,32730,7450,7450,7450,0,25280,23000,23000,0,0,2280,2000,280,0,14656,14656,13156,0,2627,365,61,242,182,395
2020,941600251,84161,28011,28011,17861,0,56150,29800,24000,5800,0,26350,2900,23450,0,13000,13000,8000,0,3508,245,123,242,186,405
2020,941600261,33334,3909,3909,3909,0,29425,28000,28000,0,0,1425,1380,45,0,5250,5250,5250,0,2826,240,120,144,396,101
2020,941600271,12569,49,49,49,0,12520,12420,7800,4620,0,100,100,0,0,0,0,0,0,1216,128,549,49,31,34
2020,941600291,2615,2290,490,490,1800,325,0,0,0,0,325,200,125,0,0,0,0,0,2370,200,10,420,300,29
2020,941600301,5350,1350,1350,1350,0,4000,4000,4000,0,0,0,0,0,0,0,0,0,0,519,106,33,25,70,6
2020,941600311,28918,3018,3018,3018,0,25900,24000,18000,6000,0,1900,1900,0,0,7025,7025,5025,2000,3248,552,30,372,264,1243
2020,941600321,71154,68050,49550,49550,18500,3104,0,0,0,0,3104,2200,904,0,0,0,0,0,2464,300,200,324,180,182
2020,941600331,12170,9970,2470,2470,7500,2200,0,0,0,0,2200,2200,0,0,5000,5000,5000,0,2860,320,200,350,120,36
2020,941600341,75699,46224,46224,46224,0,29475,28375,25000,3375,0,1100,600,500,0,8000,8000,8000,0,3220,300,300,230,180,1344
2020,941600351,29320,8102,8102,8102,0,21218,500,500,0,0,20718,1650,19068,0,14000,14000,14000,0,2920,240,200,200,170,62
2020,941600361,4212,4162,4162,4162,0,50,0,0,0,0,50,0,50,0,0,0,0,0,816,204,144,48,60,27
2020,941600381,44178,16500,16500,16500,0,27678,26000,26000,0,0,1678,1000,678,0,0,0,0,0,4200,400,60,360,180,631
2020,941600391,27824,5224,5224,5224,0,22600,22000,22000,0,0,600,600,0,0,14440,14440,8940,5500,3100,120,60,240,300,101
2020,941700201,301,301,58,58,243,0,0,0,0,0,0,0,0,0,419,419,0,0,545,50,5,20,60,0
2020,941700211,380,316,66,66,250,64,0,0,0,0,64,0,64,0,0,0,0,0,446,102,30,30,24,0
2020,941700281,63632,61549,40549,34349,21000,2083,0,0,0,0,2083,1610,473,0,0,0,0,0,4400,363,85,530,249,1832
2020,941700311,57940,12340,12340,12340,0,45600,40000,40000,0,0,5600,2600,3000,0,9500,9500,9500,0,6740,600,500,360,480,3394
2020,941700351,37630,12430,9630,9630,2800,25200,24700,0,22000,2700,500,500,0,0,13660,660,0,660,2052,80,20,360,96,173
2020,941700361,39510,1880,1880,1880,0,37630,33000,15000,18000,0,4630,4600,30,0,14500,9500,7000,2500,1628,96,120,420,72,46
2020,941700371,41992,2562,2562,2562,0,39430,38000,8000,30000,0,1430,800,630,0,0,0,0,0,902,140,96,120,96,24
2020,941700381,52214,15004,15004,15004,0,37210,33000,4000,29000,0,4210,410,3800,0,0,0,0,0,753,156,100,240,72,134
2020,941800201,35515,6295,6295,6195,0,29220,28000,28000,0,0,1220,1220,0,0,250,250,0,0,1044,224,100,120,110,62
2020,941800211,70860,11134,11134,11134,0,59726,58000,20000,38000,0,1726,1500,226,0,6058,5058,4900,0,2526,246,500,307,96,97
2020,941800241,13775,3425,3425,3425,0,10350,9000,9000,0,0,1350,1350,0,0,400,400,400,0,2544,160,200,530,276,536
2020,941800251,41162,39874,15874,15874,24000,1288,0,0,0,0,1288,1200,88,0,15000,15000,15000,0,3251,240,150,380,456,204
2020,941800271,34737,23261,4261,4261,19000,11476,0,0,0,0,11476,5250,226,6000,5000,5000,5000,0,3476,238,120,86,239,335
2020,941800291,37948,7768,7768,7768,0,30180,28000,28000,0,0,2180,2180,0,0,14344,14344,14344,0,4424,300,600,480,360,152
2020,941800301,35630,2330,2330,2330,0,33300,14000,14000,0,0,19300,1300,18000,0,17000,17000,1000,0,3780,270,100,1500,200,118
2020,941800311,1334,1260,1260,1260,0,74,0,0,0,0,74,50,24,0,0,0,0,0,869,0,20,360,24,7
2020,941800341,9000,900,900,900,0,8100,8000,8000,0,0,100,100,0,0,0,0,0,0,1499,113,20,250,54,34
2020,941800351,24155,975,975,975,0,23180,22540,8390,14150,0,640,300,340,0,0,0,0,0,1097,212,88,240,12,58
2020,941800361,614,544,544,544,0,70,0,0,0,0,70,0,70,0,0,0,0,0,796,200,30,84,36,1
2020,941800391,11845,11755,755,755,11000,90,0,0,0,0,90,0,90,0,10162,10162,6862,3300,2438,168,10,60,96,57
2020,941900211,35311,6224,6224,6224,0,29087,27000,27000,0,0,2087,1780,307,0,4050,4050,4000,0,8434,960,240,480,360,686
2020,941900241,7428,6128,128,128,6000,1300,0,0,0,0,1300,1300,0,0,0,0,0,0,2349,156,50,290,300,14
2020,941900251,415,415,315,315,100,0,0,0,0,0,0,0,0,0,662,662,0,662,840,390,5,30,40,0
2020,941900261,33011,8632,8632,8632,0,24379,11000,11000,0,0,13379,1150,229,12000,3080,3080,3000,0,1612,173,322,114,118,108
2020,941900271,60857,3272,3272,3272,0,57585,54000,18000,36000,0,3585,3500,85,0,20500,20500,20000,500,2860,315,54,362,158,72
2020,941900291,204,204,4,4,200,0,0,0,0,0,0,0,0,0,0,0,0,0,546,98,10,18,4,1
2020,941900301,19490,2440,2440,2440,0,17050,17000,5000,12000,0,50,0,50,0,0,0,0,0,1160,150,200,50,80,41
2020,941900311,300,300,300,300,0,0,0,0,0,0,0,0,0,0,0,0,0,0,865,120,58,30,17,1
2020,941900321,4069,2049,2049,2049,0,2020,2000,2000,0,0,20,0,20,0,1700,1700,600,1000,1353,142,490,60,108,3
2020,941900341,20700,550,550,550,0,20150,20000,20000,0,0,150,150,0,0,0,0,0,0,3120,300,120,120,240,84
2020,941900371,14295,495,495,495,0,13800,13000,13000,0,0,800,800,0,0,9100,9100,8000,0,2330,700,200,400,150,119
2020,941900391,3690,3250,850,850,2400,440,0,0,0,0,440,380,60,0,0,0,0,0,2003,240,40,230,240,25
2020,942000202,38140,3447,3447,3447,0,34693,34000,34000,0,0,693,580,113,0,4200,4200,4200,0,4464,360,100,360,258,77
2020,942000212,15104,49,49,49,0,15055,15000,15000,0,0,55,0,55,0,0,0,0,0,654,162,180,24,48,10
2020,942000222,20253,7818,7818,7818,0,12435,12000,12000,0,0,435,190,245,0,5700,5700,5700,0,591,156,61,84,48,36
2020,942000232,335,335,135,135,200,0,0,0,0,0,0,0,0,0,0,0,0,0,1660,370,20,50,160,0
2020,942000302,3902,3782,3682,3682,100,120,0,0,0,0,120,0,120,0,625,625,0,625,2289,672,10,10,17,35
2020,942000312,3090,550,50,50,500,2540,2540,0,2540,0,0,0,0,0,0,0,0,0,353,66,10,20,25,4
2020,942000322,13681,2100,2100,2100,0,11581,11151,6000,5151,0,430,430,0,0,0,0,0,0,1289,100,15,250,41,11
2020,942000332,4550,350,350,350,0,4200,4200,1700,2500,0,0,0,0,0,0,0,0,0,435,70,80,18,30,3
2020,942000342,34001,7671,7671,1171,0,26330,25000,25000,0,0,1330,1330,0,0,10000,10000,10000,0,5929,216,100,360,353,865
2020,942000382,37900,13200,13200,8200,0,24700,21000,21000,0,0,3700,700,0,3000,10000,10000,10000,0,2138,185,120,360,324,139
2020,942600211,29291,365,365,365,0,28926,28700,28700,0,0,226,0,226,0,0,0,0,0,376,128,37,24,26,34
2020,942600221,4298,4185,185,185,4000,113,0,0,0,0,113,0,113,0,0,0,0,0,825,240,50,60,60,20
2020,942600301,9190,5150,5150,5150,0,4040,4000,4000,0,0,40,0,40,0,0,0,0,0,870,110,120,140,90,32
2020,942600311,19620,5120,5120,5120,0,14500,14500,3000,11500,0,0,0,0,0,0,0,0,0,661,122,100,100,44,44
2020,942600321,50054,4000,4000,4000,0,46054,22210,7710,14500,0,23844,818,23026,0,11780,11780,11780,0,1876,340,100,190,96,145
2020,942600331,100,100,100,100,0,0,0,0,0,0,0,0,0,0,0,0,0,0,1739,60,5,90,60,22
2020,942600341,25850,6000,6000,6000,0,19850,19500,7500,12000,0,350,200,150,0,0,0,0,0,900,180,10,180,60,47
2020,942700221,67961,63304,27304,21304,36000,4657,0,0,0,0,4657,4200,457,0,0,0,0,0,4447,260,269,455,190,343
2020,942700301,41607,29013,29013,29013,0,12594,12190,7190,5000,0,404,404,0,0,0,0,0,0,1403,300,60,120,42,121
2020,942700311,9450,4950,4950,4950,0,4500,4000,4000,0,0,500,500,0,0,1610,1610,0,0,2295,180,50,700,160,27
2020,942700321,18490,4490,4490,4490,0,14000,14000,5000,9000,0,0,0,0,0,2100,2100,2100,0,1090,150,20,60,80,13
2020,942700341,6874,374,374,374,0,6500,6200,5000,1200,0,300,300,0,0,0,0,0,0,1500,180,60,180,240,146
2020,942700351,3180,350,350,350,0,2830,2550,2550,0,0,280,280,0,0,0,0,0,0,375,39,120,60,20,6
2020,942800201,4010,4010,4010,4010,0,0,0,0,0,0,0,0,0,0,0,0,0,0,950,228,210,36,38,1
2020,942800221,5640,5550,2550,2550,3000,90,0,0,0,0,90,0,90,0,0,0,0,0,1266,198,10,60,48,2
2020,942800331,14180,8130,8130,8130,0,6050,6050,4250,1800,0,0,0,0,0,0,0,0,0,481,110,29,10,40,19
2020,942800351,45344,10644,10644,10644,0,34700,33700,400,33300,0,1000,1000,0,0,0,0,0,0,1716,384,800,10,42,22
2020,942800361,45889,4589,4589,4589,0,41300,10800,0,10800,0,30500,0,30500,0,14000,14000,14000,0,971,97,200,60,70,7
2020,942800391,60978,6998,6998,6998,0,53980,53500,16000,37500,0,480,400,80,0,4000,0,0,0,1318,240,120,180,48,103
2020,942900201,215,215,15,15,200,0,0,0,0,0,0,0,0,0,100,100,0,0,478,84,5,72,14,0
2020,942900211,13150,3324,3324,3324,0,9826,9300,9300,0,0,526,260,266,0,721,721,721,0,2056,192,60,216,288,65
2020,942900221,46092,44610,33310,33310,11300,1482,0,0,0,0,1482,1053,429,0,15,15,0,0,2234,328,48,276,194,220
2020,942900231,29063,10083,10083,10083,0,18980,18800,15000,3800,0,180,180,0,0,6901,6901,5101,1800,3649,168,598,348,350,130
2020,942900241,37920,22750,22750,22750,0,15170,15000,15000,0,0,170,170,0,0,0,0,0,0,1806,156,120,240,120,156
2020,942900301,596,596,596,596,0,0,0,0,0,0,0,0,0,0,0,0,0,0,591,100,70,10,29,1
2020,942900321,23620,3120,3120,3120,0,20500,18700,500,18200,0,1800,700,1100,0,0,0,0,0,3292,2080,120,260,20,24
2020,942900331,17789,6789,789,789,6000,11000,0,0,0,0,11000,1000,10000,0,19650,19650,4800,0,2368,276,10,300,240,232
2020,942900361,2677,230,230,230,0,2447,2447,1847,600,0,0,0,0,0,0,0,0,0,686,120,120,10,5,2
2020,942900371,7910,2530,2530,2530,0,5380,4380,3000,1380,0,1000,1000,0,0,0,0,0,0,1895,132,510,240,72,44
2020,942900381,3885,3885,385,385,3500,0,0,0,0,0,0,0,0,0,2540,2540,2110,330,1276,120,36,120,140,8
2020,943000312,14075,9375,9375,9375,0,4700,2600,0,2600,0,2100,2100,0,0,0,0,0,0,1522,244,360,96,48,40
2020,950000202,10610,2410,2410,2310,0,8200,8000,8000,0,0,200,200,0,0,60,60,0,0,2730,240,200,340,120,298
2020,950000212,10494,2024,2024,2024,0,8470,8100,7300,800,0,370,0,370,0,0,0,0,0,688,156,60,24,36,10
2020,950000222,17220,15420,5420,5420,10000,1800,0,0,0,0,1800,1800,0,0,5000,5000,5000,0,1891,108,5,360,108,212
2020,950000242,3400,3400,400,400,3000,0,0,0,0,0,0,0,0,0,3000,3000,0,0,370,60,10,10,10,1
2020,950000252,450,450,250,250,200,0,0,0,0,0,0,0,0,0,0,0,0,0,706,249,120,0,12,1
2020,950000272,6015,15,15,15,0,6000,6000,6000,0,0,0,0,0,0,2000,2000,2000,0,1242,300,360,144,28,5
2020,950000292,6072,3070,3070,3070,0,3002,0,0,0,0,3002,3002,0,0,2000,2000,2000,0,3242,300,36,240,180,109
2020,950000302,13440,12640,7140,1040,5500,800,0,0,0,0,800,800,0,0,400,400,0,400,2432,360,12,240,300,38
2020,950000312,15800,1800,1800,1800,0,14000,14000,14000,0,0,0,0,0,0,0,0,0,0,540,180,26,12,24,25
2020,950000322,51122,14622,10622,10622,4000,36500,34000,0,34000,0,2500,2500,0,0,12500,2500,2500,0,2610,600,50,300,240,54
2020,950000332,4000,4000,500,500,3500,0,0,0,0,0,0,0,0,0,0,0,0,0,406,80,30,10,12,1
2020,950000352,23992,3992,3992,3992,0,20000,20000,20000,0,0,0,0,0,0,0,0,0,0,1444,147,60,84,60,23
2020,950000362,22880,5480,5480,5480,0,17400,17400,17400,0,0,0,0,0,0,10780,10780,10780,0,2210,270,20,150,180,22
2020,950000372,22018,2368,2368,2368,0,19650,17500,17500,0,0,2150,2150,0,0,15460,15460,12000,2000,4172,216,50,240,216,367
2020,950000382,128040,5640,5640,5640,0,122400,121000,51000,70000,0,1400,1400,0,0,11700,7200,7200,0,2932,372,120,500,240,261
2020,950600201,1850,1850,350,350,1500,0,0,0,0,0,0,0,0,0,200,200,0,200,1362,80,40,130,50,50
2020,950600211,885,285,45,45,240,600,0,0,0,0,600,600,0,0,683,683,0,0,1054,128,2,100,72,10
2020,950600221,552,552,14,14,538,0,0,0,0,0,0,0,0,0,0,0,0,0,505,132,70,12,15,1
2020,950600261,34785,3785,3785,3785,0,31000,31000,31000,0,0,0,0,0,0,0,0,0,0,2666,100,2240,60,84,22
2020,950600311,81530,38790,38790,38790,0,42740,31100,16000,7800,7300,11640,11300,340,0,3370,3370,0,0,6940,800,120,1000,600,1069
2020,950600321,26600,18600,18600,18600,0,8000,8000,8000,0,0,0,0,0,0,0,0,0,0,1995,187,1000,50,48,63
2020,950600331,20752,4752,4752,4752,0,16000,15000,8000,7000,0,1000,1000,0,0,1380,1380,0,0,1681,188,1,200,72,50
2020,950600361,12250,250,250,250,0,12000,12000,5000,7000,0,0,0,0,0,0,0,0,0,502,280,25,15,23,95
2020,950700211,65130,20130,20130,20130,0,45000,45000,45000,0,0,0,0,0,0,500,0,0,0,1100,200,80,40,40,154
2020,950700231,6895,2895,5,5,2890,4000,0,0,0,0,4000,4000,0,0,8390,8390,6790,0,2190,400,70,150,150,2231
2020,950700251,14003,1403,1403,1403,0,12600,12000,5000,7000,0,600,600,0,0,180,180,0,0,2876,240,180,300,216,75
2020,950700281,77097,9497,9497,9497,0,67600,65000,20000,45000,0,2600,1600,1000,0,30000,14000,10000,4000,5990,360,60,720,240,528
2020,950700291,12200,200,200,200,0,12000,12000,12000,0,0,0,0,0,0,0,0,0,0,1621,150,1200,36,15,12
2020,950700301,9637,297,297,297,0,9340,8000,8000,0,0,1340,640,700,0,4830,4830,4830,0,2944,300,24,240,240,13
2020,950700311,52380,8880,8880,8880,0,43500,43000,28000,15000,0,500,500,0,0,34300,20200,12200,8000,2787,180,100,160,147,710
2020,950700331,18066,4026,4026,4026,0,14040,14000,14000,0,0,40,40,0,0,3000,3000,3000,0,2016,264,50,360,254,43
2020,950700341,65114,2794,2794,2794,0,62320,57000,12000,45000,0,5320,5320,0,0,1400,1400,1400,0,2960,300,100,700,230,382
2020,950700361,19532,4280,4280,4280,0,15252,12000,12000,0,0,3252,2800,452,0,8810,8810,5510,3300,3410,350,50,500,190,116
2020,950700391,22120,1650,1650,1650,0,20470,20000,5000,15000,0,470,400,70,0,0,0,0,0,890,200,50,150,140,28
2020,950800221,251,251,1,1,250,0,0,0,0,0,0,0,0,0,2000,2000,0,1000,630,100,10,180,50,0
2020,950800241,60770,6170,6170,4670,0,54600,48500,23000,25500,0,6100,3000,3100,0,14789,7789,6789,1000,4056,180,800,500,360,239
2020,950800251,721,721,721,721,0,0,0,0,0,0,0,0,0,0,0,0,0,0,302,48,10,12,20,1
2020,950800261,58954,8854,8854,8854,0,50100,50000,50000,0,0,100,100,0,0,0,0,0,0,1750,330,10,275,115,75
2020,950800271,23300,300,300,300,0,23000,23000,23000,0,0,0,0,0,0,4032,4032,3532,0,237,152,1,36,24,29
2020,950800281,68778,35078,35078,35078,0,33700,33000,23000,10000,0,700,700,0,0,0,0,0,0,4520,250,700,240,120,145
2020,950800301,3124,3124,3124,3124,0,0,0,0,0,0,0,0,0,0,4600,4600,0,3000,1930,360,50,240,150,1
2020,950800311,15091,1746,1746,1746,0,13345,13000,13000,0,0,345,0,345,0,7000,7000,7000,0,1502,240,300,110,78,4
2020,950800331,18402,402,402,402,0,18000,16000,16000,0,0,2000,1900,100,0,5000,5000,5000,0,5717,425,20,280,252,55
2020,950800351,18140,1940,1940,1940,0,16200,14000,10000,4000,0,2200,2200,0,0,2936,2936,2936,0,1890,210,100,300,100,81
2020,950800381,18300,17300,3300,3300,14000,1000,0,0,0,0,1000,1000,0,0,0,0,0,0,2640,240,150,466,178,58
2020,950800391,104674,12082,12082,12082,0,92592,88600,35500,53100,0,3992,2800,1192,0,40600,20000,20000,0,8110,300,150,960,600,1369
2020,950900201,31180,6050,6050,6050,0,25130,25000,25000,0,0,130,130,0,0,50,50,0,0,1506,303,180,156,60,102
2020,950900231,29480,11180,11180,10980,0,18300,16000,16000,0,0,2300,2300,0,0,8800,8800,8800,0,4016,240,120,456,200,973
2020,950900271,36270,1270,1270,1270,0,35000,35000,35000,0,0,0,0,0,0,4500,4500,4500,0,1196,234,36,15,90,32
2020,950900281,11954,2954,2954,2954,0,9000,9000,9000,0,0,0,0,0,0,0,0,0,0,2075,180,5,70,180,205
2020,950900311,158530,47800,32800,32800,15000,110730,110600,0,110600,0,130,130,0,0,25000,0,0,0,3238,200,1500,500,96,320
2020,950900331,34378,5088,5088,5088,0,29290,28000,28000,0,0,1290,1100,190,0,9200,9200,9200,0,2313,221,70,420,127,452
2020,950900341,29142,9142,9142,9142,0,20000,20000,15000,5000,0,0,0,0,0,0,0,0,0,1020,180,100,150,40,16
2020,950900361,13936,6665,6665,6575,0,7271,7000,7000,0,0,271,0,271,0,0,0,0,0,2126,360,156,360,210,9
2020,950900371,52008,5248,5248,5248,0,46760,45000,45000,0,0,1760,1260,500,0,3000,3000,3000,0,5620,480,800,800,240,664
2020,950900381,15726,14526,2526,2526,12000,1200,0,0,0,0,1200,1200,0,0,7000,7000,0,7000,6200,500,100,500,350,148
2020,950900391,5992,722,722,722,0,5270,5000,5000,0,0,270,270,0,0,0,0,0,0,985,60,10,160,45,12
2020,951000202,24550,10400,10400,10400,0,14150,14000,14000,0,0,150,150,0,0,0,0,0,0,1138,72,150,96,60,108
2020,951000212,45800,4300,4300,4300,0,41500,40000,40000,0,0,1500,1500,0,0,3086,586,0,0,1866,240,360,180,72,75
2020,951000242,76567,8741,8741,7441,0,67826,65000,32000,33000,0,2826,600,2226,0,27800,27800,27800,0,3324,276,70,338,300,72
2020,951000252,14020,3020,3020,3020,0,11000,11000,11000,0,0,0,0,0,0,14600,14600,5800,8800,3960,360,84,360,276,146
2020,951000272,39680,3380,3380,3380,0,36300,35000,30000,5000,0,1300,1300,0,0,5000,5000,5000,0,2856,180,72,120,144,527
2020,951000282,41413,15250,15250,15250,0,26163,26000,0,26000,0,163,50,113,0,0,0,0,0,2666,300,150,240,96,42
2020,951000292,49150,3150,3150,3150,0,46000,46000,36000,10000,0,0,0,0,0,21386,21386,20886,0,8716,1000,400,600,216,608
2020,951000312,116608,4930,4930,4930,0,111678,111000,11000,100000,0,678,0,678,0,16000,13000,13000,0,2187,240,20,50,42,254
2020,951000322,3780,2480,1980,1980,500,1300,0,0,0,0,1300,1300,0,0,11000,11000,0,0,1600,250,150,180,200,56
2020,951000332,16230,3730,230,230,3500,12500,10000,0,10000,0,2500,2500,0,0,3708,3708,3708,0,1555,93,40,300,72,31
2020,951000342,33370,8370,8370,8370,0,25000,25000,3000,22000,0,0,0,0,0,0,0,0,0,1152,236,120,36,480,10
2020,951000352,29160,110,110,110,0,29050,29000,5000,24000,0,50,50,0,0,0,0,0,0,662,160,30,120,72,10
2020,951000362,64190,5340,5340,5040,0,58850,58000,7000,51000,0,850,0,850,0,0,0,0,0,1277,107,170,80,60,21
2020,951000372,18519,219,219,219,0,18300,13000,13000,0,0,5300,5300,0,0,13158,13158,8068,5000,7622,672,30,1140,240,1038
2020,951000382,16090,4090,4090,4090,0,12000,12000,12000,0,0,0,0,0,0,0,0,0,0,1110,240,10,60,60,8
2020,951000392,30450,8200,3200,3200,5000,22250,10250,0,10000,250,12000,2000,10000,0,200,0,0,0,2010,360,240,480,180,151
2020,951600201,21846,5346,5346,5346,0,16500,15000,15000,0,0,1500,1500,0,0,200,0,0,0,4550,480,200,650,300,203
2020,951600211,16630,13130,3130,3130,10000,3500,0,0,0,0,3500,3500,0,0,8619,8619,7700,0,2372,300,240,240,180,81
2020,951600241,19600,1100,1100,1100,0,18500,18000,18000,0,0,500,500,0,0,5640,5640,5640,0,2022,240,10,48,24,180
2020,951600261,18750,3350,3350,2350,0,15400,12000,12000,0,0,3400,3400,0,0,15456,15456,8000,5000,3130,360,120,360,180,1162
2020,951600271,36233,1962,1962,1962,0,34271,30000,30000,0,0,4271,1271,3000,0,23880,23880,23880,0,6280,1080,50,600,240,460
2020,951600291,403,403,3,3,400,0,0,0,0,0,0,0,0,0,0,0,0,0,708,156,84,60,30,1
2020,951600311,123198,43098,43098,38098,0,80100,52200,20000,29200,3000,27900,4100,23800,0,0,0,0,0,5240,640,200,840,280,1215
2020,951600361,62391,16191,16191,16191,0,46200,45000,18500,26500,0,1200,1200,0,0,6200,6200,5700,500,3750,300,100,450,200,1517
2020,951600371,21200,2200,2200,2200,0,19000,19000,19000,0,0,0,0,0,0,0,0,0,0,1990,350,300,100,120,72
2020,951600381,6860,160,160,160,0,6700,6600,6600,0,0,100,100,0,0,1965,1965,1000,965,2340,1200,250,200,60,47
2020,951600391,4671,3721,1721,1721,2000,950,0,0,0,0,950,950,0,0,1400,1400,400,500,2260,220,70,170,110,107
2020,951700261,195,195,195,195,0,0,0,0,0,0,0,0,0,0,0,0,0,0,2122,480,5,276,192,0
2020,951700271,4536,4536,2536,2536,2000,0,0,0,0,0,0,0,0,0,1600,1600,1600,0,1412,276,36,72,96,1
2020,951700281,70730,13180,13180,13180,0,57550,56000,33000,23000,0,1550,1550,0,0,15040,40,0,0,7280,1000,120,500,480,1124
2020,951700291,32640,2620,2620,2620,0,30020,30000,0,30000,0,20,20,0,0,19000,17000,17000,0,4020,300,400,240,180,96
2020,951700301,26212,10112,10112,10112,0,16100,15000,13000,2000,0,1100,100,1000,0,1895,1895,1480,0,2212,240,240,200,152,36
2020,951700311,6740,5640,5440,5440,200,1100,0,0,0,0,1100,1100,0,0,700,700,0,0,2800,420,20,600,120,202
2020,951700321,220,220,20,20,200,0,0,0,0,0,0,0,0,0,0,0,0,0,649,144,15,252,18,0
2020,951700351,23966,1166,1166,1166,0,22800,21000,21000,0,0,1800,1500,300,0,0,0,0,0,2076,204,30,60,240,94
2020,951700361,2476,2026,2026,2026,0,450,0,0,0,0,450,450,0,0,740,740,0,740,1902,144,120,180,156,16
2020,951700371,33892,15692,15692,15692,0,18200,18200,17000,1200,0,0,0,0,0,0,0,0,0,1180,180,360,60,40,63
2020,951700381,39912,5612,5612,5612,0,34300,32000,20000,12000,0,2300,2300,0,0,200,200,0,200,5960,360,1000,360,240,1217
2020,951700391,7982,1432,1432,1432,0,6550,6000,3000,3000,0,550,550,0,0,700,700,0,700,2020,120,150,300,60,43
2020,951800201,25192,9812,9812,9812,0,15380,15000,15000,0,0,380,200,180,0,0,0,0,0,4012,312,300,420,300,389
2020,951800221,67950,9700,9700,9700,0,58250,58000,30000,28000,0,250,250,0,0,8400,7900,0,7900,950,230,30,120,60,96
2020,951800241,30670,29670,4670,4670,25000,1000,0,0,0,0,1000,900,100,0,15400,15400,15000,0,1704,360,10,300,144,96
2020,951800281,33440,27640,4640,4640,23000,5800,0,0,0,0,5800,4800,1000,0,0,0,0,0,4903,240,100,130,240,240
2020,951800291,25208,4208,4208,4208,0,21000,20000,20000,0,0,1000,1000,0,0,5300,5300,5300,0,4500,600,50,300,150,399
2020,951800301,29318,6538,6538,6538,0,22780,21300,6500,14800,0,1480,980,500,0,0,0,0,0,1510,150,70,160,80,59
2020,951800311,1116,916,416,416,500,200,0,0,0,0,200,200,0,0,1200,1200,0,1200,1040,100,10,120,130,12
2020,951800321,550,550,50,50,500,0,0,0,0,0,0,0,0,0,0,0,0,0,920,180,80,120,80,182
2020,951800331,1500,1500,500,500,1000,0,0,0,0,0,0,0,0,0,0,0,0,0,618,84,20,30,24,5
2020,951800341,325060,36560,36560,31560,0,288500,249500,49500,200000,0,39000,7600,31400,0,73100,68100,68100,0,8650,720,120,720,360,6205
2020,951800351,1216,1216,16,16,1200,0,0,0,0,0,0,0,0,0,50,50,0,50,942,240,60,10,72,1
2020,951800361,6100,100,100,100,0,6000,6000,6000,0,0,0,0,0,0,0,0,0,0,665,300,30,10,20,2
2020,951800371,11028,728,728,728,0,10300,4500,4500,0,0,5800,800,0,5000,7270,7270,1400,5870,2316,360,180,500,96,29
2020,951800381,5000,5000,2000,2000,3000,0,0,0,0,0,0,0,0,0,0,0,0,0,600,150,30,10,40,3
2020,951800391,238,238,40,40,198,0,0,0,0,0,0,0,0,0,0,0,0,0,1360,300,24,360,96,0
2020,951900201,11042,5642,1642,1642,4000,5400,4500,0,4500,0,900,900,0,0,0,0,0,0,980,150,40,250,40,40
2020,951900221,27688,2988,2988,2988,0,24700,21000,21000,0,0,3700,3300,400,0,6000,6000,6000,0,4362,480,24,600,240,316
2020,951900241,52720,11220,5720,5720,5500,41500,40000,0,40000,0,1500,1500,0,0,13000,0,0,0,2370,300,50,300,120,106
2020,951900271,15500,500,500,500,0,15000,15000,15000,0,0,0,0,0,0,0,0,0,0,3452,2100,400,120,72,21
2020,951900281,12030,3030,30,30,3000,9000,9000,0,9000,0,0,0,0,0,15884,9884,7960,1924,4387,840,240,216,240,171
2020,951900291,39867,10267,10267,10267,0,29600,20000,20000,0,0,9600,600,0,9000,0,0,0,0,2538,300,44,450,48,24
2020,951900301,750,200,200,200,0,550,500,500,0,0,50,0,50,0,0,0,0,0,773,120,30,30,18,1
2020,951900311,50500,5500,5500,5500,0,45000,45000,5000,40000,0,0,0,0,0,0,0,0,0,835,150,300,50,20,11
2020,951900321,106300,29400,29400,28900,0,76900,55000,10000,45000,0,21900,1900,20000,0,4292,4292,4292,0,4340,600,450,400,400,161
2020,951900331,25789,7069,2069,2069,5000,18720,18000,0,18000,0,720,720,0,0,0,0,0,0,2510,180,100,210,180,225
2020,951900361,31820,8420,8420,8420,0,23400,21000,0,21000,0,2400,1400,1000,0,6400,6400,6400,0,1730,240,40,120,120,94
2020,951900391,29838,5988,5988,5988,0,23850,23500,3500,20000,0,350,350,0,0,0,0,0,0,1847,392,100,300,180,37
2020,952000202,79610,2110,2110,2110,0,77500,75000,75000,0,0,2500,2500,0,0,10000,10000,10000,0,4480,500,100,360,420,158
2020,952000222,107414,16014,16014,14514,0,91400,90000,80000,10000,0,1400,1400,0,0,29400,28900,24950,3800,4262,336,60,360,156,794
2020,952000252,230,230,30,30,200,0,0,0,0,0,0,0,0,0,0,0,0,0,1106,420,10,36,60,39
2020,952000262,48300,44300,16300,16300,28000,4000,0,0,0,0,4000,4000,0,0,15000,15000,0,15000,5550,360,10,400,180,741
2020,952000282,55140,10140,10140,10140,0,45000,45000,45000,0,0,0,0,0,0,300,300,0,0,3490,360,50,120,100,60
2020,952000292,45935,1300,1300,1300,0,44635,41000,41000,0,0,3635,3635,0,0,17700,17700,15100,800,3242,276,70,96,108,231
2020,952000302,7200,4700,700,700,4000,2500,0,0,0,0,2500,2500,0,0,2200,2200,2200,0,2399,540,5,132,300,100
2020,952000312,11540,1040,1040,1040,0,10500,10000,10000,0,0,500,400,100,0,1008,1008,0,0,2144,360,200,360,144,154
2020,952000332,20138,8882,8882,8882,0,11256,11000,3000,8000,0,256,0,256,0,0,0,0,0,1700,110,1000,12,48,27
2020,952000342,18570,4790,4790,4790,0,13780,12000,12000,0,0,1780,1540,240,0,9300,9300,8300,1000,1300,168,20,120,160,45
2020,952000352,15580,3480,3480,3480,0,12100,12000,12000,0,0,100,0,100,0,0,0,0,0,1384,156,20,70,98,15
2020,952000362,40620,1120,1120,1120,0,39500,36000,1000,35000,0,3500,1500,2000,0,16500,16500,16500,0,2530,360,100,600,120,102
2020,952000372,12075,4545,4545,4545,0,7530,4200,2000,2200,0,3330,3300,30,0,1400,1400,0,0,1980,300,200,180,80,27
2020,952000382,30500,150,150,150,0,30350,29000,14000,15000,0,1350,100,1250,0,4000,4000,4000,0,1084,120,50,120,48,38
2020,952600211,233130,59880,59880,57480,0,173250,171950,50000,120000,1950,1300,800,500,0,52546,5746,5700,46,8759,1052,592,313,180,2261
2020,952600251,18410,5910,5910,5910,0,12500,11000,11000,0,0,1500,1500,0,0,535,535,285,0,2770,240,150,120,180,167
2020,952600261,17848,9048,9048,9048,0,8800,7000,7000,0,0,1800,1800,0,0,2000,2000,2000,0,1823,143,260,240,120,88
2020,952600291,37540,13140,8140,5140,5000,24400,24000,0,24000,0,400,400,0,0,9020,6020,6000,0,1980,90,40,360,120,238
2020,952600311,35378,7228,7228,5228,0,28150,27000,27000,0,0,1150,0,1150,0,15180,15180,14000,1000,3400,245,80,180,360,45
2020,952600321,18442,1842,1842,1842,0,16600,12000,12000,0,0,4600,4600,0,0,9970,9970,9970,0,2570,250,180,400,240,29
2020,952600341,12090,3990,3990,3990,0,8100,5000,5000,0,0,3100,3100,0,0,1323,1323,363,0,3270,230,45,510,345,145
2020,952600351,26310,4120,4120,4120,0,22190,11800,6000,5800,0,10390,390,0,10000,0,0,0,0,2360,180,260,240,250,10
2020,952600361,3450,450,450,450,0,3000,3000,3000,0,0,0,0,0,0,0,0,0,0,405,100,100,30,20,4
2020,952700241,69530,13530,13530,13530,0,56000,52000,30000,22000,0,4000,4000,0,0,16780,4280,4280,0,4380,420,240,480,240,198
2020,952700251,35216,33264,10264,10264,23000,1952,0,0,0,0,1952,1952,0,0,0,0,0,0,3730,400,250,360,180,731
2020,952700261,56057,12457,12457,10457,0,43600,39300,39300,0,0,4300,1800,0,2500,14100,14100,12400,500,4618,210,18,540,420,334
2020,952700281,14480,2480,2480,2480,0,12000,12000,12000,0,0,0,0,0,0,0,0,0,0,1924,360,600,36,48,13
2020,952700301,72374,9924,9924,9924,0,62450,52500,2500,50000,0,9950,4100,5850,0,11900,11900,11500,0,2370,250,300,300,250,149
2020,952700311,1906,1506,1506,1506,0,400,0,0,0,0,400,100,300,0,0,0,0,0,530,35,50,55,36,6
2020,952700321,17770,100,100,100,0,17670,16800,5000,11800,0,870,870,0,0,0,0,0,0,1626,436,100,240,40,33
2020,952700341,1650,1600,1600,1600,0,50,0,0,0,0,50,0,50,0,0,0,0,0,510,120,30,50,60,13
2020,952700361,10850,50,50,50,0,10800,10800,800,10000,0,0,0,0,0,0,0,0,0,427,96,40,36,32,9
2020,952700371,27256,5556,5556,5556,0,21700,18000,8000,10000,0,3700,2300,1400,0,3855,3855,1800,0,4572,78,3440,240,364,12
2020,952800201,39600,3400,3400,3400,0,36200,23000,23000,0,0,13200,13200,0,0,6000,6000,0,0,1571,240,5,180,96,198
2020,952800221,17040,15640,640,640,15000,1400,0,0,0,0,1400,1400,0,0,8050,8050,8000,0,1590,240,50,120,120,91
2020,952800231,123000,52000,52000,35000,0,71000,70000,40000,30000,0,1000,1000,0,0,9433,9433,0,9433,5410,540,80,750,190,3911
2020,952800241,82700,3500,3500,3500,0,79200,75000,45000,30000,0,4200,4200,0,0,10800,9300,0,7000,5150,400,90,700,420,190
2020,952800251,84630,8430,8430,8430,0,76200,75000,75000,0,0,1200,1200,0,0,20300,20300,18500,1800,1233,550,53,175,55,67
2020,952800261,76660,14460,14460,14460,0,62200,60000,60000,0,0,2200,2200,0,0,2100,2100,0,2100,5960,360,1000,300,100,1506
2020,952800291,61400,3710,3710,2710,0,57690,56000,26000,30000,0,1690,900,790,0,20000,20000,20000,0,2740,400,400,480,130,125
2020,952800301,38120,10970,10970,10970,0,27150,25000,15000,10000,0,2150,2150,0,0,13900,6400,6400,0,2520,240,60,320,220,460
2020,952800311,4200,600,600,600,0,3600,3000,3000,0,0,600,0,600,0,0,0,0,0,515,120,20,50,50,3
2020,952800321,62885,13285,13285,12285,0,49600,37000,14000,23000,0,12600,2600,10000,0,34600,34600,3000,29400,2835,190,300,280,500,217
2020,952800331,3544,544,544,544,0,3000,3000,3000,0,0,0,0,0,0,0,0,0,0,506,150,120,20,36,4
2020,952800341,64180,51500,51500,51500,0,12680,12500,11000,1500,0,180,180,0,0,0,0,0,0,576,150,60,36,40,148
2020,952800351,30188,758,758,758,0,29430,29430,930,28500,0,0,0,0,0,0,0,0,0,1202,175,630,60,62,12
2020,952800361,12015,15,15,15,0,12000,12000,12000,0,0,0,0,0,0,0,0,0,0,470,84,60,60,36,4
2020,952900201,152406,24026,24026,24026,0,128380,128000,63000,65000,0,380,380,0,0,40200,27200,27200,0,4290,300,80,190,300,1031
2020,952900261,22004,7004,7004,5004,0,15000,11000,11000,0,0,4000,4000,0,0,3000,3000,0,3000,2250,220,50,240,260,39
2020,952900271,11748,11748,8448,8448,3300,0,0,0,0,0,0,0,0,0,0,0,0,0,817,192,39,10,54,66
2020,952900291,103739,23239,23239,23239,0,80500,75000,75000,0,0,5500,3500,2000,0,2100,2100,0,0,6010,400,300,500,150,788
2020,952900301,7205,5,5,5,0,7200,7200,3000,4200,0,0,0,0,0,0,0,0,0,462,110,12,36,24,2
2020,952900321,3000,670,370,370,300,2330,1000,0,1000,0,1330,1330,0,0,328,328,0,0,2284,516,2,720,96,6
2020,952900331,808,808,808,808,0,0,0,0,0,0,0,0,0,0,0,0,0,0,765,308,0,10,17,0
2020,952900341,6680,180,180,180,0,6500,5000,5000,0,0,1500,1500,0,0,4840,4840,3200,840,812,72,48,94,48,87
2020,952900351,51330,850,850,850,0,50480,50000,20000,30000,0,480,380,100,0,0,0,0,0,1350,200,300,150,60,34
2020,952900361,550,550,550,550,0,0,0,0,0,0,0,0,0,0,0,0,0,0,310,90,50,20,20,2
2020,953600201,20972,1722,1722,1722,0,19250,19000,19000,0,0,250,250,0,0,0,0,0,0,766,195,90,70,84,31
2020,953900211,33630,2280,2280,2280,0,31350,31000,31000,0,0,350,350,0,0,12000,12000,11000,1000,3120,370,20,350,180,621
2020,960000202,6140,5240,240,240,5000,900,0,0,0,0,900,900,0,0,4750,4750,4750,0,1260,350,100,150,50,17
2020,960000212,13128,12188,2288,2288,9900,940,0,0,0,0,940,940,0,0,5500,5500,5500,0,2050,450,100,400,100,58
2020,960000222,45614,8864,8864,8864,0,36750,36000,36000,0,0,750,550,200,0,7000,7000,7000,0,3500,240,120,360,120,119
2020,960000232,80670,14280,14280,14280,0,66390,61000,37000,24000,0,5390,4560,830,0,200,0,0,0,2456,276,180,120,120,1546
2020,960000242,50670,35170,31670,31670,3500,15500,15000,0,15000,0,500,500,0,0,9000,9000,0,9000,1359,132,67,120,60,1620
2020,960000252,169740,6300,6300,6300,0,163440,160000,80000,80000,0,3440,3440,0,0,60900,60000,60000,0,6030,60,200,700,300,2509
2020,960000262,53360,1900,1900,1900,0,51460,50000,50000,0,0,1460,1000,460,0,10000,10000,10000,0,2350,300,50,100,100,792
2020,960000272,46410,3660,3660,2940,0,42750,41000,41000,0,0,1750,1750,0,0,23250,23250,8250,15000,13320,480,600,1200,360,1270
2020,960000312,7106,106,106,106,0,7000,5000,5000,0,0,2000,2000,0,0,0,0,0,0,1524,480,120,84,120,28
2020,960000352,21640,140,140,140,0,21500,21500,15900,0,5600,0,0,0,0,100,0,0,0,688,60,120,12,24,11
2020,960000362,37892,13492,13492,10492,0,24400,22000,11000,11000,0,2400,2400,0,0,5415,5415,5415,0,4960,192,200,460,168,281
2020,960000372,43700,12660,12660,12360,0,31040,27000,27000,0,0,4040,4040,0,0,0,0,0,0,6094,344,50,300,240,222
2020,960000392,24800,3200,3200,3200,0,21600,11500,10000,1500,0,10100,0,10100,0,1000,1000,0,1000,2985,204,1608,120,132,16
2020,960600211,113364,36164,36164,36164,0,77200,73000,36000,37000,0,4200,3700,500,0,0,0,0,0,2030,240,100,200,100,411
2020,960600241,29040,8670,8670,8670,0,20370,20000,20000,0,0,370,270,100,0,600,0,0,0,2058,300,700,60,48,33
2020,960600261,30070,70,70,70,0,30000,30000,30000,0,0,0,0,0,0,10000,10000,10000,0,1564,300,600,80,24,32
2020,960600271,41742,11682,11682,11682,0,30060,30000,30000,0,0,60,0,60,0,7000,7000,7000,0,1420,360,120,50,120,73
2020,960600301,650,650,650,650,0,0,0,0,0,0,0,0,0,0,0,0,0,0,605,120,300,10,5,1
2020,960600351,42500,18780,18780,18780,0,23720,23000,10000,13000,0,720,700,20,0,500,500,500,0,1831,132,170,300,160,111
2020,960600361,9800,800,800,800,0,9000,9000,9000,0,0,0,0,0,0,0,0,0,0,534,72,12,12,36,12
2020,960600381,13656,3486,3486,3486,0,10170,10000,10000,0,0,170,170,0,0,2338,2338,2000,338,2848,208,50,360,240,197
2020,960600391,43495,5185,5185,5185,0,38310,32000,32000,0,0,6310,6100,210,0,24965,24965,19270,800,3638,288,35,650,240,67
2020,960700221,17020,20,20,20,0,17000,17000,17000,0,0,0,0,0,0,400,0,0,0,960,120,600,50,20,13
2020,960700231,88468,10160,10160,10160,0,78308,75000,50000,25000,0,3308,2600,708,0,29000,29000,25000,4000,5390,600,300,400,250,1109
2020,960700241,59480,21060,21060,21060,0,38420,35000,35000,0,0,3420,3300,120,0,7190,1190,0,0,3410,360,30,500,450,968
2020,960700251,3938,3438,2438,2438,1000,500,0,0,0,0,500,500,0,0,0,0,0,0,2830,500,20,120,240,17
2020,960700271,37256,11856,11856,11656,0,25400,25000,25000,0,0,400,400,0,0,0,0,0,0,3104,360,100,240,144,232
2020,960700281,32950,8000,8000,8000,0,24950,22000,22000,0,0,2950,2700,250,0,3800,3800,3800,0,2620,120,100,360,80,1161
2020,960700291,39058,4958,4958,4958,0,34100,33000,24000,9000,0,1100,1100,0,0,6590,5590,5000,0,4064,720,278,210,120,165
2020,960700321,10204,8704,7704,5204,1000,1500,0,0,0,0,1500,500,1000,0,7500,7500,2000,3000,2150,260,10,360,192,21
2020,960700331,16006,16006,11006,11006,5000,0,0,0,0,0,0,0,0,0,1656,1656,0,1656,3800,240,120,1260,600,141
2020,960700341,2110,2110,110,110,2000,0,0,0,0,0,0,0,0,0,0,0,0,0,566,64,152,24,36,1
2020,960700351,10900,100,100,100,0,10800,10800,9800,1000,0,0,0,0,0,0,0,0,0,890,180,60,40,30,27
2020,960700361,49060,6880,6880,6880,0,42180,41180,25400,15780,0,1000,1000,0,0,0,0,0,0,1123,138,70,120,112,292
2020,960700381,25412,4162,4162,4162,0,21250,18000,9000,9000,0,3250,2950,300,0,3000,2000,2000,0,6370,240,1200,960,300,447
2020,960700391,9015,15,15,15,0,9000,9000,9000,0,0,0,0,0,0,4260,4260,4260,0,560,144,120,6,30,10
2020,960800221,217382,82082,82082,82082,0,135300,130000,75000,55000,0,5300,5000,300,0,4000,0,0,0,4348,312,600,240,96,13934
2020,960800241,105220,1700,1700,1700,0,103520,103000,45000,58000,0,520,0,520,0,26730,12730,12600,0,2514,264,360,100,200,268
2020,960800281,125275,11475,11475,11475,0,113800,110000,30000,80000,0,3800,3800,0,0,16720,16520,16520,0,2081,236,15,360,240,1914
2020,960800291,104000,23700,23700,23700,0,80300,80000,30000,50000,0,300,200,100,0,500,0,0,0,1012,200,120,200,72,431
2020,960800301,21035,2885,2885,2885,0,18150,7800,7800,0,0,10350,350,0,10000,0,0,0,0,1167,113,20,540,234,12
2020,960800311,8080,80,80,80,0,8000,8000,8000,0,0,0,0,0,0,0,0,0,0,564,120,150,10,36,26
2020,960800321,26400,8400,8400,900,0,18000,18000,18000,0,0,0,0,0,0,300,300,0,0,2760,180,15,60,240,18
2020,960800361,8450,2650,2650,2650,0,5800,5600,2000,3600,0,200,0,200,0,0,0,0,0,1326,88,440,120,48,11
2020,960800371,81332,19232,19232,19232,0,62100,57000,55000,2000,0,5100,4200,900,0,13100,12600,12600,0,2138,380,60,480,120,121
2020,960800381,12020,20,20,20,0,12000,12000,12000,0,0,0,0,0,0,3580,1580,1580,0,1288,216,80,84,48,11
2020,960800391,77362,16910,16910,16910,0,60452,56000,36000,20000,0,4452,4000,452,0,0,0,0,0,4556,300,100,1074,144,2158
2020,960900201,21400,1400,1400,1400,0,20000,20000,20000,0,0,0,0,0,0,1200,0,0,0,935,202,227,24,42,20
2020,960900211,54450,4000,4000,4000,0,50450,50000,50000,0,0,450,350,100,0,18000,10000,10000,0,1066,240,50,150,96,117
2020,960900221,16380,8880,8880,8880,0,7500,0,0,0,0,7500,6500,1000,0,0,0,0,0,2250,225,25,460,200,163
2020,960900241,27552,6952,6952,6952,0,20600,20000,20000,0,0,600,600,0,0,1700,1700,1500,0,2120,300,300,360,180,131
2020,960900251,26156,3856,3856,3856,0,22300,20000,20000,0,0,2300,2300,0,0,0,0,0,0,2960,240,700,240,180,221
2020,960900261,1035,1035,5,5,1030,0,0,0,0,0,0,0,0,0,0,0,0,0,979,240,60,38,45,9
2020,960900271,43312,4962,4962,4662,0,38350,36000,26000,0,10000,2350,2350,0,0,21555,21555,11489,10000,3310,250,250,200,120,552
2020,960900291,90377,5032,5032,5032,0,85345,85000,85000,0,0,345,0,345,0,11000,11000,11000,0,2275,740,330,20,60,156
2020,960900311,7500,0,0,0,0,7500,7000,0,0,7000,500,500,0,0,300,300,0,300,1170,150,100,150,70,16
2020,960900331,21725,3225,3225,3225,0,18500,18500,17000,1500,0,0,0,0,0,50,50,0,0,1930,256,500,120,96,19
2020,960900351,183248,15428,15428,15428,0,167820,167000,30000,137000,0,820,400,420,0,0,0,0,0,1721,216,120,144,120,156
2020,960900361,46805,12955,12955,12955,0,33850,30000,30000,0,0,3850,3650,200,0,5747,5747,5497,200,4896,420,300,580,336,439
2020,960900391,1608,1608,1608,1608,0,0,0,0,0,0,0,0,0,0,0,0,0,0,990,150,30,100,65,1
2020,961000202,47998,15048,15048,15048,0,32950,30000,30000,0,0,2950,1950,1000,0,6400,6400,6400,0,4572,300,240,360,360,1075
2020,961000212,33004,4884,4884,4884,0,28120,27000,27000,0,0,1120,1000,120,0,400,400,0,0,2890,150,120,150,150,1069
2020,961000222,4320,1320,1320,1320,0,3000,3000,3000,0,0,0,0,0,0,0,0,0,0,620,160,150,10,30,6
2020,961000232,12060,3060,3060,3060,0,9000,9000,9000,0,0,0,0,0,0,0,0,0,0,2070,120,470,10,170,19
2020,961000252,19394,10194,10194,10194,0,9200,7000,7000,0,0,2200,2000,200,0,5000,5000,4000,1000,2125,210,40,550,280,99
2020,961000282,19480,5330,5330,5330,0,14150,14000,10000,4000,0,150,150,0,0,0,0,0,0,1320,180,60,240,120,494
2020,961000302,2886,1636,1336,1336,300,1250,0,0,0,0,1250,1250,0,0,0,0,0,0,1228,72,80,340,96,97
2020,961000312,8293,1268,1268,1268,0,7025,7000,7000,0,0,25,0,25,0,3500,3500,3000,0,1597,240,300,120,110,9
2020,961000322,5,5,5,5,0,0,0,0,0,0,0,0,0,0,10500,10500,0,6500,553,120,20,10,40,1
2020,961000332,16967,14180,1680,1680,12500,2787,0,0,0,0,2787,2090,697,0,0,0,0,0,2292,216,48,360,168,435
2020,961000342,49513,30835,15885,15885,14950,18678,17000,0,17000,0,1678,1000,678,0,7700,200,0,0,5680,240,800,420,420,133
2020,961000352,22482,569,569,569,0,21913,21000,6000,15000,0,913,500,113,300,500,0,0,0,2766,192,120,910,176,31
2020,961000362,7880,1750,1750,1750,0,6130,6000,6000,0,0,130,0,130,0,0,0,0,0,689,96,120,60,15,6
2020,961000372,19993,9348,9348,9348,0,10645,10500,6500,4000,0,145,0,145,0,0,0,0,0,631,96,50,11,24,6
2020,961000382,78,78,78,78,0,0,0,0,0,0,0,0,0,0,0,0,0,0,640,130,260,30,40,1
2020,961000392,12785,10035,10035,10035,0,2750,2750,2750,0,0,0,0,0,0,0,0,0,0,495,180,60,30,24,4
2020,961600221,14992,5092,5092,5092,0,9900,9000,9000,0,0,900,800,100,0,2892,2892,1892,1000,3840,240,100,240,360,65
2020,961600231,16754,12554,4554,3054,8000,4200,0,0,0,0,4200,2700,500,1000,10240,10240,2840,7400,2376,360,60,300,360,26
2020,961600241,64506,21706,21706,21706,0,42800,40000,40000,0,0,2800,0,2800,0,0,0,0,0,2985,300,55,100,230,1066
2020,961600261,46798,298,298,298,0,46500,45500,30000,15500,0,1000,1000,0,0,0,0,0,0,1641,250,168,195,98,120
2020,961600271,12010,5590,590,590,5000,6420,500,0,500,0,5920,120,4500,1300,7250,7250,0,3000,2824,156,1000,480,108,33
2020,961600301,67063,13805,13805,13805,0,53258,50000,32000,18000,0,3258,3100,158,0,0,0,0,0,4644,1444,23,360,216,741
2020,961600321,55245,10719,10719,10719,0,44526,25000,25000,0,0,19526,16300,226,3000,8658,8658,5628,0,3386,312,200,300,360,491
2020,961600331,61801,1,1,1,0,61800,60000,60000,0,0,1800,1800,0,0,32708,24708,23500,0,1762,330,10,360,70,116
2020,961600341,47777,29090,29090,29090,0,18687,15000,15000,0,0,3687,2700,987,0,2650,2650,2650,0,2072,240,20,480,240,76
2020,961600361,3378,378,378,378,0,3000,3000,0,3000,0,0,0,0,0,0,0,0,0,436,60,96,48,16,3
2020,961600371,33261,1278,1278,1278,0,31983,31900,3200,28700,0,83,0,83,0,2000,2000,0,0,931,96,144,77,60,22
2020,961600381,27564,17974,7974,6974,10000,9590,3000,0,0,3000,6590,4000,1090,1500,2200,2200,0,0,3795,300,30,292,288,170
2020,961700231,89014,17314,17314,17314,0,71700,69000,27000,42000,0,2700,2700,0,0,5000,0,0,0,3990,140,50,400,150,1491
2020,961700251,12426,12426,8426,8426,4000,0,0,0,0,0,0,0,0,0,0,0,0,0,1009,156,180,43,40,19
2020,961700261,231,231,31,31,200,0,0,0,0,0,0,0,0,0,0,0,0,0,820,360,144,10,26,0
2020,961700271,20736,1736,1736,1736,0,19000,19000,10000,9000,0,0,0,0,0,4000,4000,0,4000,2460,240,180,180,300,803
2020,961700281,9830,1830,1830,1830,0,8000,8000,8000,0,0,0,0,0,0,0,0,0,0,716,200,100,60,36,10
2020,961700301,14856,4906,4906,4906,0,9950,9000,9000,0,0,950,750,200,0,0,0,0,0,1985,162,200,134,144,40
2020,961700311,39381,4501,4501,4501,0,34880,28000,28000,0,0,6880,4800,2080,0,13930,13930,11160,0,1802,240,30,100,120,248
2020,961700321,136070,58970,58970,58970,0,77100,47000,17000,30000,0,30100,5100,25000,0,3800,1800,0,0,4246,720,250,480,456,439
2020,961700331,38590,20040,7540,7540,12500,18550,0,0,0,0,18550,15700,350,2500,8000,8000,8000,0,2198,240,10,240,288,109
2020,961700341,116056,35367,35367,35367,0,80689,65000,40000,18000,7000,15689,5430,10259,0,1500,1500,0,0,5309,382,297,845,599,1213
2020,961700361,4740,690,690,690,0,4050,4000,4000,0,0,50,0,50,0,0,0,0,0,688,108,85,10,40,2
2020,961700381,140,140,140,140,0,0,0,0,0,0,0,0,0,0,0,0,0,0,1225,150,350,10,50,1
2020,961700391,16717,1667,1667,1667,0,15050,15000,15000,0,0,50,0,50,0,500,0,0,0,2452,1389,620,115,50,16
2020,961800201,35084,8684,8684,8684,0,26400,26000,26000,0,0,400,0,400,0,250,50,0,0,1550,130,120,10,60,17
2020,961800221,3280,2753,2753,2753,0,527,0,0,0,0,527,527,0,0,9900,9900,4900,0,4245,156,2000,1440,114,3
2020,961800231,25138,5008,5008,5008,0,20130,19300,8000,11300,0,830,372,458,0,5000,5000,5000,0,2199,264,100,180,300,47
2020,961800241,17280,15130,15130,130,0,2150,0,0,0,0,2150,2150,0,0,0,0,0,0,2976,240,80,240,276,191
2020,961800261,51290,12040,12040,12040,0,39250,37000,19000,18000,0,2250,1750,500,0,60,60,0,0,3100,540,650,420,300,171
2020,961800271,59186,22686,22686,22686,0,36500,31000,16000,15000,0,5500,4500,1000,0,0,0,0,0,3970,300,500,600,360,1446
2020,961800301,42785,35720,29720,29720,6000,7065,0,0,0,0,7065,1500,5565,0,0,0,0,0,5420,180,60,480,300,81
2020,961800311,48703,8158,8158,8158,0,40545,21000,6000,15000,0,19545,8000,11545,0,5540,5540,0,0,4385,352,232,480,456,300
2020,961800321,8494,7594,6094,6094,1500,900,0,0,0,0,900,900,0,0,2313,2313,0,2300,1862,192,120,360,360,167
2020,961800331,29412,2890,2890,2890,0,26522,25000,25000,0,0,1522,1080,442,0,14755,14755,14755,0,5106,310,180,410,360,112
2020,961800341,18194,7344,7344,7344,0,10850,9000,9000,0,0,1850,1850,0,0,4850,4850,3850,1000,3382,240,80,340,198,629
2020,961800351,4164,2524,1524,524,1000,1640,0,0,0,0,1640,1540,100,0,0,0,0,0,3480,420,120,480,360,35
2020,961800371,18554,7554,7554,7554,0,11000,9500,9500,0,0,1500,1400,100,0,3423,3423,3400,0,2212,130,50,478,310,417
2020,961800381,70526,11300,11300,11300,0,59226,56000,3000,53000,0,3226,2000,1226,0,0,0,0,0,1823,225,110,480,168,572
2020,961800391,16906,2386,2386,2386,0,14520,14320,14000,320,0,200,200,0,0,0,0,0,0,1225,135,150,180,60,19
2020,961900201,1270,1270,70,70,1200,0,0,0,0,0,0,0,0,0,0,0,0,0,1100,90,800,40,20,1
2020,961900231,14150,50,50,50,0,14100,14000,14000,0,0,100,100,0,0,0,0,0,0,592,68,80,68,96,66
2020,961900271,40400,5400,5400,3400,0,35000,33000,25000,8000,0,2000,2000,0,0,5000,5000,5000,0,2930,270,40,450,330,76
2020,961900281,64695,12995,12995,9995,0,51700,47250,46000,1250,0,4450,950,500,3000,29000,29000,22000,7000,2974,246,20,456,180,1301
2020,961900311,60,60,60,60,0,0,0,0,0,0,0,0,0,0,100,100,0,0,410,60,100,45,18,1
2020,961900321,111956,5348,5348,5348,0,106608,59600,2100,57500,0,47008,3110,43898,0,3200,3200,1600,1600,2849,284,96,360,204,97
2020,961900331,21184,4284,4284,4284,0,16900,16900,4900,12000,0,0,0,0,0,0,0,0,0,846,86,43,67,42,9
2020,961900341,42699,8173,8173,8173,0,34526,29000,18000,11000,0,5526,4800,726,0,13880,13880,6000,7000,3578,216,500,240,120,572
2020,961900361,19025,1980,1980,1980,0,17045,17000,12000,5000,0,45,0,45,0,0,0,0,0,1324,138,250,70,36,17
2020,961900371,8871,1871,1871,1871,0,7000,6250,1500,4750,0,750,250,500,0,900,900,0,900,1744,110,900,250,60,19
2020,962000302,23420,3520,3520,3520,0,19900,18000,15000,3000,0,1900,1900,0,0,10500,10500,7500,3000,567,70,50,120,61,59
2020,962000312,38540,14040,14040,14040,0,24500,23500,18500,5000,0,1000,1000,0,0,0,0,0,0,3757,360,300,480,280,200
2020,962000322,10406,3456,3456,3456,0,6950,6700,6700,0,0,250,250,0,0,4504,4504,4500,0,1698,270,100,180,220,48
2020,962000332,11150,6700,6700,6700,0,4450,3500,2500,1000,0,950,850,100,0,0,0,0,0,1358,48,240,240,170,58
2020,962000352,45562,2612,2612,2612,0,42950,41250,15000,26250,0,1700,1500,200,0,0,0,0,0,3149,239,72,600,108,76
2020,962000362,5182,4282,4282,4282,0,900,500,500,0,0,400,400,0,0,0,0,0,0,2144,160,100,300,200,48
2020,962600301,65121,4391,4391,4391,0,60730,59500,4500,55000,0,1230,400,830,0,4504,4504,4504,0,1733,184,140,340,84,25
2020,962600321,1196,1083,1083,1083,0,113,0,0,0,0,113,0,113,0,0,0,0,0,1444,0,25,120,180,0
2020,962600341,9306,1506,1506,1506,0,7800,7250,6000,1250,0,550,50,500,0,2300,2300,1800,500,1095,100,230,300,130,36
2020,962600351,8465,1465,1465,1465,0,7000,7000,7000,0,0,0,0,0,0,0,0,0,0,1002,166,300,180,46,38
2020,962700301,21198,1148,1148,1148,0,20050,11000,3000,8000,0,9050,3000,1050,5000,24700,24700,6500,8000,2550,300,150,310,100,16
2020,962700311,73280,19880,19880,19880,0,53400,41900,20000,21900,0,11500,11500,0,0,0,0,0,0,3457,162,50,619,151,2888
2020,962700321,1950,1950,1850,1850,100,0,0,0,0,0,0,0,0,0,2132,2132,2000,0,1958,540,0,300,130,1
2020,962700341,826,626,626,626,0,200,0,0,0,0,200,0,200,0,0,0,0,0,730,76,240,100,24,3
2020,962700351,10725,275,275,275,0,10450,10300,8000,2300,0,150,0,150,0,0,0,0,0,1116,240,120,180,96,8
2020,962700361,15543,5843,5843,5843,0,9700,5000,3000,2000,0,4700,1000,3700,0,0,0,0,0,960,50,10,100,120,34
2020,962700371,11770,9618,5018,5018,4600,2152,0,0,0,0,2152,1700,452,0,1340,1340,1300,0,2448,240,120,300,360,166
2020,962800301,9872,3272,3272,3272,0,6600,6100,700,5400,0,500,0,500,0,0,0,0,0,1115,210,215,70,70,3
2020,962800311,6828,203,203,203,0,6625,6625,1425,5200,0,0,0,0,0,0,0,0,0,842,90,405,90,48,5
2020,962800321,25106,9800,9800,9800,0,15306,9800,2000,7800,0,5506,30,5476,0,0,0,0,0,1652,100,400,150,80,13
2020,962800331,12112,8712,2412,2412,6300,3400,0,0,0,0,3400,3400,0,0,0,0,0,0,4816,644,100,600,360,355
2020,962800341,63505,11115,7115,7115,4000,52390,50000,0,50000,0,2390,2300,90,0,3920,3920,3800,0,1745,252,20,187,156,123
2020,962800351,1874,1824,1824,1824,0,50,0,0,0,0,50,0,50,0,0,0,0,0,773,148,180,36,19,13
2020,962800361,21380,730,730,730,0,20650,20550,3000,17550,0,100,0,100,0,1470,1470,1470,0,1483,152,422,60,97,7
2020,962900301,5220,20,20,20,0,5200,5200,2000,3200,0,0,0,0,0,0,0,0,0,315,65,32,41,25,3
2020,962900311,60,60,60,60,0,0,0,0,0,0,0,0,0,0,0,0,0,0,510,54,60,24,24,3
2020,962900331,21937,1287,1287,1287,0,20650,16800,7800,9000,0,3850,2200,1650,0,9400,9400,9400,0,2900,600,120,600,360,28
2020,962900341,81392,8192,8192,8192,0,73200,70000,7000,63000,0,3200,3200,0,0,32804,32804,29934,2870,5132,864,20,360,288,1562
2020,962900351,4540,2340,2340,2340,0,2200,700,700,0,0,1500,1500,0,0,4032,4032,1600,2432,4168,168,360,150,360,267
2020,970000302,4140,2540,2540,2540,0,1600,0,0,0,0,1600,1600,0,0,0,0,0,0,2060,240,300,300,120,88
2020,970000322,23730,1980,1980,1980,0,21750,17000,7000,10000,0,4750,1000,3750,0,11500,11500,11500,0,2240,250,50,340,200,28
2020,970000332,27240,3240,3240,400,0,24000,23000,8000,15000,0,1000,1000,0,0,14000,1000,0,1000,2215,130,360,480,144,402
2020,970000362,18100,4100,4100,4100,0,14000,12000,10000,2000,0,2000,1000,0,1000,0,0,0,0,4485,240,15,200,300,135
2020,970000382,40165,22100,22100,22100,0,18065,15000,15000,0,0,3065,2500,565,0,0,0,0,0,2324,360,60,180,144,110
2020,970000392,62482,7332,7332,6832,0,55150,55120,4120,51000,0,30,0,30,0,0,0,0,0,2372,482,240,170,170,71
2020,970600301,39552,13052,13052,13052,0,26500,26000,26000,0,0,500,500,0,0,1000,1000,0,1000,4750,720,200,720,300,1054
2020,970600321,20830,1850,1850,1850,0,18980,18000,18000,0,0,980,900,80,0,0,0,0,0,3620,240,300,500,180,64
2020,970600331,1910,210,210,210,0,1700,0,0,0,0,1700,1700,0,0,640,640,0,640,1890,250,40,350,150,51
2020,970600341,150488,9788,9788,9788,0,140700,140000,0,140000,0,700,700,0,0,53400,6900,6900,0,1186,84,200,120,72,224
2020,970600361,3350,300,300,300,0,3050,3000,3000,0,0,50,0,50,0,0,0,0,0,561,162,120,24,30,41
2020,970600371,6255,1040,1040,1040,0,5215,5000,5000,0,0,215,0,215,0,0,0,0,0,961,167,60,24,46,77
2020,970600381,4462,4362,2462,2462,1900,100,0,0,0,0,100,100,0,0,3000,3000,3000,0,2315,365,120,250,320,11
2020,970600391,1902,2,2,2,0,1900,1900,1900,0,0,0,0,0,0,0,0,0,0,570,90,0,10,15,5
2020,970700301,1249,449,449,449,0,800,0,0,0,0,800,500,300,0,0,0,0,0,1672,156,12,560,144,31
2020,970700311,24504,9164,9164,9164,0,15340,15000,5000,10000,0,340,180,160,0,0,0,0,0,1805,150,30,600,85,241
2020,970700341,29840,8540,8540,8540,0,21300,19000,19000,0,0,2300,2300,0,0,0,0,0,0,3620,360,120,600,240,745
2020,970700351,48500,12800,12800,12800,0,35700,34000,19000,15000,0,1700,1700,0,0,4500,4500,0,4500,5390,360,100,600,180,1086
2020,970700361,1530,1330,1330,1330,0,200,0,0,0,0,200,200,0,0,1000,1000,0,0,762,250,12,20,80,16
2020,970700371,13530,13380,380,380,13000,150,0,0,0,0,150,150,0,0,0,0,0,0,1010,195,120,320,60,41
2020,970800301,7130,1330,1330,1330,0,5800,5500,5500,0,0,300,300,0,0,2090,2090,2090,0,1535,180,10,240,120,42
2020,970800311,1,1,1,1,0,0,0,0,0,0,0,0,0,0,12700,12700,12700,0,2570,300,60,400,180,11
2020,970800321,14740,3850,3850,3850,0,10890,10000,10000,0,0,890,890,0,0,0,0,0,0,922,30,120,60,72,33
2020,970800331,33203,6303,6303,6303,0,26900,25000,25000,0,0,1900,1900,0,0,0,0,0,0,3960,200,150,600,180,379
2020,970800351,3680,3480,2980,2980,500,200,0,0,0,0,200,200,0,0,0,0,0,0,1822,100,310,60,132,65
2020,970800381,51160,13000,13000,13000,0,38160,35000,35000,0,0,3160,2800,360,0,0,0,0,0,2530,600,50,200,80,477
2020,970800391,250968,24968,24968,24968,0,226000,139500,32500,107000,0,86500,9300,77200,0,15000,15000,15000,0,4440,240,50,600,300,266
2020,970900301,150,150,150,150,0,0,0,0,0,0,0,0,0,0,100,100,0,100,474,84,30,30,30,1
2020,970900311,5930,102,102,102,0,5828,3000,3000,0,0,2828,2150,678,0,10400,10400,1400,9000,2658,60,120,360,420,180
2020,970900331,3580,3430,1830,1830,1600,150,0,0,0,0,150,150,0,0,0,0,0,0,573,180,60,90,20,4
2020,970900341,66978,8928,8928,8928,0,58050,57000,14000,43000,0,1050,1050,0,0,0,0,0,0,2034,258,30,180,120,53
2020,970900351,14350,300,300,300,0,14050,14000,14000,0,0,50,50,0,0,3000,3000,3000,0,2188,204,360,60,83,36
2020,970900361,108692,8392,8392,6392,0,100300,94000,4000,90000,0,6300,2300,3000,1000,37500,37500,32500,5000,3444,284,50,182,396,116
2020,970900371,8250,2450,2450,1950,0,5800,3500,3500,0,0,2300,500,1000,800,250,250,0,0,965,96,8,96,96,13
2020,971000322,540,490,490,490,0,50,0,0,0,0,50,50,0,0,3260,3260,0,3260,3030,1000,24,120,160,6
2020,971000332,124250,5450,5450,3950,0,118800,95000,50000,45000,0,23800,3100,20000,700,51000,34000,33000,0,5930,930,200,800,300,435
2020,971000352,3250,250,250,250,0,3000,3000,3000,0,0,0,0,0,0,0,0,0,0,510,106,80,10,24,5
2020,971000362,48140,8340,8340,8340,0,39800,38000,13000,25000,0,1800,1800,0,0,0,0,0,0,4896,1396,150,250,250,738
2020,971000372,28200,18200,18200,18200,0,10000,10000,10000,0,0,0,0,0,0,0,0,0,0,2134,550,120,24,40,109
2020,971600301,19840,10540,10540,10180,0,9300,8500,8500,0,0,800,800,0,0,1450,1450,0,1450,4560,240,120,360,240,736
2020,971600311,23042,2942,2942,2892,0,20100,15000,15000,0,0,5100,0,5100,0,0,0,0,0,4020,150,2200,200,70,29
2020,971600321,367360,218160,218160,118160,0,149200,133000,28000,105000,0,16200,6200,10000,0,29500,29500,25000,4000,4400,500,200,600,200,1070
2020,971600341,83105,36005,36005,36005,0,47100,46500,13500,33000,0,600,600,0,0,500,0,0,0,3475,230,100,120,120,1560
2020,971600351,13500,1200,1200,1200,0,12300,12000,12000,0,0,300,300,0,0,700,700,700,0,2780,300,80,400,200,45
2020,971600381,29050,4000,4000,4000,0,25050,25000,10000,15000,0,50,0,50,0,0,0,0,0,2340,400,800,60,30,5
2020,971700311,30864,13664,13664,13664,0,17200,15000,15000,0,0,2200,2200,0,0,5820,5820,4320,1500,5260,200,60,600,480,1141
2020,971700321,33180,11080,11080,6580,0,22100,19000,14000,5000,0,3100,3100,0,0,1650,1650,1650,0,4150,250,200,400,300,197
2020,971700351,3500,3350,1150,1150,2200,150,0,0,0,0,150,150,0,0,0,0,0,0,2129,324,200,250,120,69
2020,971700361,5637,377,377,377,0,5260,4700,4700,0,0,560,0,560,0,0,0,0,0,1558,150,38,25,52,8
2020,971700371,19612,11312,11312,11312,0,8300,6000,6000,0,0,2300,2300,0,0,0,0,0,0,2160,160,100,360,40,193
2020,971800301,14322,732,732,732,0,13590,12600,4000,8600,0,990,170,820,0,2012,2012,0,2000,1517,120,58,32,45,7
2020,971800321,23100,100,100,100,0,23000,23000,23000,0,0,0,0,0,0,13000,13000,13000,0,1014,400,50,60,84,60
2020,971800331,15560,310,310,310,0,15250,15000,15000,0,0,250,50,200,0,0,0,0,0,1160,120,100,60,50,38
2020,971800341,4680,680,680,680,0,4000,4000,4000,0,0,0,0,0,0,0,0,0,0,1473,192,180,144,60,5
2020,971800351,85925,22625,22625,22625,0,63300,63000,13000,50000,0,300,300,0,0,0,0,0,0,1774,130,160,300,262,87
2020,971800361,3572,2472,2472,2472,0,1100,0,0,0,0,1100,1100,0,0,0,0,0,0,1930,360,240,200,180,142
2020,971800371,43260,19960,6460,6460,13500,23300,23000,0,23000,0,300,300,0,0,1041,41,0,0,2760,330,200,350,180,51
2020,971800381,38017,3867,3867,3867,0,34150,32350,25000,7350,0,1800,1500,300,0,19200,19200,18500,700,6149,324,24,540,324,50
2020,971900301,32350,2300,2300,2300,0,30050,30000,30000,0,0,50,50,0,0,0,0,0,0,2050,330,10,500,60,85
2020,971900321,62412,9112,9112,9112,0,53300,49000,7000,42000,0,4300,4100,200,0,0,0,0,0,4620,300,700,480,400,943
2020,971900331,5030,30,30,30,0,5000,5000,5000,0,0,0,0,0,0,0,0,0,0,1658,100,24,10,24,17
2020,971900351,4050,850,800,800,50,3200,0,0,0,0,3200,3200,0,0,30,30,0,0,2060,374,100,360,156,106
2020,971900361,5430,300,300,300,0,5130,5000,5000,0,0,130,0,130,0,0,0,0,0,1432,240,200,250,42,16
2020,971900371,13736,2036,2036,2036,0,11700,11500,5000,6500,0,200,200,0,0,12000,12000,10000,2000,1253,180,30,120,120,623
2020,971900391,215,215,215,215,0,0,0,0,0,0,0,0,0,0,3000,3000,0,0,446,156,30,10,24,1
2020,972000322,9423,123,123,123,0,9300,9000,9000,0,0,300,300,0,0,5700,5700,5700,0,1659,228,260,180,192,77
2020,972000332,1408,608,108,108,500,800,0,0,0,0,800,800,0,0,300,300,0,300,4300,240,100,660,276,30
2020,972000352,7554,700,700,700,0,6854,6770,6770,0,0,84,0,84,0,0,0,0,0,473,60,80,40,13,3
2020,972000372,42800,25300,25300,25300,0,17500,14000,8000,6000,0,3500,3500,0,0,100,100,0,0,3000,720,100,240,120,213
2020,972600331,410,310,50,50,260,100,0,0,0,0,100,0,100,0,0,0,0,0,744,168,6,6,72,0
2020,972600341,14150,2350,2350,2350,0,11800,11800,1800,10000,0,0,0,0,0,0,0,0,0,825,200,100,70,25,4
2020,972600351,36434,7114,7114,7114,0,29320,27890,6890,21000,0,1430,1380,50,0,0,0,0,0,1400,240,120,240,48,84
2020,972600361,3200,200,200,200,0,3000,3000,3000,0,0,0,0,0,0,0,0,0,0,1334,94,1000,10,0,5
2020,972600371,39763,9363,9363,9363,0,30400,26000,10000,16000,0,4400,3400,1000,0,2000,2000,2000,0,1370,640,20,300,50,112
2020,972700311,36868,13778,13778,13778,0,23090,23000,13000,10000,0,90,90,0,0,0,0,0,0,1448,182,50,100,216,781
2020,972700321,100,50,50,50,0,50,0,0,0,0,50,0,50,0,0,0,0,0,620,50,240,50,20,1
2020,972700361,24900,4600,4600,4600,0,20300,19500,13000,6500,0,800,0,800,0,0,0,0,0,1055,190,110,50,95,56
2020,972800301,37080,7680,7680,5680,0,29400,24000,24000,0,0,5400,4400,1000,0,5100,5100,4600,500,3420,340,160,480,160,137
2020,972800311,11800,500,500,500,0,11300,10000,10000,0,0,1300,1300,0,0,0,0,0,0,1750,200,200,120,120,108
2020,972800331,6300,100,100,100,0,6200,6200,3000,3200,0,0,0,0,0,0,0,0,0,492,70,60,60,22,4
2020,972800361,3594,1594,1594,1594,0,2000,2000,2000,0,0,0,0,0,0,1410,1410,700,0,665,294,30,20,36,13
2020,972900301,22760,3360,3360,3360,0,19400,18000,18000,0,0,1400,1100,300,0,9000,9000,8400,0,3660,360,100,200,300,215
2020,972900311,31800,300,300,300,0,31500,31500,31500,0,0,0,0,0,0,0,0,0,0,2727,360,110,135,72,47
2020,972900321,16557,3607,3307,3307,300,12950,12000,0,12000,0,950,800,150,0,0,0,0,0,3522,480,120,420,312,74
2020,972900331,700,700,200,200,500,0,0,0,0,0,0,0,0,0,0,0,0,0,1224,360,120,84,120,1
2020,972900341,27232,1582,1582,1582,0,25650,10600,5600,5000,0,15050,1750,13300,0,5500,5500,0,5500,1751,140,68,340,108,62
2020,972900361,93022,2822,2822,2822,0,90200,88000,30000,58000,0,2200,2200,0,0,76000,43000,43000,0,3570,420,50,1320,240,333
2020,980000322,1458,1458,258,258,1200,0,0,0,0,0,0,0,0,0,190,190,0,150,2012,600,10,72,180,0
2020,980000332,14922,4522,4522,4022,0,10400,10000,10000,0,0,400,0,400,0,300,0,0,0,930,120,180,50,48,93
2020,980000342,58720,5180,5180,5180,0,53540,40000,17000,23000,0,13540,2240,11300,0,39780,33780,21780,12000,3301,144,600,360,192,585
2020,980000372,2600,500,500,500,0,2100,2000,0,2000,0,100,0,100,0,0,0,0,0,948,120,360,60,24,2
2020,980000382,146345,67820,67820,42820,0,78525,74500,22000,52500,0,4025,4025,0,0,18250,6000,0,6000,7840,600,1300,1300,360,2989
2020,980000392,31010,8500,8500,2500,0,22510,22000,22000,0,0,510,510,0,0,6000,6000,5000,1000,1567,300,150,510,96,53
2020,980600301,167600,45120,45120,45120,0,122480,120000,90000,30000,0,2480,1350,1130,0,5800,0,0,0,4117,480,120,512,180,507
2020,980600321,44976,7876,7876,2876,0,37100,28000,28000,0,0,9100,100,4000,5000,18000,18000,18000,0,2285,300,640,192,120,284
2020,980600341,42923,3023,3023,3023,0,39900,30000,30000,0,0,9900,2700,7200,0,19640,19640,7940,1950,4900,420,6,840,360,51
2020,980600371,4200,200,200,200,0,4000,4000,4000,0,0,0,0,0,0,0,0,0,0,514,146,100,20,16,7
2020,980600391,108228,17578,17578,14778,0,90650,90000,32000,58000,0,650,200,450,0,16057,15057,15057,0,4720,576,10,450,384,422
2020,980700301,1260,610,110,110,500,650,0,0,0,0,650,650,0,0,0,0,0,0,2134,474,30,250,80,51
2020,980700321,18063,5163,5163,5163,0,12900,12900,11500,1400,0,0,0,0,0,1000,0,0,0,1612,140,60,48,55,32
2020,980700371,8189,5149,4849,4849,300,3040,3000,0,3000,0,40,0,40,0,1800,1800,0,1700,2108,468,240,180,120,8
2020,980700381,10650,4650,4150,2150,500,6000,0,0,0,0,6000,1500,4500,0,15050,15050,0,10550,5030,720,0,1200,240,49
2020,980700391,31484,9584,9584,4584,0,21900,15000,15000,0,0,6900,1900,5000,0,0,0,0,0,3230,180,200,480,240,747
2020,980800311,15514,5734,5734,5734,0,9780,9680,6500,3180,0,100,100,0,0,500,500,0,500,1269,141,140,400,54,29
2020,980800321,27944,21371,21371,21371,0,6573,6300,6300,0,0,273,250,23,0,111,111,0,0,1161,144,300,70,47,63
2020,980800341,3136,3136,136,136,3000,0,0,0,0,0,0,0,0,0,0,0,0,0,989,86,100,0,4,0
2020,980800351,147872,6572,6572,6572,0,141300,96500,20000,76500,0,44800,10800,30000,4000,50750,50750,43340,0,5330,300,50,360,300,1389
2020,980800361,24326,1201,1201,1201,0,23125,23000,23000,0,0,125,0,125,0,12106,12106,8882,3000,2324,360,680,240,144,60
2020,980800371,8181,4331,1331,1331,3000,3850,0,0,0,0,3850,3850,0,0,1920,1920,0,0,4373,840,180,640,420,431
2020,980800391,42440,24890,24890,24890,0,17550,16000,7000,9000,0,1550,1550,0,0,500,0,0,0,1600,250,400,150,60,64
2020,980900301,6112,5882,1882,1882,4000,230,0,0,0,0,230,230,0,0,20,20,0,0,2070,420,20,480,240,9
2020,980900321,9884,2860,2860,2360,0,7024,7000,7000,0,0,24,0,24,0,0,0,0,0,722,94,50,20,36,7
2020,980900331,520,420,420,120,0,100,0,0,0,0,100,100,0,0,3690,3690,0,1490,2168,140,50,610,315,15
2020,980900341,61094,20764,20764,5764,0,40330,32900,14000,18900,0,7430,1850,5580,0,0,0,0,0,4626,890,60,760,187,111
2020,980900351,9852,502,502,502,0,9350,9000,9000,0,0,350,350,0,0,0,0,0,0,1460,160,150,120,130,20
2020,980900371,20100,1600,1600,1560,0,18500,8000,8000,0,0,10500,10500,0,0,20260,20260,12760,0,4662,780,10,720,280,205
2020,980900391,19703,4703,4703,4703,0,15000,13000,13000,0,0,2000,300,1700,0,9400,9400,9370,0,1782,288,120,120,204,75
2020,981000332,43640,40530,37030,37030,3500,3110,2500,0,2500,0,610,550,60,0,0,0,0,0,2920,450,30,700,120,339
2020,981000342,620,420,420,420,0,200,0,0,0,0,200,200,0,0,2613,2613,0,2613,1510,384,10,210,126,141
2020,981000352,15846,1846,1846,1846,0,14000,7500,5500,2000,0,6500,6100,0,400,16536,16536,3987,4549,2160,185,250,280,264,21
2020,981000362,7070,70,70,70,0,7000,7000,7000,0,0,0,0,0,0,0,0,0,0,800,200,50,30,18,9
2020,981000372,7150,150,150,150,0,7000,7000,7000,0,0,0,0,0,0,0,0,0,0,870,190,100,50,30,10
2020,981000382,39079,6371,6371,6371,0,32708,32000,9000,23000,0,708,625,83,0,5070,5070,5000,0,4326,230,10,400,306,123
2020,981000392,58440,1110,1110,1110,0,57330,55000,40000,15000,0,2330,2330,0,0,9470,470,0,350,2600,340,100,600,120,125
2020,981600311,16082,5182,4182,4182,1000,10900,6000,0,6000,0,4900,2400,1500,1000,7800,7800,4800,3000,3095,920,24,280,294,1356
2020,981600321,28018,27068,11068,11068,16000,950,0,0,0,0,950,700,250,0,2350,2350,0,2200,2482,180,50,200,96,29
2020,981600341,66248,8568,8568,8568,0,57680,56000,21000,35000,0,1680,1530,150,0,12000,12000,11000,1000,3570,180,820,480,380,128
2020,981600351,47065,4195,4195,4195,0,42870,38000,38000,0,0,4870,4350,520,0,18580,18580,18310,0,3095,408,30,660,325,2702
2020,981600381,158580,4860,4860,4860,0,153720,145000,45000,100000,0,8720,720,8000,0,31500,31500,27000,4500,3040,120,72,220,220,209
2020,981700301,31424,2424,2424,2424,0,29000,29000,29000,0,0,0,0,0,0,600,0,0,0,1889,420,360,48,144,71
2020,981700321,8596,1096,1096,1096,0,7500,7500,7500,0,0,0,0,0,0,1500,1500,1500,0,772,107,34,35,72,22
2020,981700331,120,120,120,120,0,0,0,0,0,0,0,0,0,0,0,0,0,0,1648,62,1200,0,24,1
2020,981700341,43640,25140,25140,25140,0,18500,18000,18000,0,0,500,500,0,0,0,0,0,0,3604,204,30,480,240,311
2020,981700351,31392,7792,7792,7792,0,23600,22800,18500,4300,0,800,800,0,0,11477,11477,10417,1060,3986,200,780,410,216,115
2020,981700361,31312,5762,5762,5762,0,25550,25000,25000,0,0,550,550,0,0,11491,11491,11491,0,3780,360,60,480,180,116
2020,981700381,5072,3852,852,852,3000,1220,0,0,0,0,1220,1200,20,0,4080,4080,2800,500,2930,240,20,430,300,54
2020,981800311,10780,9780,7180,6480,2600,1000,0,0,0,0,1000,1000,0,0,590,590,0,400,2331,393,50,70,228,19
2020,981800321,9951,8951,8451,6451,500,1000,0,0,0,0,1000,1000,0,0,0,0,0,0,3640,600,100,480,360,96
2020,981800331,225,225,25,25,200,0,0,0,0,0,0,0,0,0,3500,3500,0,3000,2034,444,10,180,170,1
2020,981800351,100,100,100,100,0,0,0,0,0,0,0,0,0,0,120,120,0,0,1600,240,460,10,40,1
2020,981800361,49947,1151,1151,1151,0,48796,48000,23000,25000,0,796,796,0,0,16000,15000,15000,0,2870,420,20,300,220,115
2020,981800371,17980,5910,5910,5910,0,12070,10000,10000,0,0,2070,2070,0,0,490,490,0,490,4398,200,50,840,288,100
2020,981800391,40840,13140,13140,13140,0,27700,26000,26000,0,0,1700,1500,200,0,10690,10690,8320,700,6240,360,20,500,360,843
2020,981900311,16444,2754,2754,2680,0,13690,11120,9000,2120,0,2570,2170,400,0,5321,5321,1983,270,3467,288,80,180,375,48
2020,981900341,14370,13670,3670,3670,10000,700,0,0,0,0,700,400,300,0,1030,1030,1000,0,4210,300,100,200,210,900
2020,981900361,110400,10900,10900,10900,0,99500,99000,95000,4000,0,500,500,0,0,5528,28,0,0,2580,230,80,250,80,335
2020,981900381,35540,13518,7518,7518,6000,22022,21000,0,21000,0,1022,570,452,0,14000,14000,14000,0,3566,228,294,784,259,158
2020,981900391,4510,3960,3960,3960,0,550,0,0,0,0,550,200,350,0,4300,4300,0,3500,2440,200,130,200,120,43
2020,982000302,6000,500,500,500,0,5500,3500,3500,0,0,2000,0,2000,0,0,0,0,0,1174,144,180,180,48,4
2020,982000312,131,131,131,131,0,0,0,0,0,0,0,0,0,0,0,0,0,0,1806,80,720,160,46,1
2020,982000332,41912,2412,2412,2412,0,39500,38000,38000,0,0,1500,1500,0,0,35,35,0,0,3396,396,500,120,300,245
2020,982000342,29490,1190,1190,1190,0,28300,28000,18000,10000,0,300,300,0,0,6038,1038,938,100,3007,764,50,72,72,81
2020,982000362,33370,19840,19840,19840,0,13530,11500,11500,0,0,2030,2030,0,0,960,960,0,880,2302,214,50,180,120,165
2020,982000382,500,500,500,500,0,0,0,0,0,0,0,0,0,0,0,0,0,0,937,132,380,30,31,1
2020,982000392,25056,7056,6556,6556,500,18000,17000,0,17000,0,1000,1000,0,0,9013,13,0,0,1999,426,200,240,120,49
2020,982600311,39664,7384,7384,7384,0,32280,31000,21000,10000,0,1280,880,400,0,14141,6141,6116,0,3820,360,20,300,240,492
2020,982600341,152,152,22,22,130,0,0,0,0,0,0,0,0,0,0,0,0,0,629,180,14,60,48,1
2020,982600361,13880,380,380,380,0,13500,12500,12500,0,0,1000,1000,0,0,10882,10882,10000,0,1521,180,93,87,30,28
2020,982600381,11858,1658,1658,1658,0,10200,8400,8400,0,0,1800,1800,0,0,1860,1860,1800,0,1728,300,57,198,66,168
2020,982600391,62424,2224,2224,2224,0,60200,35000,9000,26000,0,25200,200,25000,0,37000,37000,37000,0,1230,130,150,240,120,132
2020,982700311,30236,6736,6736,6736,0,23500,23500,23500,0,0,0,0,0,0,0,0,0,0,1237,348,60,72,72,25
2020,982700321,20958,1158,1158,1158,0,19800,19500,19500,0,0,300,300,0,0,0,0,0,0,920,260,10,70,120,56
2020,982700331,50057,6777,2277,2277,4500,43280,35000,0,35000,0,8280,1280,2000,5000,25880,19880,19880,0,3772,600,516,280,240,99
2020,982700341,29690,9640,9640,9640,0,20050,14050,11000,0,3050,6000,6000,0,0,132,132,0,0,1856,162,50,500,72,442
2020,982700351,10104,5004,4004,2004,1000,5100,0,0,0,0,5100,100,0,5000,0,0,0,0,3291,201,20,400,120,155
2020,982700361,2550,1750,1750,1750,0,800,0,0,0,0,800,800,0,0,6370,6370,0,5500,2082,492,20,192,132,137
2020,982700381,2252,2252,2252,2252,0,0,0,0,0,0,0,0,0,0,0,0,0,0,867,76,102,72,50,1
2020,982800301,37175,7575,7575,7175,0,29600,28600,8600,10000,10000,1000,1000,0,0,13030,13030,0,13000,2890,300,30,420,240,346
2020,982800331,3410,3280,3280,3280,0,130,0,0,0,0,130,130,0,0,0,0,0,0,1384,120,180,120,60,27
2020,982800341,39522,14249,14249,14149,0,25273,21000,21000,0,0,4273,4073,200,0,5160,5160,0,5160,6892,243,53,520,360,666
2020,982800351,34444,7614,7614,7614,0,26830,17300,8000,9300,0,9530,4530,5000,0,6400,6400,1400,5000,3007,150,520,360,40,85
2020,982800371,12600,2600,2600,2600,0,10000,10000,10000,0,0,0,0,0,0,500,0,0,0,1153,129,720,10,18,21
2020,982800381,15015,15,15,15,0,15000,15000,15000,0,0,0,0,0,0,0,0,0,0,683,84,150,30,29,21
2020,982900301,64054,1684,1684,1684,0,62370,62000,56000,6000,0,370,370,0,0,49700,45700,38000,7000,3680,470,100,450,310,1321
2020,982900311,94617,16877,16877,16877,0,77740,76500,31500,45000,0,1240,1240,0,0,0,0,0,0,2411,179,55,260,246,100
2020,982900321,32830,8470,8470,8470,0,24360,23000,23000,0,0,1360,960,400,0,29000,29000,0,29000,4642,420,100,480,132,792
2020,982900331,1195,1195,195,195,1000,0,0,0,0,0,0,0,0,0,0,0,0,0,1542,480,212,30,60,1
2020,982900341,34090,15740,15740,15740,0,18350,18000,11000,7000,0,350,350,0,0,3000,3000,3000,0,5722,2180,12,240,300,607
2020,982900351,9107,2107,2107,2107,0,7000,7000,3000,4000,0,0,0,0,0,0,0,0,0,1437,100,880,70,43,8
2020,982900361,4120,1120,1120,1120,0,3000,3000,0,3000,0,0,0,0,0,0,0,0,0,417,84,24,12,7,3
2020,982900371,6450,4950,4950,4950,0,1500,1500,0,1500,0,0,0,0,0,0,0,0,0,1015,160,120,20,15,7
2020,982900391,6807,507,507,507,0,6300,6300,3500,2800,0,0,0,0,0,0,0,0,0,644,94,32,1,24,4
2020,983000302,20586,13986,13986,13986,0,6600,6000,0,6000,0,600,600,0,0,0,0,0,0,1053,112,120,120,73,53
2020,983000312,4750,350,350,350,0,4400,4000,4000,0,0,400,0,400,0,0,0,0,0,1028,80,78,100,40,10
2020,983600311,111368,6218,6218,6218,0,105150,100000,20000,80000,0,5150,1150,4000,0,30000,0,0,0,1625,180,75,180,150,116
2020,983700301,6,6,6,6,0,0,0,0,0,0,0,0,0,0,2000,2000,0,2000,1195,85,700,60,40,1
2020,983800301,43680,2180,2180,2180,0,41500,38850,8000,30850,0,2650,0,2650,0,2500,0,0,0,2444,180,425,274,110,13
2020,983900301,20594,7374,7374,7374,0,13220,10000,5000,5000,0,3220,2770,450,0,0,0,0,0,1767,272,70,480,180,61
2020,990000202,21910,810,810,810,0,21100,20000,20000,0,0,1100,1100,0,0,750,750,0,500,5430,240,360,1200,360,361
2020,990000252,51480,28330,28330,28330,0,23150,21000,6000,15000,0,2150,2150,0,0,300,0,0,0,2424,148,180,840,156,250
2020,990000262,33984,14884,13184,4184,1700,19100,10000,0,10000,0,9100,9100,0,0,6750,6750,0,1300,5820,1200,300,1200,250,604
2020,990000282,75571,20571,8571,8571,12000,55000,55000,0,55000,0,0,0,0,0,21000,3000,3000,0,2449,240,24,15,120,512
2020,990000292,189071,18571,12371,11371,6200,170500,170000,0,170000,0,500,500,0,0,163200,146200,117500,8700,3439,840,100,126,180,581
2020,990000302,2050,50,50,50,0,2000,2000,0,2000,0,0,0,0,0,0,0,0,0,605,60,30,15,20,3
2020,990000312,101500,1100,1100,1100,0,100400,100000,0,100000,0,400,400,0,0,0,0,0,0,1767,204,99,158,56,477
2020,990000332,431,431,331,331,100,0,0,0,0,0,0,0,0,0,1117,1117,0,1117,3598,694,36,60,156,1
2020,990000342,252702,2092,2092,2092,0,250610,250000,0,250000,0,610,600,10,0,200000,200000,200000,0,1727,360,240,300,127,471
2020,990000352,65820,3320,3320,3320,0,62500,61000,23000,38000,0,1500,1500,0,0,0,0,0,0,2636,196,800,300,60,138
2020,990000362,1089,1089,1089,1089,0,0,0,0,0,0,0,0,0,0,0,0,0,0,2890,240,500,70,240,2610
2020,990000382,75830,100,100,100,0,75730,74800,55000,19800,0,930,930,0,0,17000,17000,5000,12000,7430,1690,100,460,330,2153
2020,990000392,20650,650,650,650,0,20000,20000,10000,10000,0,0,0,0,0,0,0,0,0,589,60,51,0,36,8
2020,990600211,32,32,32,32,0,0,0,0,0,0,0,0,0,0,0,0,0,0,557,150,100,25,50,0
2020,990600301,2954,2954,1954,1954,1000,0,0,0,0,0,0,0,0,0,80,80,0,0,1430,240,10,240,120,1
2020,990600321,17134,16794,16794,14694,0,340,0,0,0,0,340,340,0,0,3000,3000,3000,0,4200,521,30,1080,250,147
2020,990600341,15500,320,320,320,0,15180,15000,15000,0,0,180,180,0,0,0,0,0,0,1471,72,180,240,60,12
2020,990600371,49120,9620,9620,9620,0,39500,37000,37000,0,0,2500,2500,0,0,0,0,0,0,1188,240,60,60,108,88
2020,990600381,88320,27920,27920,26420,0,60400,59000,32000,20000,7000,1400,1300,100,0,8500,8500,7000,1200,2810,180,360,600,180,170
2020,990700221,22888,8388,3288,3288,5100,14500,14000,0,14000,0,500,500,0,0,1512,612,0,600,2140,720,30,140,72,27
2020,990700301,33140,5750,5750,5750,0,27390,27000,7000,20000,0,390,300,90,0,0,0,0,0,1607,150,130,180,72,161
2020,990700311,800,300,300,300,0,500,0,0,0,0,500,500,0,0,3000,3000,0,3000,998,50,240,240,54,21
2020,990700331,6962,962,962,962,0,6000,6000,6000,0,0,0,0,0,0,3895,3895,150,0,682,30,5,5,61,16
2020,990700341,6940,6640,1640,1440,5000,300,0,0,0,0,300,300,0,0,0,0,0,0,1006,72,5,186,108,25
2020,990700351,101000,31000,31000,31000,0,70000,70000,70000,0,0,0,0,0,0,1000,0,0,0,1226,156,24,0,0,158
2020,990700361,6260,6260,6260,6260,0,0,0,0,0,0,0,0,0,0,0,0,0,0,765,330,200,30,35,46
2020,990700371,33226,7226,7226,7226,0,26000,25000,25000,0,0,1000,1000,0,0,5720,5720,5000,600,3116,440,36,200,240,558
2020,990700381,24937,937,937,937,0,24000,24000,0,24000,0,0,0,0,0,3000,3000,3000,0,1278,312,10,0,24,475
2020,990800221,11020,7020,7020,7020,0,4000,0,0,0,0,4000,4000,0,0,0,0,0,0,1822,240,40,270,72,818
2020,990800251,15680,1880,1880,1880,0,13800,12000,12000,0,0,1800,1500,300,0,8202,8202,7202,0,3512,180,54,250,240,363
2020,990800261,41904,1704,1704,1704,0,40200,40000,40000,0,0,200,200,0,0,3000,3000,0,0,2477,360,30,240,72,215
2020,990800301,7870,7570,7370,7370,200,300,0,0,0,0,300,300,0,0,9300,9300,0,9300,3100,552,36,300,240,325
2020,990800311,26000,3000,3000,3000,0,23000,23000,23000,0,0,0,0,0,0,0,0,0,0,395,53,60,24,18,10
2020,990800321,12780,9280,9280,9280,0,3500,0,0,0,0,3500,3500,0,0,0,0,0,0,2456,96,20,300,180,388
2020,990800331,250,250,250,250,0,0,0,0,0,0,0,0,0,0,0,0,0,0,724,180,2,0,1,9
2020,990800351,50538,6781,6781,6781,0,43757,40000,25000,15000,0,3757,1757,1500,500,3520,3520,3400,0,2674,220,30,564,185,54
2020,990800361,7658,6908,108,108,6800,750,0,0,0,0,750,700,50,0,6560,6560,5160,1100,2980,240,60,100,240,23
2020,990800371,35805,11905,11905,8905,0,23900,21000,21000,0,0,2900,1300,600,1000,12350,12350,11180,670,2423,168,500,270,355,99
2020,990900241,32573,8973,8973,8973,0,23600,22000,20000,2000,0,1600,1600,0,0,5380,5380,5380,0,4080,240,300,360,360,192
2020,990900251,61806,31506,31506,1506,0,30300,30000,0,30000,0,300,300,0,0,5000,5000,5000,0,3754,360,24,480,240,18
2020,990900271,46130,1830,1830,1630,0,44300,42700,40000,0,2700,1600,600,500,500,16800,16800,16600,0,2392,420,10,600,192,77
2020,990900281,78200,12200,12200,12200,0,66000,65000,35000,30000,0,1000,1000,0,0,16000,0,0,0,2228,120,300,88,120,386
2020,990900301,2972,2972,2972,2972,0,0,0,0,0,0,0,0,0,0,0,0,0,0,2063,224,8,115,300,29
2020,990900321,143392,15142,15142,15142,0,128250,127000,20000,107000,0,1250,1250,0,0,100,0,0,0,1486,102,120,180,144,290
2020,990900351,4983,4983,4683,4683,300,0,0,0,0,0,0,0,0,0,1120,1120,1120,0,2230,500,50,150,480,1
2020,990900361,5910,5210,2710,2710,2500,700,0,0,0,0,700,700,0,0,0,0,0,0,1950,432,10,120,60,28
2020,990900371,71488,4488,4488,4488,0,67000,65000,52000,13000,0,2000,2000,0,0,18200,8200,4700,3500,4666,360,60,384,392,1158
2020,991000202,28836,26136,10136,10136,16000,2700,0,0,0,0,2700,2700,0,0,6200,6200,0,6000,2110,300,30,500,240,285
2020,991000212,43620,28120,9120,9120,19000,15500,15000,0,15000,0,500,500,0,0,0,0,0,0,4170,300,180,720,216,107
2020,991000222,91000,18000,18000,18000,0,73000,70000,70000,0,0,3000,3000,0,0,20000,20000,0,20000,3630,480,50,200,200,58970
2020,991000302,39260,300,300,300,0,38960,38960,21846,17114,0,0,0,0,0,0,0,0,0,1383,58,350,0,60,120
2020,991000322,730,730,30,30,700,0,0,0,0,0,0,0,0,0,0,0,0,0,394,78,120,20,40,1
2020,991000332,103300,57300,17400,12400,39900,46000,30000,0,30000,0,16000,6000,5000,5000,26000,26000,20000,0,3450,500,50,700,150,439
2020,991000342,83220,23920,15820,15820,8100,59300,59000,0,59000,0,300,300,0,0,0,0,0,0,2334,384,120,300,180,780
2020,991600301,29005,705,705,705,0,28300,28000,28000,0,0,300,300,0,0,300,300,0,0,1659,262,120,60,103,33
2020,991600341,500,500,100,100,400,0,0,0,0,0,0,0,0,0,0,0,0,0,480,0,0,0,60,1
2020,991700301,1640,1640,440,440,1200,0,0,0,0,0,0,0,0,0,0,0,0,0,541,70,20,5,15,1
2020,991700311,40330,16030,16030,16030,0,24300,20000,20000,0,0,4300,2300,2000,0,2000,2000,0,2000,2820,100,60,240,360,32
2020,991700321,123960,6810,6810,6810,0,117150,113000,13000,100000,0,4150,1950,2200,0,3900,3900,3700,200,1406,210,100,240,60,93
2020,991800211,13635,1585,1585,1585,0,12050,12000,12000,0,0,50,50,0,0,0,0,0,0,1348,120,240,150,48,25
2020,991800221,140968,35028,35028,35028,0,105940,105000,55000,50000,0,940,270,670,0,5000,0,0,0,1435,125,30,280,115,361
2020,991800241,460,460,100,100,360,0,0,0,0,0,0,0,0,0,0,0,0,0,527,200,20,17,30,1
2020,991800311,28010,7910,7910,7760,0,20100,20000,20000,0,0,100,10,90,0,500,500,0,500,2038,148,300,60,240,103
2020,991900211,55150,2750,2750,2750,0,52400,50000,50000,0,0,2400,2400,0,0,740,740,0,740,4860,300,300,200,360,331
2020,991900221,118630,46130,46130,45126,0,72500,70000,30000,40000,0,2500,2500,0,0,13500,13500,0,13500,6200,270,250,650,180,1573
2020,991900301,206616,61716,61716,48716,0,144900,140000,40000,100000,0,4900,3100,1800,0,0,0,0,0,4038,214,80,300,384,1036
2020,991900311,10130,80,80,80,0,10050,10000,10000,0,0,50,0,50,0,0,0,0,0,715,50,72,15,18,5
2020,991900321,56490,2390,2390,2390,0,54100,45000,15000,30000,0,9100,1000,8100,0,0,0,0,0,2775,140,500,240,72,40
2020,992800211,14110,80,80,80,0,14030,12500,12500,0,0,1530,1530,0,0,0,0,0,0,1192,150,156,152,114,84
2020,992800251,166877,35473,35473,35473,0,131404,130000,41000,89000,0,1404,1404,0,0,30278,11278,4731,6547,2650,200,200,240,350,2019
2020,992800261,15000,4600,4600,4600,0,10400,10000,10000,0,0,400,400,0,0,0,0,0,0,2968,168,150,480,240,217
2020,992800271,227220,420,420,420,0,226800,220000,200000,20000,0,6800,1800,5000,0,45500,45000,17000,28000,4355,960,120,1200,360,298
2020,992800281,27428,2428,2428,2428,0,25000,25000,25000,0,0,0,0,0,0,0,0,0,0,1786,100,100,50,156,24
2020,992800291,11466,4316,4316,4316,0,7150,7000,7000,0,0,150,150,0,0,945,945,645,0,1158,120,204,240,24,19
2020,993800251,13720,12020,2020,2020,10000,1700,0,0,0,0,1700,1700,0,0,4100,4100,4000,0,3030,360,400,150,70,587
2020,993800291,6705,6705,6255,6255,450,0,0,0,0,0,0,0,0,0,2200,2200,0,2200,3530,1200,60,300,150,32
2020,994800251,130180,12480,12480,12480,0,117700,117000,100000,0,17000,700,700,0,0,22000,22000,22000,0,3752,360,190,72,200,1173
2020,994800261,265226,7900,7900,7400,0,257326,255000,70000,185000,0,2326,2100,226,0,29000,8000,8000,0,4860,900,400,400,360,1159
2020,994800291,109695,23705,10205,10205,13500,85990,85000,0,85000,0,990,990,0,0,25000,0,0,0,3680,600,100,200,120,891
2020,995800261,71223,15023,15023,15023,0,56200,50000,50000,0,0,6200,6200,0,0,13000,13000,13000,0,3506,300,80,360,288,384
